日期,外資買賣超,投信買賣超,自營商買賣超,單日合計買賣超,外資估計持股,投信估計持股,自營商估計持股,單日合計估計持股,外資持股比重,三大法人持股比重,
107/03/31,0,0,122,122,104109,0,2899,107008,12.47%,12.82%,
107/03/30,21,0,36,57,104109,0,2777,106886,12.47%,12.80%,
107/03/29,-344,0,9,-335,104231,0,2741,106972,12.49%,12.82%,
107/03/28,-493,0,74,-419,104575,0,2732,107307,12.53%,12.86%,
107/03/27,-774,0,22,-752,105058,0,2658,107716,12.59%,12.91%,
107/03/26,-236,0,-10,-246,105730,0,2636,108366,12.67%,12.99%,
107/03/23,-32,0,-42,-74,105966,0,2646,108612,12.70%,13.02%,
107/03/22,-43,0,-639,-682,105798,0,2688,108486,12.68%,13.00%,
107/03/21,-25,0,-105,-130,105841,0,3327,109168,12.68%,13.08%,
107/03/20,195,0,0,195,105866,0,3432,109298,12.68%,13.09%,
107/03/19,101,0,-4,97,105671,0,3432,109103,12.66%,13.07%,
107/03/16,-180,-2407,-16,-2603,105603,0,3436,109039,12.65%,13.06%,
107/03/15,129,9,-14,124,105783,2407,3452,111642,12.67%,13.37%,
107/03/14,339,0,-5,334,105398,2398,3466,111262,12.63%,13.33%,
107/03/13,274,0,-3,271,105610,2398,3471,111479,12.65%,13.35%,
107/03/12,52,0,-191,-139,105336,2398,3474,111208,12.62%,13.32%,
107/03/09,52,0,-3,49,105284,2398,3665,111347,12.61%,13.34%,
107/03/08,-51,0,-17,-68,105232,2398,3668,111298,12.61%,13.34%,
107/03/07,-32,0,-55,-87,105283,2398,3685,111366,12.61%,13.34%,
107/03/06,-67,0,-16,-83,105315,2398,3740,111453,12.62%,13.36%,
107/03/05,-562,0,-25,-587,105522,2398,3756,111676,12.64%,13.38%,
107/03/02,-345,9,-57,-393,106084,2398,3781,112263,12.71%,13.45%,
107/03/01,434,0,3,437,106429,2389,3838,112656,12.75%,13.50%,
107/02/27,330,0,-18,312,105995,2389,3835,112219,12.70%,13.45%,
107/02/26,327,0,-10,317,105675,2389,3853,111917,12.66%,13.41%,
107/02/23,1136,0,102,1238,105338,2389,3863,111590,12.62%,13.37%,
107/02/22,740,0,-31,709,104192,2389,3761,110342,12.48%,13.22%,
107/02/21,829,0,-103,726,103252,2389,3792,109433,12.37%,13.11%,
107/02/12,180,0,-61,119,102423,2389,3895,108707,12.27%,13.02%,
107/02/09,593,7,-174,426,102221,2389,3956,108566,12.25%,13.01%,
107/02/08,1047,0,373,1420,101956,2382,4130,108468,12.21%,12.99%,
107/02/07,44,1911,-111,1844,100951,2382,3757,107090,12.09%,12.83%,
107/02/06,710,471,-575,606,100877,471,3868,105216,12.09%,12.61%,
107/02/05,-305,0,-425,-730,100147,0,4443,104590,12.00%,12.53%,
107/02/02,-166,0,-155,-321,100232,0,4868,105100,12.01%,12.59%,
107/02/01,-114,0,-70,-184,100566,0,5023,105589,12.05%,12.65%,
107/01/31,-747,0,-53,-800,100340,0,5093,105433,12.02%,12.63%,
107/01/30,-63,0,57,-6,100203,0,5146,105349,12.00%,12.62%,
107/01/29,861,0,1954,2815,100266,0,5089,105355,12.01%,12.62%,
107/01/26,642,0,19,661,99405,0,3135,102540,11.91%,12.29%,
107/01/25,741,0,-27,714,98763,0,3116,101879,11.83%,12.20%,
107/01/24,890,0,-78,812,98022,0,3143,101165,11.74%,12.12%,
107/01/23,172,0,-22,150,97268,0,3221,100489,11.65%,12.04%,
107/01/22,299,0,-3,296,97086,0,3243,100329,11.63%,12.02%,
107/01/19,510,0,-51,459,96787,0,3246,100033,11.60%,11.99%,
107/01/18,296,0,68,364,96277,0,3297,99574,11.53%,11.93%,
107/01/17,798,0,-11,787,96095,0,3229,99324,11.51%,11.90%,
107/01/16,105,0,-149,-44,95387,0,3240,98627,11.43%,11.82%,
107/01/15,-119,0,58,-61,95282,0,3389,98671,11.41%,11.82%,
107/01/12,301,0,56,357,95401,0,3331,98732,11.43%,11.83%,
107/01/11,111,0,-36,75,95109,0,3275,98384,11.39%,11.78%,
107/01/10,103,0,-2,101,94970,0,3311,98281,11.38%,11.78%,
107/01/09,43,0,40,83,94867,0,3313,98180,11.37%,11.77%,
107/01/08,280,0,201,481,94825,0,3273,98098,11.36%,11.75%,
107/01/05,566,0,-1,565,94742,0,3072,97814,11.35%,11.72%,
107/01/04,198,0,-9,189,94484,0,3073,97557,11.32%,11.69%,
107/01/03,218,0,5,223,94286,0,3082,97368,11.30%,11.67%,
107/01/02,265,0,21,286,94268,0,3077,97345,11.29%,11.66%,
106/12/29,312,0,-40,272,94003,0,3056,97059,11.26%,11.63%,
106/12/28,153,-15,69,207,94075,0,3096,97171,11.27%,11.64%,
106/12/27,172,0,-14,158,93922,9,3027,96958,11.25%,11.61%,
106/12/26,29,0,-1,28,94150,9,3041,97200,11.28%,11.65%,
106/12/25,7,0,-102,-95,94121,9,3042,97172,11.28%,11.65%,
106/12/22,-113,0,23,-90,94131,9,3144,97284,11.28%,11.66%,
106/12/21,105,0,-26,79,94794,9,3121,97924,11.36%,11.74%,
106/12/20,312,0,-407,-95,94689,9,3147,97845,11.34%,11.72%,
106/12/19,365,0,-51,314,94851,9,3554,98414,11.36%,11.79%,
106/12/18,-617,0,-112,-729,94486,9,3605,98100,11.32%,11.75%,
106/12/15,271,0,-38,233,95103,9,3717,98829,11.39%,11.84%,
106/12/14,145,0,-53,92,94936,9,3755,98700,11.37%,11.82%,
106/12/13,372,0,-326,46,94827,9,3808,98644,11.36%,11.82%,
106/12/12,-133,0,-154,-287,94455,9,4134,98598,11.32%,11.82%,
106/12/11,-38,0,891,853,94009,9,4288,98306,11.26%,11.78%,
106/12/08,519,0,-54,465,94573,9,3397,97979,11.33%,11.74%,
106/12/07,585,0,51,636,94443,9,3451,97903,11.31%,11.72%,
106/12/06,171,0,265,436,93858,9,3400,97267,11.24%,11.65%,
106/12/05,764,0,119,883,93687,9,3135,96831,11.22%,11.60%,
106/12/04,146,0,-163,-17,92923,9,3016,95948,11.13%,11.49%,
106/12/01,43,0,-83,-40,92777,9,3179,95965,11.11%,11.49%,
106/11/30,121,0,-120,1,92724,9,3262,95995,11.11%,11.50%,
106/11/29,125,0,488,613,92603,9,3382,95994,11.09%,11.50%,
106/11/28,243,0,0,243,92468,9,2894,95371,11.08%,11.43%,
106/11/27,-362,0,30,-332,92225,9,2894,95128,11.05%,11.40%,
106/11/24,91,0,53,144,92587,9,2864,95460,11.09%,11.43%,
106/11/23,-300,0,-56,-356,92496,9,2811,95316,11.08%,11.42%,
106/11/22,-573,0,-120,-693,92796,9,2867,95672,11.12%,11.46%,
106/11/21,1020,0,514,1534,93369,9,2987,96365,11.19%,11.55%,
106/11/20,1095,0,-105,990,92349,9,2473,94831,11.06%,11.36%,
106/11/17,3,0,-49,-46,91254,9,2578,93841,10.93%,11.24%,
106/11/16,331,0,50,381,91324,9,2627,93960,10.94%,11.26%,
106/11/15,737,0,160,897,90993,9,2577,93579,10.90%,11.21%,
106/11/14,64,0,233,297,90256,9,2417,92682,10.81%,11.10%,
106/11/13,282,0,141,423,90318,9,2184,92511,10.82%,11.08%,
106/11/10,248,0,-22,226,90019,9,2043,92071,10.78%,11.03%,
106/11/09,247,0,117,364,89771,9,2065,91845,10.75%,11.00%,
106/11/08,246,0,-160,86,89626,9,1948,91583,10.74%,10.97%,
106/11/07,-209,0,-84,-293,89350,9,2108,91467,10.70%,10.95%,
106/11/06,1186,0,237,1423,89358,9,2192,91559,10.70%,10.96%,
106/11/03,3,0,-5,-2,88067,9,1955,90031,10.55%,10.79%,
106/11/02,-8,0,-1,-9,88064,9,1960,90033,10.55%,10.79%,
106/11/01,93,0,43,136,88022,9,1961,89992,10.54%,10.78%,
106/10/31,-109,0,-4,-113,87929,9,1918,89856,10.53%,10.76%,
106/10/30,450,0,-92,358,87933,9,1922,89864,10.53%,10.76%,
106/10/27,-418,0,-111,-529,87479,9,2014,89502,10.48%,10.72%,
106/10/26,-154,0,-27,-181,87897,9,2125,90031,10.53%,10.79%,
106/10/25,256,0,205,461,88007,9,2152,90168,10.54%,10.80%,
106/10/24,395,0,-121,274,87564,9,1947,89520,10.49%,10.72%,
106/10/23,-473,0,-50,-523,86954,9,2068,89031,10.42%,10.67%,
106/10/20,-592,0,124,-468,87382,9,2118,89509,10.47%,10.72%,
106/10/19,481,0,-6,475,87723,9,1994,89726,10.51%,10.75%,
106/10/18,-282,0,122,-160,87197,9,2000,89206,10.45%,10.69%,
106/10/17,-578,0,2,-576,87396,9,1878,89283,10.47%,10.70%,
106/10/16,-1169,0,-75,-1244,87924,9,1876,89809,10.53%,10.76%,
106/10/13,-812,0,-10,-822,89093,9,1951,91053,10.67%,10.90%,
106/10/12,-797,0,-211,-1008,89465,9,1961,91435,10.72%,10.96%,
106/10/11,-5188,0,316,-4872,89910,9,2172,92091,10.77%,11.03%,
106/10/06,-629,0,-1,-630,94871,9,1856,96736,11.37%,11.59%,
106/10/05,-781,0,0,-781,95365,9,1857,97231,11.42%,11.64%,
106/10/03,146,-7,-8,131,95918,9,1857,97784,11.49%,11.71%,
106/10/02,-150,0,5,-145,95577,16,1865,97458,11.45%,11.68%,
106/09/30,0,0,0,0,95708,16,1860,97584,11.47%,11.69%,
106/09/29,538,0,-10,528,95708,27,1860,97595,11.47%,11.70%,
106/09/28,-1490,0,40,-1450,95158,27,1870,97055,11.40%,11.63%,
106/09/27,-576,0,-1,-577,96542,27,1830,98399,11.57%,11.79%,
106/09/26,-366,0,-7,-373,97077,27,1831,98935,11.63%,11.85%,
106/09/25,-1541,0,-28,-1569,96948,27,1838,98813,11.61%,11.83%,
106/09/22,-893,0,-4,-897,98382,27,1866,100275,11.79%,12.02%,
106/09/21,-896,0,-4,-900,99089,27,1870,100986,11.87%,12.10%,
106/09/20,-526,0,-16,-542,99982,27,1874,101883,11.98%,12.21%,
106/09/19,-1931,0,13,-1918,100330,27,1890,102247,12.02%,12.25%,
106/09/18,-1199,0,-3,-1202,102032,27,1877,103936,12.22%,12.45%,
106/09/15,287,0,0,287,103151,27,1880,105058,12.36%,12.59%,
106/09/14,-776,0,-39,-815,102648,27,1880,104555,12.30%,12.53%,
106/09/13,-1308,0,5,-1303,103122,27,1919,105068,12.35%,12.58%,
106/09/12,-1371,0,-6,-1377,104199,27,1914,106140,12.48%,12.71%,
106/09/11,-620,0,-35,-655,105560,27,1920,107507,12.65%,12.88%,
106/09/08,-2584,0,0,-2584,105943,27,1955,107925,12.69%,12.93%,
106/09/07,-998,0,-10,-1008,108274,27,1955,110256,12.97%,13.21%,
106/09/06,-1178,0,0,-1178,108992,27,1965,110984,13.06%,13.30%,
106/09/05,-1838,0,-9,-1847,110120,27,1965,112112,13.19%,13.43%,
106/09/04,-1175,0,-114,-1289,111020,27,1974,113021,13.30%,13.54%,
106/09/01,-1714,0,-22,-1736,111938,27,2088,114053,13.41%,13.66%,
106/08/31,-739,0,33,-706,112343,27,2110,114480,13.46%,13.72%,
106/08/30,-752,0,-77,-829,112454,27,2077,114558,13.47%,13.72%,
106/08/29,-1090,0,-151,-1241,112447,27,2154,114628,13.47%,13.73%,
106/08/28,-1867,0,-15,-1882,112525,27,2305,114857,13.48%,13.76%,
106/08/25,-750,0,-66,-816,113900,27,2320,116247,13.65%,13.93%,
106/08/24,742,0,-98,644,115350,27,2386,117763,13.82%,14.11%,
106/08/23,-4272,0,309,-3963,114627,27,2484,117138,13.73%,14.03%,
106/08/22,-2533,0,-12,-2545,118880,27,2175,121082,14.24%,14.50%,
106/08/21,-1232,0,-5,-1237,121413,27,2187,123627,14.55%,14.82%,
106/08/18,-1111,0,12,-1099,122940,27,2192,125159,14.73%,15.00%,
106/08/17,-1202,0,-18,-1220,124626,27,2180,126833,14.93%,15.19%,
106/08/16,-270,0,-2,-272,125828,27,2198,128053,15.08%,15.35%,
106/08/15,-208,0,0,-208,126823,27,2200,129050,15.20%,15.47%,
106/08/14,-1551,0,-46,-1597,126950,27,2200,129177,15.21%,15.48%,
106/08/11,-651,0,-2,-653,128583,27,2246,130856,15.41%,15.68%,
106/08/10,-461,0,30,-431,129127,27,2248,131402,15.47%,15.74%,
106/08/09,-565,0,-93,-658,129572,27,2218,131817,15.52%,15.79%,
106/08/08,-1103,0,48,-1055,130062,27,2311,132400,15.58%,15.86%,
106/08/07,-430,0,38,-392,131156,27,2263,133446,15.71%,15.98%,
106/08/04,-556,0,0,-556,131586,27,2225,133838,15.77%,16.04%,
106/08/03,-720,0,-28,-748,132142,27,2225,134394,15.83%,16.10%,
106/08/02,-565,0,8,-557,132817,27,2253,135097,15.91%,16.18%,
106/08/01,37,0,0,37,133289,27,2245,135561,15.97%,16.24%,
106/07/31,-1545,0,8,-1537,133348,27,2245,135620,15.98%,16.25%,
106/07/28,-40,0,-67,-107,134253,27,2237,136517,16.09%,16.36%,
106/07/27,-373,0,47,-326,134457,27,2304,136788,16.11%,16.39%,
106/07/26,-550,0,-52,-602,134830,27,2257,137114,16.15%,16.42%,
106/07/25,-267,0,0,-267,135197,27,2309,137533,16.20%,16.48%,
106/07/24,-151,0,0,-151,135464,27,2309,137800,16.23%,16.51%,
106/07/21,-467,0,38,-429,135603,27,2309,137939,16.25%,16.53%,
106/07/20,-456,0,0,-456,136297,27,2271,138595,16.33%,16.61%,
106/07/19,-253,0,249,-4,136776,27,2271,139074,16.39%,16.67%,
106/07/18,-388,0,-78,-466,137019,27,2022,139068,16.42%,16.67%,
106/07/17,-583,0,4,-579,137166,27,2100,139293,16.43%,16.68%,
106/07/14,-1046,0,-92,-1138,137749,27,2096,139872,16.50%,16.75%,
106/07/13,-179,0,-52,-231,138795,27,2188,141010,16.63%,16.90%,
106/07/12,-18,0,-11,-29,138974,27,2240,141241,16.65%,16.92%,
106/07/11,-334,0,3,-331,138992,27,2251,141270,16.65%,16.92%,
106/07/10,-634,0,-17,-651,139951,27,2248,142226,16.77%,17.04%,
106/07/07,-170,0,-6,-176,140585,27,2265,142877,16.84%,17.11%,
106/07/06,-253,0,0,-253,140755,27,2271,143053,16.86%,17.14%,
106/07/05,-47,0,0,-47,141008,27,2271,143306,16.90%,17.18%,
106/07/04,199,0,-156,43,141055,27,2271,143353,16.90%,17.18%,
106/07/03,488,0,0,488,140856,27,2427,143310,16.88%,17.17%,
106/06/30,-238,6,-13,-245,140263,27,2427,142717,16.81%,17.10%,
106/06/29,116,0,-4,112,140421,2,2440,142863,16.82%,17.11%,
106/06/28,-239,0,-6,-245,140305,2,2444,142751,16.81%,17.10%,
106/06/27,-324,0,0,-324,140544,2,2450,142996,16.84%,17.13%,
106/06/26,-199,0,37,-162,140868,2,2450,143320,16.88%,17.17%,
106/06/23,-113,0,-6,-119,141332,2,2413,143747,16.93%,17.22%,
106/06/22,-57,0,16,-41,141345,2,2419,143766,16.94%,17.23%,
106/06/21,677,0,184,861,141302,2,2403,143707,16.93%,17.22%,
106/06/20,109,0,-69,40,140545,2,2219,142766,16.84%,17.11%,
106/06/19,154,0,3,157,140436,2,2288,142726,16.83%,17.10%,
106/06/16,-236,0,-85,-321,140282,2,2285,142569,16.81%,17.08%,
106/06/15,-766,0,-43,-809,140493,2,2370,142865,16.83%,17.11%,
106/06/14,-663,0,-47,-710,141259,2,2413,143674,16.93%,17.22%,
106/06/13,-345,0,33,-312,141912,2,2460,144374,17.00%,17.30%,
106/06/12,-65,0,-11,-76,142257,2,2427,144686,17.04%,17.33%,
106/06/09,-531,0,-2,-533,142367,2,2438,144807,17.06%,17.35%,
106/06/08,-421,0,3,-418,142899,2,2440,145341,17.12%,17.41%,
106/06/07,-375,0,7,-368,143336,2,2437,145775,17.17%,17.46%,
106/06/06,-292,-11,10,-293,143428,2,2430,145860,17.19%,17.48%,
106/06/05,-316,-7,0,-323,143545,13,2420,145978,17.20%,17.49%,
106/06/03,0,0,0,0,143706,20,2420,146146,17.22%,17.51%,
106/06/02,194,0,12,206,143706,20,2420,146146,17.22%,17.51%,
106/06/01,124,0,-1,123,143513,20,2408,145941,17.20%,17.49%,
106/05/31,-727,0,0,-727,143373,20,2409,145802,17.18%,17.47%,
106/05/26,-203,0,-40,-243,144100,20,2409,146529,17.27%,17.56%,
106/05/25,-884,0,-2,-886,144303,20,2449,146772,17.29%,17.59%,
106/05/24,-295,0,-10,-305,145340,20,2451,147811,17.41%,17.71%,
106/05/23,-227,0,-34,-261,145635,20,2461,148116,17.45%,17.75%,
106/05/22,-273,0,0,-273,145861,20,2495,148376,17.48%,17.78%,
106/05/19,-858,0,31,-827,145978,20,2495,148493,17.49%,17.79%,
106/05/18,-241,0,-18,-259,146738,20,2464,149222,17.58%,17.88%,
106/05/17,-329,0,255,-74,146936,20,2482,149438,17.61%,17.91%,
106/05/16,-652,0,9,-643,147071,20,2227,149318,17.62%,17.89%,
106/05/15,-405,0,-101,-506,147623,20,2218,149861,17.69%,17.96%,
106/05/12,-805,0,117,-688,147973,20,2319,150312,17.73%,18.01%,
106/05/11,-156,0,-25,-181,148701,20,2202,150923,17.82%,18.09%,
106/05/10,-632,0,-13,-645,148812,20,2227,151059,17.83%,18.10%,
106/05/09,-618,0,-90,-708,149364,20,2240,151624,17.90%,18.17%,
106/05/08,-329,0,63,-266,149856,20,2330,152206,17.96%,18.24%,
106/05/05,-179,0,-43,-222,150185,20,2267,152472,18.00%,18.27%,
106/05/04,-137,0,-23,-160,150259,20,2310,152589,18.00%,18.28%,
106/05/03,-23,0,-26,-49,150371,20,2333,152724,18.02%,18.30%,
106/05/02,-117,0,-149,-266,150354,20,2359,152733,18.02%,18.31%,
106/04/28,46,0,224,270,150471,20,2508,152999,18.03%,18.33%,
106/04/27,-173,0,-2,-175,150425,20,2284,152729,18.02%,18.30%,
106/04/26,-298,0,-7,-305,150598,20,2286,152904,18.04%,18.32%,
106/04/25,-232,0,-25,-257,150897,20,2293,153210,18.08%,18.36%,
106/04/24,-4,0,-56,-60,151129,20,2318,153467,18.11%,18.39%,
106/04/21,-637,0,1,-636,151133,20,2374,153527,18.11%,18.40%,
106/04/20,-117,0,-23,-140,151769,20,2373,154162,18.18%,18.47%,
106/04/19,-1216,0,-193,-1409,151686,20,2396,154102,18.17%,18.46%,
106/04/18,-212,0,-23,-235,152802,20,2589,155411,18.31%,18.62%,
106/04/17,-174,0,-89,-263,152914,20,2612,155546,18.32%,18.64%,
106/04/14,-397,-1,-172,-570,153088,20,2701,155809,18.34%,18.67%,
106/04/13,-827,0,-221,-1048,153486,21,2873,156380,18.39%,18.74%,
106/04/12,-1192,0,211,-981,154313,21,3094,157428,18.49%,18.86%,
106/04/11,-815,0,-88,-903,155505,21,2883,158409,18.63%,18.98%,
106/04/10,-2107,0,-60,-2167,156320,21,2971,159312,18.73%,19.09%,
106/04/07,-932,0,68,-864,158427,21,3031,161479,18.98%,19.35%,
106/04/06,-603,0,-16,-619,159359,21,2963,162343,19.09%,19.45%,
106/04/05,-1388,0,-72,-1460,159962,21,2979,162962,19.17%,19.53%,
106/03/31,-1541,0,-146,-1687,161350,21,3051,164422,19.33%,19.70%,
106/03/30,-370,0,30,-340,162891,0,3197,166088,19.52%,19.90%,
106/03/29,-407,0,-26,-433,163261,0,3167,166428,19.56%,19.94%,
106/03/28,-674,0,-66,-740,163668,0,3193,166861,19.61%,19.99%,
106/03/27,-1441,0,-52,-1493,164342,0,3259,167601,19.69%,20.08%,
106/03/24,-232,0,5,-227,165783,0,3311,169094,19.86%,20.26%,
106/03/23,-153,0,-110,-263,166015,0,3306,169321,19.89%,20.29%,
106/03/22,108,0,-187,-79,166168,0,3416,169584,19.91%,20.32%,
106/03/21,-247,-59,-168,-474,166060,0,3603,169663,19.90%,20.33%,
106/03/20,-122,-61,-845,-1028,166307,0,3771,170078,19.93%,20.38%,
106/03/17,-95,0,-47,-142,166429,47,4616,171092,19.94%,20.50%,
106/03/16,-912,0,765,-147,166524,47,4663,171234,19.95%,20.51%,
106/03/15,-179,0,-157,-336,167436,47,3898,171381,20.06%,20.53%,
106/03/14,-929,0,-64,-993,167615,47,4055,171717,20.08%,20.57%,
106/03/13,-475,0,-110,-585,168544,47,4119,172710,20.20%,20.70%,
106/03/10,-571,0,-597,-1168,169019,47,4229,173295,20.25%,20.76%,
106/03/09,-423,0,1695,1272,169590,47,4826,174463,20.32%,20.90%,
106/03/08,54,0,31,85,170013,47,3131,173191,20.37%,20.75%,
106/03/07,-49,0,-2,-51,169949,47,3100,173096,20.36%,20.74%,
106/03/06,63,0,41,104,169998,47,3102,173147,20.37%,20.75%,
106/03/03,230,0,-48,182,169935,47,3061,173043,20.36%,20.73%,
106/03/02,852,0,-75,777,169705,47,3109,172861,20.33%,20.71%,
106/03/01,388,0,-26,362,168853,47,3184,172084,20.23%,20.62%,
106/02/24,131,0,3,134,168465,47,3210,171722,20.19%,20.58%,
106/02/23,339,0,-96,243,168334,47,3207,171588,20.17%,20.56%,
106/02/22,-274,0,4,-270,167995,47,3303,171345,20.13%,20.53%,
106/02/21,527,0,-401,126,168269,47,3299,171615,20.16%,20.56%,
106/02/20,9,0,713,722,167742,47,3700,171489,20.10%,20.55%,
106/02/18,0,0,-6,-6,167733,47,2987,170767,20.10%,20.46%,
106/02/17,106,0,-1,105,167733,47,2993,170773,20.10%,20.46%,
106/02/16,-984,0,-88,-1072,167637,47,2994,170678,20.09%,20.45%,
106/02/15,-481,0,-5,-486,168621,47,3082,171750,20.20%,20.58%,
106/02/14,536,0,-66,470,169102,47,3087,172236,20.26%,20.64%,
106/02/13,-510,0,-44,-554,168565,47,3153,171765,20.20%,20.58%,
106/02/10,-765,0,-6,-771,169075,47,3197,172319,20.26%,20.65%,
106/02/09,-432,0,29,-403,169840,47,3203,173090,20.35%,20.74%,
106/02/08,-960,0,-24,-984,170271,47,3174,173492,20.40%,20.79%,
106/02/07,-523,0,-79,-602,171231,47,3198,174476,20.52%,20.91%,
106/02/06,209,0,141,350,171754,47,3277,175078,20.58%,20.98%,
106/02/03,-1054,11,-33,-1076,172055,47,3136,175238,20.62%,21.00%,
106/02/02,-421,0,7,-414,173189,36,3169,176394,20.75%,21.13%,
106/01/24,-647,0,21,-626,173610,36,3162,176808,20.80%,21.18%,
106/01/23,-226,1,-86,-311,174257,36,3141,177434,20.88%,21.26%,
106/01/20,-1700,0,148,-1552,174483,35,3227,177745,20.91%,21.30%,
106/01/19,-318,0,-61,-379,176183,35,3079,179297,21.11%,21.48%,
106/01/18,-482,0,35,-447,176501,35,3140,179676,21.15%,21.53%,
106/01/17,38,0,-1,37,176981,35,3105,180121,21.21%,21.59%,
106/01/16,-457,0,-52,-509,176943,35,3106,180084,21.20%,21.58%,
106/01/13,-349,0,-7,-356,177400,35,3158,180593,21.26%,21.64%,
106/01/12,-710,0,-94,-804,177749,35,3165,180949,21.30%,21.68%,
106/01/11,509,0,-48,461,178379,35,3259,181673,21.37%,21.76%,
106/01/10,-339,0,-224,-563,177870,35,3307,181212,21.31%,21.71%,
106/01/09,1317,0,198,1515,178209,35,3531,181775,21.35%,21.78%,
106/01/06,-1001,15,71,-915,176892,35,3333,180260,21.20%,21.60%,
106/01/05,560,20,4,584,177893,20,3262,181175,21.32%,21.71%,
106/01/04,-353,0,-20,-373,177333,0,3258,180591,21.25%,21.64%,
106/01/03,378,0,118,496,177686,0,3278,180964,21.29%,21.68%,
105/12/30,-87,0,-80,-167,177308,0,3160,180468,21.25%,21.63%,
105/12/29,191,0,-92,99,177395,0,3240,180635,21.26%,21.65%,
105/12/28,347,0,-21,326,177204,0,3332,180536,21.23%,21.63%,
105/12/27,181,0,42,223,176857,0,3353,180210,21.19%,21.59%,
105/12/26,-60,0,-38,-98,176893,0,3311,180204,21.20%,21.60%,
105/12/23,-159,0,-17,-176,176953,0,3349,180302,21.20%,21.60%,
105/12/22,-61,0,-19,-80,177112,0,3366,180478,21.22%,21.62%,
105/12/21,-419,0,5,-414,177173,0,3385,180558,21.23%,21.64%,
105/12/20,-623,0,-410,-1033,177592,0,3380,180972,21.28%,21.69%,
105/12/19,-875,0,673,-202,178215,0,3790,182005,21.35%,21.80%,
105/12/16,-388,0,12,-376,179080,0,3117,182197,21.46%,21.83%,
105/12/15,-739,0,-42,-781,179468,0,3105,182573,21.50%,21.87%,
105/12/14,-24,0,-102,-126,180187,0,3147,183334,21.59%,21.97%,
105/12/13,-302,0,-13,-315,179701,0,3249,182950,21.53%,21.92%,
105/12/12,-757,0,116,-641,180003,0,3262,183265,21.57%,21.96%,
105/12/09,-944,0,9,-935,180760,0,3146,183906,21.66%,22.04%,
105/12/08,-117,0,15,-102,181704,0,3137,184841,21.77%,22.15%,
105/12/07,-1931,0,-99,-2030,181821,0,3122,184943,21.79%,22.16%,
105/12/06,-375,0,-19,-394,183752,0,3221,186973,22.02%,22.41%,
105/12/05,-660,0,19,-641,184082,0,3240,187322,22.06%,22.45%,
105/12/02,-1002,0,-20,-1022,184442,0,3221,187663,22.10%,22.49%,
105/12/01,-557,0,46,-511,185415,0,3241,188656,22.22%,22.61%,
105/11/30,-6,0,21,15,185957,0,3195,189152,22.28%,22.66%,
105/11/29,-736,0,-72,-808,185963,0,3174,189137,22.28%,22.66%,
105/11/28,-885,0,137,-748,186618,0,3246,189864,22.36%,22.75%,
105/11/25,-142,0,17,-125,187458,0,3109,190567,22.46%,22.83%,
105/11/24,-473,0,-19,-492,187600,0,3092,190692,22.48%,22.85%,
105/11/23,-934,0,-25,-959,188073,0,3111,191184,22.54%,22.91%,
105/11/22,-1103,0,12,-1091,189007,0,3136,192143,22.65%,23.03%,
105/11/21,-987,0,123,-864,190110,0,3124,193234,22.78%,23.15%,
105/11/18,-1747,0,-93,-1840,191097,0,3001,194098,22.90%,23.26%,
105/11/17,-2213,0,-129,-2342,192883,0,3094,195977,23.11%,23.48%,
105/11/16,-958,0,-171,-1129,195096,0,3223,198319,23.38%,23.77%,
105/11/15,-378,0,-6,-384,196054,0,3394,199448,23.49%,23.90%,
105/11/14,76,0,-622,-546,196432,0,3400,199832,23.54%,23.95%,
105/11/11,-793,0,-359,-1152,196356,0,4022,200378,23.53%,24.01%,
105/11/10,191,0,185,376,197120,0,4381,201501,23.62%,24.15%,
105/11/09,180,0,-833,-653,196929,0,4196,201125,23.60%,24.10%,
105/11/08,589,0,664,1253,196749,0,5029,201778,23.58%,24.18%,
105/11/07,-347,0,42,-305,196160,0,4365,200525,23.51%,24.03%,
105/11/04,758,0,-130,628,196507,0,4323,200830,23.55%,24.07%,
105/11/03,937,0,-636,301,195749,0,4453,200202,23.46%,23.99%,
105/11/02,-1275,0,-942,-2217,194787,0,5089,199876,23.34%,23.95%,
105/11/01,-885,0,-211,-1096,196048,0,6031,202079,23.49%,24.21%,
105/10/31,583,0,-75,508,196931,0,6242,203173,23.60%,24.35%,
105/10/28,898,0,-268,630,196348,0,6317,202665,23.53%,24.29%,
105/10/27,262,0,100,362,195450,0,6585,202035,23.42%,24.21%,
105/10/26,927,0,-347,580,195188,0,6485,201673,23.39%,24.17%,
105/10/25,608,0,-281,327,194261,0,6832,201093,23.28%,24.10%,
105/10/24,1986,0,-12,1974,193786,0,7113,200899,23.22%,24.07%,
105/10/21,-629,-107,127,-609,191800,0,7125,198925,22.98%,23.83%,
105/10/20,257,-106,-140,11,192429,0,6998,199427,23.06%,23.90%,
105/10/19,706,0,1052,1758,192172,28,7138,199338,23.03%,23.89%,
105/10/18,1779,0,-231,1548,191456,28,6086,197570,22.94%,23.67%,
105/10/17,607,0,-322,285,189739,28,6317,196084,22.74%,23.50%,
105/10/14,1611,0,-798,813,189091,28,6639,195758,22.66%,23.46%,
105/10/13,1738,0,2734,4472,187480,28,7437,194945,22.46%,23.35%,
105/10/12,1891,0,48,1939,185742,28,4703,190473,22.26%,22.83%,
105/10/11,900,0,163,1063,183851,28,4655,188534,22.03%,22.59%,
105/10/07,1042,0,98,1140,182951,28,4492,187471,21.92%,22.46%,
105/10/06,356,0,36,392,181909,28,4394,186331,21.80%,22.33%,
105/10/05,800,0,-209,591,181755,28,4358,186141,21.78%,22.31%,
105/10/04,1790,0,383,2173,180955,28,4567,185550,21.68%,22.23%,
105/10/03,610,0,-3,607,179165,28,4184,183377,21.47%,21.97%,
105/09/30,129,-2,-120,7,178555,28,4187,182770,21.40%,21.91%,
105/09/29,2756,0,-404,2352,178421,0,4307,182728,21.38%,21.90%,
105/09/26,1798,0,564,2362,175665,0,4711,180376,21.05%,21.61%,
105/09/23,1033,0,150,1183,173867,0,4147,178014,20.83%,21.33%,
105/09/22,1862,0,-17,1845,172834,0,3997,176831,20.71%,21.19%,
105/09/21,2136,0,-841,1295,170972,0,4014,174986,20.49%,20.97%,
105/09/20,3792,0,307,4099,168836,0,4855,173691,20.23%,20.81%,
105/09/19,2230,0,633,2863,164982,0,4548,169530,19.77%,20.32%,
105/09/14,476,-120,-116,240,162752,0,3915,166667,19.50%,19.97%,
105/09/13,1766,0,-283,1483,162276,27,4031,166334,19.44%,19.93%,
105/09/12,555,0,-682,-127,160510,27,4314,164851,19.23%,19.75%,
105/09/10,-10,0,-533,-543,159955,27,4996,164978,19.17%,19.77%,
105/09/09,856,0,763,1619,159965,27,5529,165521,19.17%,19.84%,
105/09/08,2147,-2,-30,2115,159109,27,4766,163902,19.06%,19.63%,
105/09/07,2131,0,160,2291,156962,29,4796,161787,18.81%,19.39%,
105/09/06,904,0,-496,408,154831,29,4636,159496,18.55%,19.11%,
105/09/05,580,0,639,1219,153927,29,5132,159088,18.44%,19.06%,
105/09/02,1180,0,-24,1156,153578,29,4493,158100,18.40%,18.94%,
105/09/01,1037,0,-158,879,152440,29,4517,156986,18.27%,18.81%,
105/08/31,2677,0,-203,2474,151403,29,4675,156107,18.14%,18.70%,
105/08/30,466,0,-516,-50,148726,29,4878,153633,17.82%,18.41%,
105/08/29,4277,-1,27,4303,148218,29,5394,153641,17.76%,18.41%,
105/08/26,3292,0,204,3496,144057,30,5367,149454,17.26%,17.91%,
105/08/25,1921,-10,-870,1041,140765,30,5163,145958,16.87%,17.49%,
105/08/24,4149,-5,-193,3951,140054,40,6033,146127,16.78%,17.51%,
105/08/23,3635,-1,2281,5915,135890,45,6226,142161,16.28%,17.03%,
105/08/22,2325,-49,-65,2211,131915,46,3945,135906,15.81%,16.29%,
105/08/19,3010,0,238,3248,129443,95,4010,133548,15.51%,16.00%,
105/08/18,1859,-2,-96,1761,126340,95,3772,130207,15.14%,15.60%,
105/08/17,1261,0,-177,1084,124386,97,3868,128351,14.90%,15.38%,
105/08/16,1636,-6,-683,947,123125,97,4045,127267,14.75%,15.25%,
105/08/15,1634,0,603,2237,121489,103,4728,126320,14.56%,15.14%,
105/08/12,986,3,40,1029,119855,103,4125,124083,14.36%,14.87%,
105/08/11,1432,-2,-80,1350,118869,100,4085,123054,14.24%,14.74%,
105/08/10,1236,0,-26,1210,117437,102,4165,121704,14.07%,14.58%,
105/08/09,1740,0,-229,1511,116201,102,4191,120494,13.92%,14.43%,
105/08/08,226,-5,-324,-103,114461,102,4420,118983,13.71%,14.25%,
105/08/05,-120,-3,-58,-181,114235,107,4744,119086,13.69%,14.27%,
105/08/04,902,-1,-1083,-182,114355,110,4802,119267,13.70%,14.29%,
105/08/03,565,-6,1062,1621,113453,111,5885,119449,13.59%,14.31%,
105/08/02,260,0,-94,166,112888,117,4823,117828,13.52%,14.11%,
105/08/01,34,0,-9,25,112628,117,4917,117662,13.49%,14.09%,
105/07/29,1615,-10,-995,610,112594,117,4926,117637,13.49%,14.09%,
105/07/28,-2427,0,-353,-2780,110979,127,5921,117027,13.30%,14.02%,
105/07/27,-952,-3,2096,1141,113406,127,6274,119807,13.59%,14.36%,
105/07/26,-22,0,-24,-46,114358,130,4178,118666,13.70%,14.22%,
105/07/25,-684,0,336,-348,114380,130,4202,118712,13.70%,14.22%,
105/07/22,-44,-13,-31,-88,115064,130,3866,119060,13.79%,14.27%,
105/07/21,27,-11,-322,-306,115108,143,3897,119148,13.79%,14.27%,
105/07/20,-244,-10,-182,-436,115120,154,4219,119493,13.79%,14.31%,
105/07/19,-187,-1,19,-169,115364,164,4401,119929,13.82%,14.37%,
105/07/18,-861,42,-995,-1814,115551,165,4382,120098,13.84%,14.38%,
105/07/15,3083,0,812,3895,116373,123,5377,121873,13.94%,14.60%,
105/07/14,385,-1,-436,-52,113290,123,4565,117978,13.57%,14.13%,
105/07/13,1888,0,-1942,-54,112905,124,5001,118030,13.53%,14.14%,
105/07/12,-2459,0,1547,-912,111707,124,6943,118774,13.38%,14.23%,
105/07/11,-1411,0,985,-426,114166,124,5396,119686,13.68%,14.34%,
105/07/07,-174,120,-504,-558,115577,124,4411,120112,13.85%,14.39%,
105/07/06,2229,-45,848,3032,115751,4,4915,120670,13.87%,14.46%,
105/07/05,188,0,-372,-184,113522,49,4067,117638,13.60%,14.09%,
105/07/04,8,0,1176,1184,113344,49,4439,117832,13.58%,14.12%,
105/07/01,345,0,258,603,113336,49,3263,116648,13.58%,13.98%,
105/06/30,158,0,-297,-139,112991,49,3005,116045,13.54%,13.91%,
105/06/29,-503,0,91,-412,112887,266,3302,116455,13.52%,13.95%,
105/06/28,-862,2,135,-725,113390,266,3211,116867,13.59%,14.01%,
105/06/27,-107,48,-68,-127,114252,264,3076,117592,13.69%,14.09%,
105/06/24,-478,50,-131,-559,114359,216,3144,117719,13.70%,14.10%,
105/06/23,74,0,36,110,114837,166,3275,118278,13.76%,14.17%,
105/06/22,129,0,-11,118,114763,166,3239,118168,13.75%,14.16%,
105/06/21,-26,0,28,2,114634,166,3250,118050,13.73%,14.14%,
105/06/20,239,0,-86,153,114660,166,3222,118048,13.74%,14.15%,
105/06/17,86,0,-141,-55,114421,166,3308,117895,13.71%,14.13%,
105/06/16,77,0,-405,-328,114335,166,3449,117950,13.70%,14.13%,
105/06/15,76,0,867,943,114258,166,3854,118278,13.69%,14.17%,
105/06/14,246,0,18,264,114172,166,2987,117325,13.68%,14.06%,
105/06/13,164,0,-72,92,113926,166,2969,117061,13.65%,14.03%,
105/06/08,-270,-100,-41,-411,113762,166,3041,116969,13.63%,14.01%,
105/06/07,-101,0,41,-60,114064,266,3082,117412,13.67%,14.07%,
105/06/06,-52,-100,38,-114,114121,266,3041,117428,13.67%,14.07%,
105/06/04,5,-100,-19,-114,114141,366,3003,117510,13.68%,14.08%,
105/06/03,-123,0,55,-68,114136,466,3022,117624,13.67%,14.09%,
105/06/02,419,0,10,429,114259,466,2967,117692,13.69%,14.10%,
105/06/01,170,-34,20,156,113840,466,2957,117263,13.64%,14.05%,
105/05/31,99,0,0,99,113670,500,2937,117107,13.62%,14.03%,
105/05/30,60,0,43,103,113571,500,2937,117008,13.61%,14.02%,
105/05/27,290,0,-15,275,113511,500,2894,116905,13.60%,14.01%,
105/05/26,575,-3,26,598,113221,500,2909,116630,13.56%,13.97%,
105/05/25,29,0,4,33,112646,503,2883,116032,13.50%,13.91%,
105/05/24,-4,0,9,5,112617,503,2879,115999,13.49%,13.90%,
105/05/23,-3,-67,14,-56,112621,503,2870,115994,13.49%,13.89%,
105/05/20,-404,-101,4,-501,112624,570,2856,116050,13.49%,13.90%,
105/05/19,192,-60,-28,104,113028,671,2852,116551,13.54%,13.96%,
105/05/18,98,0,-173,-75,112836,731,2880,116447,13.52%,13.95%,
105/05/17,403,-50,35,388,112738,731,3053,116522,13.51%,13.96%,
105/05/16,350,0,-87,263,112335,781,3018,116134,13.46%,13.92%,
105/05/13,492,0,26,518,111985,781,3105,115871,13.42%,13.89%,
105/05/12,250,0,88,338,111493,781,3079,115353,13.36%,13.82%,
105/05/11,414,0,-308,106,111243,781,2991,115015,13.33%,13.78%,
105/05/10,195,-2,49,242,110797,781,3299,114877,13.27%,13.76%,
105/05/09,-66,0,12,-54,110602,783,3250,114635,13.25%,13.73%,
105/05/06,-395,0,48,-347,110668,783,3238,114689,13.26%,13.74%,
105/05/05,102,0,270,372,111063,783,3190,115036,13.31%,13.79%,
105/05/04,323,0,8,331,110961,783,2920,114664,13.29%,13.73%,
105/05/03,-251,34,-17,-234,110638,783,2912,114333,13.26%,13.70%,
105/04/29,1251,0,54,1305,110889,749,2929,114567,13.29%,13.73%,
105/04/28,652,0,-37,615,109638,749,2875,113262,13.14%,13.57%,
105/04/27,299,0,-26,273,108986,749,2912,112647,13.06%,13.50%,
105/04/26,1158,0,-8,1150,108677,749,2938,112364,13.02%,13.46%,
105/04/25,1121,-1,13,1133,107519,749,2946,111214,12.88%,13.32%,
105/04/22,592,0,-6,586,106398,750,2933,110081,12.75%,13.19%,
105/04/21,533,0,50,583,105806,750,2939,109495,12.68%,13.12%,
105/04/20,212,0,37,249,105273,750,2889,108912,12.61%,13.05%,
105/04/19,1666,45,21,1732,105149,750,2852,108751,12.60%,13.03%,
105/04/18,853,0,-159,694,103483,705,2831,107019,12.40%,12.82%,
105/04/15,1665,68,176,1909,102630,705,2990,106325,12.30%,12.74%,
105/04/14,1410,0,-81,1329,100965,637,2814,104416,12.10%,12.51%,
105/04/13,1114,500,116,1730,99564,637,2895,103096,11.93%,12.35%,
105/04/12,-207,4,-98,-301,98426,137,2779,101342,11.79%,12.14%,
105/04/11,894,0,232,1126,98569,133,2877,101579,11.81%,12.17%,
105/04/08,189,0,-8,181,97675,133,2645,100453,11.70%,12.03%,
105/04/07,355,0,167,522,97486,133,2653,100272,11.68%,12.01%,
105/04/06,1903,0,11,1914,97131,133,2486,99750,11.64%,11.95%,
105/04/01,1580,0,120,1700,95228,133,2475,97836,11.41%,11.72%,
105/03/31,1046,0,11,1057,93648,133,2355,96136,11.22%,11.52%,
105/03/30,790,0,0,790,92602,0,2344,94946,11.09%,11.37%,
105/03/29,657,-1,-3,653,91812,0,2344,94156,11.00%,11.28%,
105/03/28,214,0,2,216,91155,0,2347,93502,10.92%,11.20%,
105/03/25,154,-214,0,-60,90941,0,2345,93286,10.89%,11.17%,
105/03/24,581,0,64,645,90787,0,2345,93132,10.88%,11.16%,
105/03/23,1050,-50,2,1002,90206,0,2281,92487,10.81%,11.08%,
105/03/22,584,-50,-274,260,89156,0,2279,91435,10.68%,10.95%,
105/03/21,-90,-30,0,-120,89216,45,2553,91814,10.69%,11.00%,
105/03/18,-6195,0,2,-6193,89476,75,2553,92104,10.72%,11.03%,
105/03/17,-3996,-20,47,-3969,95443,75,2551,98069,11.43%,11.74%,
105/03/16,-588,0,53,-535,99620,95,2504,102219,11.93%,12.24%,
105/03/15,-609,-1,74,-536,100208,95,2451,102754,12.01%,12.32%,
105/03/14,-945,0,68,-877,100808,96,2377,103281,12.08%,12.38%,
105/03/11,-304,0,92,-212,101710,96,2309,104115,12.19%,12.48%,
105/03/10,151,0,-4,147,101858,96,2217,104171,12.20%,12.48%,
105/03/09,271,-22,7,256,101697,96,2221,104014,12.18%,12.46%,
105/03/08,297,-1,-19,277,101379,118,2214,103711,12.15%,12.43%,
105/03/07,51,0,-3,48,101082,119,2233,103434,12.11%,12.39%,
105/03/04,693,0,-7,686,101021,119,2236,103376,12.10%,12.38%,
105/03/03,174,0,-3,171,100328,119,2243,102690,12.02%,12.30%,
105/03/02,-6,-1,0,-7,100154,119,2246,102519,12.00%,12.28%,
105/03/01,-9,0,0,-9,100243,120,2246,102609,12.01%,12.29%,
105/02/26,67,0,0,67,100252,120,2246,102618,12.01%,12.29%,
105/02/25,-47,0,0,-47,100114,120,2246,102480,11.99%,12.27%,
105/02/24,28,0,-8,20,99970,120,2246,102336,11.98%,12.26%,
105/02/23,-284,0,-3,-287,99942,120,2254,102316,11.97%,12.25%,
105/02/22,-256,0,-1,-257,100626,120,2257,103003,12.06%,12.34%,
105/02/19,-13,1,0,-12,100882,120,2258,103260,12.09%,12.38%,
105/02/18,-111,0,0,-111,100895,119,2258,103272,12.09%,12.37%,
105/02/17,-249,0,15,-234,100923,119,2258,103300,12.09%,12.37%,
105/02/16,-403,0,15,-388,101172,119,2243,103534,12.12%,12.40%,
105/02/15,-294,1,1,-292,101575,119,2228,103922,12.17%,12.45%,
105/02/03,-7,0,0,-7,101869,118,2227,104214,12.20%,12.48%,
105/02/02,487,0,0,487,102001,118,2227,104346,12.22%,12.50%,
105/02/01,78,0,-4,74,101513,118,2227,103858,12.16%,12.44%,
105/01/30,0,16,4,20,101435,118,2231,103784,12.15%,12.43%,
105/01/29,-176,0,-4,-180,101435,102,2227,103764,12.15%,12.43%,
105/01/28,8,0,0,8,101569,102,2231,103902,12.17%,12.45%,
105/01/27,110,0,0,110,101561,102,2231,103894,12.17%,12.45%,
105/01/26,29,0,-1,28,101451,102,2231,103784,12.15%,12.43%,
105/01/25,136,0,0,136,101422,102,2232,103756,12.15%,12.43%,
105/01/22,-108,0,14,-94,101286,102,2232,103620,12.13%,12.41%,
105/01/21,59,0,10,69,101394,102,2218,103714,12.15%,12.43%,
105/01/20,65,-14,-7,44,101335,102,2208,103645,12.14%,12.42%,
105/01/19,209,-2,-1,206,101410,116,2215,103741,12.15%,12.43%,
105/01/18,257,0,8,265,101201,118,2216,103535,12.12%,12.40%,
105/01/15,122,-13,-32,77,100944,118,2208,103270,12.09%,12.37%,
105/01/14,166,0,0,166,100786,131,2240,103157,12.07%,12.35%,
105/01/13,227,0,-1,226,100620,131,2240,102991,12.05%,12.33%,
105/01/12,94,0,-11,83,100393,131,2241,102765,12.03%,12.31%,
105/01/11,-149,0,0,-149,100312,131,2252,102695,12.02%,12.31%,
105/01/08,-16,0,2,-14,100451,131,2252,102834,12.03%,12.32%,
105/01/07,-201,0,0,-201,100457,131,2250,102838,12.04%,12.33%,
105/01/06,7,0,2,9,100659,131,2250,103040,12.06%,12.35%,
105/01/05,-261,0,0,-261,100652,131,2248,103031,12.06%,12.35%,
105/01/04,-58,0,-4,-62,100744,131,2248,103123,12.07%,12.36%,
104/12/31,37,0,0,37,100802,131,2252,103185,12.08%,12.37%,
104/12/30,96,0,0,96,100765,122,2252,103139,12.07%,12.35%,
104/12/29,76,54,0,130,100669,122,2252,103043,12.06%,12.34%,
104/12/28,142,55,0,197,100593,68,2252,102913,12.05%,12.33%,
104/12/25,46,0,0,46,100451,13,2252,102716,12.03%,12.30%,
104/12/24,62,0,0,62,100405,13,2252,102670,12.03%,12.30%,
104/12/23,-61,0,0,-61,100343,13,2252,102608,12.02%,12.29%,
104/12/22,54,9,1,64,100404,13,2252,102669,12.03%,12.30%,
104/12/21,171,0,0,171,100394,4,2251,102649,12.03%,12.30%,
104/12/18,142,0,0,142,100223,4,2251,102478,12.01%,12.28%,
104/12/17,221,0,2,223,100081,4,2251,102336,11.99%,12.26%,
104/12/16,40,0,21,61,99860,4,2249,102113,11.96%,12.23%,
104/12/15,136,0,5,141,99873,4,2228,102105,11.97%,12.24%,
104/12/14,-143,4,-6,-145,99727,4,2223,101954,11.95%,12.22%,
104/12/11,471,0,-10,461,99812,0,2229,102041,11.96%,12.23%,
104/12/10,-132,0,-13,-145,99361,0,2239,101600,11.90%,12.17%,
104/12/09,-177,0,-11,-188,99483,0,2252,101735,11.92%,12.19%,
104/12/08,118,0,0,118,99633,0,2263,101896,11.94%,12.21%,
104/12/07,95,0,-2,93,99505,0,2263,101768,11.92%,12.19%,
104/12/04,28,0,-2,26,99410,0,2265,101675,11.91%,12.18%,
104/12/03,-22,0,4,-18,99382,0,2267,101649,11.91%,12.18%,
104/12/02,-86,-68,-6,-160,99693,0,2263,101956,11.94%,12.21%,
104/12/01,77,0,-5,72,99779,11,2269,102059,11.95%,12.22%,
104/11/30,-679,0,16,-663,99701,11,2274,101986,11.94%,12.21%,
104/11/27,-15,0,0,-15,100380,11,2258,102649,12.03%,12.30%,
104/11/26,9,0,0,9,100395,11,2258,102664,12.03%,12.30%,
104/11/25,-125,0,0,-125,100386,11,2258,102655,12.03%,12.30%,
104/11/24,64,0,0,64,100511,11,2258,102780,12.04%,12.31%,
104/11/23,68,0,-1,67,100447,11,2258,102716,12.03%,12.30%,
104/11/20,5,-1,0,4,100379,11,2259,102649,12.03%,12.30%,
104/11/19,109,0,-2,107,100374,12,2259,102645,12.03%,12.30%,
104/11/18,155,0,-2,153,100265,12,2261,102538,12.01%,12.28%,
104/11/17,63,0,2,65,100110,12,2263,102385,11.99%,12.26%,
104/11/16,203,0,-6,197,100047,12,2261,102320,11.99%,12.26%,
104/11/13,-107,0,-1,-108,99912,12,2267,102191,11.97%,12.24%,
104/11/12,-147,0,-14,-161,100019,12,2268,102299,11.98%,12.25%,
104/11/11,-240,0,0,-240,100239,12,2282,102533,12.01%,12.28%,
104/11/10,100,0,0,100,100479,12,2282,102773,12.04%,12.31%,
104/11/09,-90,0,0,-90,100379,12,2282,102673,12.03%,12.30%,
104/11/06,24,0,-2,22,100714,12,2282,103008,12.07%,12.34%,
104/11/05,201,0,18,219,100672,12,2284,102968,12.06%,12.34%,
104/11/04,397,12,3,412,100471,12,2266,102749,12.04%,12.31%,
104/11/03,131,0,21,152,99961,0,2263,102224,11.98%,12.25%,
104/11/02,343,0,0,343,99830,0,2242,102072,11.96%,12.23%,
104/10/30,288,0,-7,281,99441,0,2242,101683,11.91%,12.18%,
104/10/29,-93,0,0,-93,99223,0,2249,101472,11.89%,12.16%,
104/10/28,417,0,0,417,99305,0,2249,101554,11.90%,12.17%,
104/10/27,35,0,0,35,98888,0,2249,101137,11.85%,12.12%,
104/10/26,235,0,0,235,98853,0,2249,101102,11.84%,12.11%,
104/10/23,101,0,0,101,98618,0,2249,100867,11.81%,12.08%,
104/10/22,0,0,0,0,98517,0,2249,100766,11.80%,12.07%,
104/10/21,445,0,13,458,98517,0,2249,100766,11.80%,12.07%,
104/10/20,712,0,21,733,98343,0,2236,100579,11.78%,12.05%,
104/10/19,571,0,-2,569,97631,0,2215,99846,11.70%,11.97%,
104/10/16,-195,-30,0,-225,97060,0,2217,99277,11.63%,11.90%,
104/10/15,249,-30,5,224,97055,0,2217,99272,11.63%,11.90%,
104/10/14,392,-30,4,366,96806,0,2212,99018,11.60%,11.87%,
104/10/13,544,-40,0,504,96143,0,2208,98351,11.52%,11.78%,
104/10/12,13,-20,0,-7,95599,7,2208,97814,11.45%,11.72%,
104/10/08,428,-20,0,408,95576,27,2208,97811,11.45%,11.72%,
104/10/07,-267,-20,0,-287,95148,47,2208,97403,11.40%,11.67%,
104/10/06,356,-20,0,336,95415,67,2208,97690,11.43%,11.70%,
104/10/05,-196,-23,-33,-252,95059,87,2208,97354,11.39%,11.67%,
104/10/02,-314,-1,0,-315,95255,110,2241,97606,11.41%,11.69%,
104/10/01,-3,-10,1,-12,95569,111,2241,97921,11.45%,11.73%,
104/09/30,-541,-10,-1,-552,95562,121,2240,97923,11.45%,11.73%,
104/09/25,-222,0,0,-222,96167,0,2241,98408,11.52%,11.79%,
104/09/24,-236,0,-7,-243,96293,0,2241,98534,11.54%,11.81%,
104/09/23,-87,0,-8,-95,96529,0,2248,98777,11.56%,11.83%,
104/09/22,-319,-6,14,-311,96616,0,2256,98872,11.57%,11.84%,
104/09/21,-276,-1,-8,-285,96725,0,2242,98967,11.59%,11.86%,
104/09/18,-9,-10,4,-15,96979,0,2250,99229,11.62%,11.89%,
104/09/17,-215,-10,3,-222,96788,0,2246,99034,11.60%,11.87%,
104/09/16,87,0,7,94,97003,0,2243,99246,11.62%,11.89%,
104/09/15,-49,-10,1,-58,96806,0,2236,99042,11.60%,11.87%,
104/09/14,-152,0,-13,-165,96855,0,2235,99090,11.60%,11.87%,
104/09/11,83,0,-2,81,97007,0,2248,99255,11.62%,11.89%,
104/09/10,140,-30,0,110,96995,0,2250,99245,11.62%,11.89%,
104/09/09,-102,-30,-33,-165,96475,0,2250,98725,11.56%,11.83%,
104/09/08,134,0,4,138,96741,0,2283,99024,11.59%,11.86%,
104/09/07,65,-49,0,16,96607,0,2279,98886,11.57%,11.84%,
104/09/04,-383,-51,-1,-435,96542,0,2279,98821,11.57%,11.84%,
104/09/03,-66,-118,-1,-185,96925,0,2280,99205,11.61%,11.88%,
104/09/02,-309,0,0,-309,96991,0,2281,99272,11.62%,11.89%,
104/09/01,-41,-13,0,-54,97365,0,2281,99646,11.66%,11.93%,
104/08/31,-446,-8,1,-453,97406,0,2281,99687,11.67%,11.94%,
104/08/28,-409,1,-7,-415,97576,1,2280,99857,11.69%,11.96%,
104/08/27,-434,0,-26,-460,97968,0,2287,100255,11.74%,12.01%,
104/08/26,-383,0,-8,-391,98360,0,2313,100673,11.78%,12.06%,
104/08/25,-307,0,-8,-315,98743,0,2321,101064,11.83%,12.11%,
104/08/24,-227,0,-5,-232,99040,0,2329,101369,11.87%,12.15%,
104/08/21,37,-262,-14,-239,99267,0,2334,101601,11.89%,12.17%,
104/08/20,-280,0,-1,-281,99207,135,2348,101690,11.89%,12.19%,
104/08/19,-398,0,-12,-410,99487,135,2349,101971,11.92%,12.22%,
104/08/18,-137,0,-1,-138,99873,135,2361,102369,11.97%,12.27%,
104/08/17,-265,-138,2,-401,99872,135,2362,102369,11.96%,12.26%,
104/08/14,-321,0,-37,-358,100118,273,2360,102751,11.99%,12.31%,
104/08/13,-319,0,21,-298,100437,273,2397,103107,12.03%,12.35%,
104/08/12,-194,-7,39,-162,100746,273,2376,103395,12.07%,12.39%,
104/08/11,-596,0,-85,-681,100940,280,2337,103557,12.09%,12.40%,
104/08/10,53,0,-14,39,101536,280,2422,104238,12.16%,12.48%,
104/08/07,-100,0,-3,-103,101483,280,2436,104199,12.16%,12.49%,
104/08/06,72,0,2,74,101573,280,2439,104292,12.17%,12.50%,
104/08/05,-1345,0,-56,-1401,101393,280,2437,104110,12.15%,12.48%,
104/08/04,-258,0,-90,-348,102767,280,2493,105540,12.31%,12.64%,
104/08/03,-379,0,215,-164,103316,280,2583,106179,12.38%,12.72%,
104/07/31,-225,0,-20,-245,103695,280,2368,106343,12.42%,12.74%,
104/07/30,-83,0,-11,-94,104039,280,2388,106707,12.46%,12.78%,
104/07/29,-1289,0,-7,-1296,104122,280,2399,106801,12.47%,12.79%,
104/07/28,-33,14,33,14,105411,280,2406,108097,12.63%,12.95%,
104/07/27,-107,0,72,-35,105415,266,2373,108054,12.63%,12.95%,
104/07/24,-132,3,43,-86,105522,266,2301,108089,12.64%,12.95%,
104/07/23,-34,0,3,-31,105354,263,2258,107875,12.62%,12.92%,
104/07/22,-213,0,7,-206,105471,263,2255,107989,12.64%,12.94%,
104/07/21,-249,1,0,-248,105684,263,2248,108195,12.66%,12.96%,
104/07/20,-175,0,-2,-177,105933,262,2248,108443,12.69%,12.99%,
104/07/17,-73,95,0,22,106108,262,2250,108620,12.71%,13.01%,
104/07/16,-182,0,0,-182,106184,167,2250,108601,12.72%,13.01%,
104/07/15,-119,9,17,-93,106383,167,2250,108800,12.75%,13.04%,
104/07/14,-740,0,-9,-749,106526,158,2233,108917,12.76%,13.05%,
104/07/13,-236,0,-10,-246,107266,158,2242,109666,12.85%,13.14%,
104/07/09,-96,0,25,-71,107502,158,2252,109912,12.88%,13.17%,
104/07/08,-409,0,8,-401,107598,158,2227,109983,12.89%,13.18%,
104/07/07,-48,0,21,-27,108007,158,2219,110384,12.94%,13.22%,
104/07/06,-3,0,-1,-4,108025,158,2198,110381,12.94%,13.22%,
104/07/03,-138,0,-11,-149,108028,158,2199,110385,12.94%,13.22%,
104/07/02,-331,0,-2,-333,108166,158,2210,110534,12.96%,13.24%,
104/07/01,-419,0,-3,-422,108497,158,2212,110867,13.00%,13.28%,
104/06/30,6,0,-4,2,108916,158,2215,111289,13.05%,13.33%,
104/06/29,-571,0,3,-568,108910,1563,2219,112692,13.05%,13.50%,
104/06/26,20,0,0,20,109481,1563,2216,113260,13.12%,13.57%,
104/06/25,-270,0,10,-260,109566,1563,2216,113345,13.13%,13.58%,
104/06/24,81,0,1,82,109836,1563,2206,113605,13.16%,13.61%,
104/06/23,-563,0,-3,-566,109772,1563,2205,113540,13.15%,13.60%,
104/06/22,1035,-9,0,1026,110315,1563,2208,114086,13.22%,13.67%,
104/06/18,-203,0,0,-203,109280,1571,2208,113059,13.09%,13.54%,
104/06/17,-387,0,0,-387,109483,1571,2208,113262,13.12%,13.57%,
104/06/16,-348,0,0,-348,109819,1571,2208,113598,13.16%,13.61%,
104/06/15,-7,0,0,-7,110167,1571,2208,113946,13.20%,13.65%,
104/06/12,-319,0,0,-319,109711,1571,2208,113490,13.14%,13.59%,
104/06/11,-201,0,0,-201,110019,1571,2208,113798,13.18%,13.63%,
104/06/10,-247,0,0,-247,110211,1571,2208,113990,13.20%,13.65%,
104/06/09,-170,0,0,-170,110426,1571,2208,114205,13.23%,13.68%,
104/06/08,-337,0,0,-337,110596,1571,2208,114375,13.25%,13.70%,
104/06/05,-350,2,-4,-352,110923,1571,2208,114702,13.29%,13.74%,
104/06/04,-370,0,-13,-383,111231,1569,2212,115012,13.33%,13.78%,
104/06/03,-96,0,-1,-97,111591,1569,2225,115385,13.37%,13.82%,
104/06/02,-126,0,-38,-164,111687,1569,2226,115482,13.38%,13.83%,
104/06/01,312,0,-9,303,111813,1569,2264,115646,13.40%,13.86%,
104/05/29,-38,0,-38,-76,111501,1569,2273,115343,13.36%,13.82%,
104/05/28,-70,0,0,-70,111595,1569,2311,115475,13.37%,13.84%,
104/05/27,114,0,0,114,111679,1569,2311,115559,13.38%,13.85%,
104/05/26,-81,0,0,-81,111565,1569,2311,115445,13.37%,13.84%,
104/05/25,-193,0,0,-193,111648,1569,2311,115528,13.38%,13.85%,
104/05/22,-76,0,-8,-84,111841,1569,2311,115721,13.40%,13.87%,
104/05/21,-194,0,-7,-201,111918,1569,2319,115806,13.41%,13.88%,
104/05/20,250,0,2,252,112102,1569,2326,115997,13.43%,13.90%,
104/05/19,21,0,-8,13,111936,1569,2324,115829,13.41%,13.88%,
104/05/18,160,0,-3,157,111884,1569,2332,115785,13.40%,13.87%,
104/05/15,130,-5,-1,124,111751,1569,2335,115655,13.39%,13.86%,
104/05/14,-34,0,-8,-42,111621,1574,2336,115531,13.37%,13.84%,
104/05/13,-577,0,0,-577,111649,1574,2344,115567,13.38%,13.85%,
104/05/12,62,0,-1,61,112227,1574,2344,116145,13.45%,13.92%,
104/05/11,-75,0,-36,-111,112156,1574,2345,116075,13.44%,13.91%,
104/05/08,206,0,-20,186,112219,1574,2381,116174,13.44%,13.91%,
104/05/07,7,0,0,7,112090,1574,2401,116065,13.43%,13.91%,
104/05/06,-622,0,0,-622,112083,1574,2401,116058,13.43%,13.91%,
104/05/05,9,0,0,9,112705,1574,2401,116680,13.50%,13.98%,
104/05/04,-113,0,0,-113,112903,1574,2401,116878,13.53%,14.01%,
104/04/30,269,0,0,269,113016,1574,2401,116991,13.54%,14.02%,
104/04/29,346,0,11,357,112747,1574,2401,116722,13.51%,13.99%,
104/04/28,60,0,-180,-120,112401,1574,2390,116365,13.47%,13.95%,
104/04/27,1068,0,31,1099,112341,1574,2570,116485,13.46%,13.96%,
104/04/24,635,0,6,641,111273,1574,2539,115386,13.33%,13.82%,
104/04/23,-84,0,-4,-88,110638,1574,2533,114745,13.26%,13.75%,
104/04/22,-193,0,-1,-194,110723,1574,2537,114834,13.27%,13.76%,
104/04/21,216,0,0,216,110921,1574,2538,115033,13.29%,13.78%,
104/04/20,-139,0,4,-135,110668,1574,2538,114780,13.26%,13.75%,
104/04/17,356,0,-20,336,110807,1574,2534,114915,13.28%,13.77%,
104/04/16,-425,0,-27,-452,110451,1574,2554,114579,13.23%,13.72%,
104/04/15,-231,-7,0,-238,110695,1574,2581,114850,13.26%,13.76%,
104/04/14,-254,0,0,-254,110957,1581,2581,115119,13.29%,13.79%,
104/04/13,-374,0,2,-372,111211,1581,2581,115373,13.32%,13.82%,
104/04/10,-279,0,-2,-281,111585,1581,2579,115745,13.37%,13.87%,
104/04/09,-212,0,0,-212,111542,1581,2581,115704,13.36%,13.86%,
104/04/08,-102,0,-1,-103,111754,1581,2581,115916,13.39%,13.89%,
104/04/07,-1170,0,3,-1167,111856,1581,2582,116019,13.40%,13.90%,
104/04/02,-434,0,10,-424,113026,1581,2579,117186,13.54%,14.04%,
104/04/01,-1510,0,-20,-1530,113334,1581,2569,117484,13.58%,14.08%,
104/03/31,-2569,0,0,-2569,115069,1581,2589,119239,13.79%,14.29%,
104/03/30,-1353,0,0,-1353,117638,1584,2589,121811,14.09%,14.59%,
104/03/27,-2237,0,-30,-2267,118991,1584,2589,123164,14.26%,14.76%,
104/03/26,-1398,0,2,-1396,121228,1584,2619,125431,14.52%,15.02%,
104/03/25,-878,0,-13,-891,122627,1584,2617,126828,14.69%,15.19%,
104/03/24,-1163,0,-79,-1242,123616,1584,2630,127830,14.81%,15.32%,
104/03/23,-1764,0,-4,-1768,124969,1584,2709,129262,14.97%,15.48%,
104/03/20,-6274,0,-425,-6699,126733,1584,2713,131030,15.18%,15.70%,
104/03/19,-8846,111,63,-8672,133007,1584,3138,137729,15.94%,16.51%,
104/03/18,-2853,288,35,-2530,141853,1473,3075,146401,17.00%,17.55%,
104/03/17,-426,0,52,-374,144641,1185,3040,148866,17.33%,17.84%,
104/03/16,-344,4,-26,-366,144842,1185,2988,149015,17.35%,17.85%,
104/03/13,-59,0,0,-59,144922,1181,3014,149117,17.36%,17.86%,
104/03/12,-113,-0,79,-34,144981,1181,3014,149176,17.37%,17.87%,
104/03/11,-1122,0,248,-874,145093,1181,2935,149209,17.38%,17.87%,
104/03/10,-116,0,-8,-124,146215,1181,2687,150083,17.52%,17.98%,
104/03/09,-180,0,12,-168,146331,1181,2695,150207,17.53%,17.99%,
104/03/06,-953,3,37,-913,146501,1181,2683,150365,17.55%,18.01%,
104/03/05,-78,0,-5,-83,147454,1178,2646,151278,17.67%,18.13%,
104/03/04,119,0,0,119,147532,1178,2651,151361,17.68%,18.14%,
104/03/03,-162,0,-10,-172,147413,1178,2651,151242,17.66%,18.12%,
104/03/02,80,0,-10,70,147595,1178,2661,151434,17.68%,18.14%,
104/02/26,-69,-3,0,-72,147514,1178,2671,151363,17.67%,18.13%,
104/02/25,-373,0,6,-367,147583,1181,2671,151435,17.68%,18.14%,
104/02/24,507,0,-7,500,147956,1181,2665,151802,17.73%,18.19%,
104/02/13,-45,0,-54,-99,147449,1181,2672,151302,17.67%,18.13%,
104/02/12,-184,0,0,-184,147494,1181,2726,151401,17.67%,18.14%,
104/02/11,-67,0,0,-67,147696,1181,2726,151603,17.70%,18.17%,
104/02/10,37,0,2,39,147763,1181,2726,151670,17.70%,18.17%,
104/02/09,5,1,-1,5,147726,1181,2724,151631,17.70%,18.17%,
104/02/06,-12,0,21,9,147721,1180,2725,151626,17.70%,18.17%,
104/02/05,24,0,-1,23,147733,1180,2704,151617,17.70%,18.17%,
104/02/04,93,0,12,105,147709,1180,2705,151594,17.70%,18.17%,
104/02/03,64,30,-1,93,147616,1180,2693,151489,17.69%,18.15%,
104/02/02,-85,0,38,-47,147552,1150,2694,151396,17.68%,18.14%,
104/01/30,-130,0,1,-129,147637,1150,2656,151443,17.69%,18.15%,
104/01/29,-152,24,7,-121,147767,1150,2655,151572,17.71%,18.17%,
104/01/28,379,0,-3,376,147919,1126,2648,151693,17.72%,18.17%,
104/01/27,-84,0,114,30,147532,1126,2651,151309,17.68%,18.13%,
104/01/26,187,0,-53,134,147616,1126,2537,151279,17.69%,18.13%,
104/01/23,-189,0,-159,-348,147474,1126,2590,151190,17.67%,18.12%,
104/01/22,164,132,-48,248,147623,1126,2749,151498,17.69%,18.15%,
104/01/21,-484,0,-39,-523,147459,994,2797,151250,17.67%,18.12%,
104/01/20,14,0,-64,-50,147943,994,2836,151773,17.73%,18.19%,
104/01/19,-115,102,-40,-53,148129,994,2900,152023,17.75%,18.22%,
104/01/16,-642,93,219,-330,148244,892,2940,152076,17.76%,18.22%,
104/01/15,130,64,67,261,148836,799,2721,152356,17.83%,18.25%,
104/01/14,-423,34,-90,-479,148706,735,2654,152095,17.82%,18.23%,
104/01/13,-504,31,29,-444,149129,701,2744,152574,17.87%,18.28%,
104/01/12,-1353,58,109,-1186,149633,670,2715,153018,17.93%,18.34%,
104/01/09,426,0,243,669,150606,612,2606,153824,18.05%,18.44%,
104/01/08,-379,73,8,-298,150180,612,2363,153155,17.99%,18.35%,
104/01/07,-151,5,5,-141,150559,539,2355,153453,18.04%,18.39%,
104/01/06,-294,28,-29,-295,150710,534,2350,153594,18.06%,18.41%,
104/01/05,-386,0,0,-386,151004,506,2379,153889,18.09%,18.44%,
