日期,外資買賣超,投信買賣超,自營商買賣超,單日合計買賣超,外資估計持股,投信估計持股,自營商估計持股,單日合計估計持股,外資持股比重,三大法人持股比重,
107/03/31,0,300,-180,120,16731,850,0,17581,7.21%,7.58%,
107/03/30,111,280,-246,145,16731,550,0,17281,7.21%,7.45%,
107/03/29,118,270,-117,271,16620,270,245,17135,7.17%,7.39%,
107/03/28,70,0,-101,-31,16513,0,362,16875,7.12%,7.28%,
107/03/27,70,0,-304,-234,16443,0,463,16906,7.09%,7.29%,
107/03/26,39,0,-120,-81,16363,0,767,17130,7.06%,7.39%,
107/03/23,46,0,-32,14,16324,0,887,17211,7.04%,7.42%,
107/03/22,26,0,-118,-92,16278,0,919,17197,7.02%,7.42%,
107/03/21,37,0,-342,-305,16252,0,1037,17289,7.01%,7.46%,
107/03/20,24,0,0,24,16115,0,1379,17494,6.95%,7.54%,
107/03/19,-70,0,0,-70,16091,0,1379,17470,6.94%,7.53%,
107/03/16,-137,0,0,-137,16161,0,1379,17540,6.97%,7.56%,
107/03/15,-11,0,0,-11,16298,0,1379,17677,7.03%,7.62%,
107/03/14,28,0,-10,18,15959,0,1379,17338,6.88%,7.47%,
107/03/13,-65,0,0,-65,15931,0,1389,17320,6.87%,7.47%,
107/03/12,-5,0,-1,-6,15996,0,1389,17385,6.90%,7.50%,
107/03/09,-12,0,0,-12,16001,0,1390,17391,6.90%,7.50%,
107/03/08,-9,0,0,-9,16013,0,1390,17403,6.90%,7.50%,
107/03/07,-38,0,1,-37,16022,0,1390,17412,6.91%,7.51%,
107/03/06,-14,0,-20,-34,16060,0,1389,17449,6.92%,7.52%,
107/03/05,-35,0,0,-35,16074,0,1409,17483,6.93%,7.54%,
107/03/02,-22,0,-15,-37,16109,0,1409,17518,6.95%,7.56%,
107/03/01,3,0,0,3,16129,0,1424,17553,6.95%,7.56%,
107/02/27,-25,0,0,-25,16126,0,1424,17550,6.95%,7.56%,
107/02/26,-9,0,0,-9,16151,0,1424,17575,6.96%,7.57%,
107/02/23,-6,0,0,-6,16160,0,1424,17584,6.97%,7.58%,
107/02/22,-26,0,0,-26,16166,0,1424,17590,6.97%,7.58%,
107/02/21,-52,0,1,-51,16186,0,1424,17610,6.98%,7.59%,
107/02/12,-11,0,-2,-13,16222,0,1423,17645,6.99%,7.60%,
107/02/09,18,0,-3,15,16233,0,1425,17658,7.00%,7.61%,
107/02/08,-8,0,0,-8,16214,0,1428,17642,6.99%,7.61%,
107/02/07,-11,0,-20,-31,16222,0,1428,17650,6.99%,7.61%,
107/02/06,-91,0,3,-88,16233,0,1448,17681,7.00%,7.62%,
107/02/05,-6,0,0,-6,16324,0,1445,17769,7.04%,7.66%,
107/02/02,-22,0,-30,-52,16330,0,1445,17775,7.04%,7.66%,
107/02/01,0,0,0,0,16352,0,1475,17827,7.05%,7.69%,
107/01/31,-12,0,0,-12,16352,0,1475,17827,7.05%,7.69%,
107/01/30,-2,0,0,-2,16364,0,1475,17839,7.06%,7.70%,
107/01/29,-10,0,0,-10,16366,0,1475,17841,7.06%,7.70%,
107/01/26,8,0,0,8,16376,0,1475,17851,7.06%,7.70%,
107/01/25,-61,0,0,-61,16368,0,1475,17843,7.06%,7.70%,
107/01/24,-54,0,0,-54,16430,0,1475,17905,7.08%,7.72%,
107/01/23,34,0,0,34,16484,0,1475,17959,7.11%,7.75%,
107/01/22,-27,0,100,73,16450,0,1475,17925,7.09%,7.73%,
107/01/19,-32,0,100,68,16477,0,1375,17852,7.10%,7.69%,
107/01/18,2,0,60,62,16509,0,1275,17784,7.12%,7.67%,
107/01/17,38,0,55,93,16507,0,1215,17722,7.12%,7.64%,
107/01/16,9,0,0,9,16469,0,1160,17629,7.10%,7.60%,
107/01/15,22,0,0,22,16460,0,1160,17620,7.10%,7.60%,
107/01/12,-36,0,0,-36,16438,0,1160,17598,7.09%,7.59%,
107/01/11,-13,0,0,-13,16474,0,1160,17634,7.10%,7.60%,
107/01/10,38,0,15,53,16487,0,1160,17647,7.11%,7.61%,
107/01/09,-18,0,0,-18,16449,0,1145,17594,7.09%,7.58%,
107/01/08,-31,0,0,-31,16467,0,1145,17612,7.10%,7.59%,
107/01/05,-34,0,12,-22,16498,0,1145,17643,7.11%,7.60%,
107/01/04,-32,0,5,-27,16532,0,1133,17665,7.13%,7.62%,
107/01/03,-83,0,0,-83,16564,0,1128,17692,7.14%,7.63%,
107/01/02,-99,0,-300,-399,16647,0,1128,17775,7.18%,7.67%,
106/12/29,-14,0,0,-14,16746,0,1428,18174,7.22%,7.84%,
106/12/28,11,0,0,11,16760,0,1428,18188,7.23%,7.85%,
106/12/27,0,0,0,0,16749,0,1428,18177,7.22%,7.84%,
106/12/26,2,0,0,2,16749,0,1428,18177,7.22%,7.84%,
106/12/25,14,0,0,14,16747,0,1428,18175,7.22%,7.84%,
106/12/22,12,0,0,12,16733,0,1428,18161,7.22%,7.84%,
106/12/21,-2,0,0,-2,16721,0,1428,18149,7.21%,7.83%,
106/12/20,-16,0,0,-16,16723,0,1428,18151,7.21%,7.83%,
106/12/19,-61,0,0,-61,16739,0,1428,18167,7.22%,7.84%,
106/12/18,23,0,0,23,16800,0,1428,18228,7.24%,7.86%,
106/12/15,-42,0,50,8,16777,0,1428,18205,7.23%,7.85%,
106/12/14,9,0,0,9,16819,0,1378,18197,7.25%,7.85%,
106/12/13,1,0,0,1,16810,0,1378,18188,7.25%,7.85%,
106/12/12,-8,0,0,-8,16809,0,1378,18187,7.25%,7.85%,
106/12/11,-30,0,50,20,16817,0,1378,18195,7.25%,7.85%,
106/12/08,2,0,200,202,16847,0,1328,18175,7.26%,7.83%,
106/12/07,-22,0,128,106,16845,0,1128,17973,7.26%,7.75%,
106/12/06,-67,0,142,75,16867,0,1000,17867,7.27%,7.70%,
106/12/05,2,0,30,32,16934,0,858,17792,7.30%,7.67%,
106/12/04,18,0,35,53,16922,0,828,17750,7.30%,7.66%,
106/12/01,41,0,65,106,16904,0,793,17697,7.29%,7.63%,
106/11/30,-116,0,100,-16,16853,0,728,17581,7.27%,7.58%,
106/11/29,-16,0,0,-16,16969,0,628,17597,7.32%,7.59%,
106/11/28,-20,0,0,-20,16985,0,628,17613,7.32%,7.59%,
106/11/27,-13,0,20,7,17005,0,628,17633,7.33%,7.60%,
106/11/24,15,0,0,15,17018,0,608,17626,7.34%,7.60%,
106/11/23,11,0,27,38,17003,0,608,17611,7.33%,7.59%,
106/11/22,-55,0,50,-5,16992,0,581,17573,7.33%,7.58%,
106/11/21,-52,0,12,-40,17047,0,531,17578,7.35%,7.58%,
106/11/20,-32,0,13,-19,17099,0,519,17618,7.37%,7.59%,
106/11/17,-38,0,0,-38,17131,0,506,17637,7.39%,7.61%,
106/11/16,-53,0,-58,-111,17171,0,506,17677,7.40%,7.62%,
106/11/15,-34,0,-168,-202,17224,0,564,17788,7.43%,7.67%,
106/11/14,-2,0,50,48,17258,0,732,17990,7.44%,7.76%,
106/11/13,0,0,50,50,17260,0,682,17942,7.44%,7.73%,
106/11/10,-16,0,50,34,17260,0,632,17892,7.44%,7.71%,
106/11/09,-59,0,48,-11,17276,0,582,17858,7.45%,7.70%,
106/11/08,-38,0,27,-11,17335,0,534,17869,7.47%,7.70%,
106/11/07,-70,0,23,-47,17373,0,507,17880,7.49%,7.71%,
106/11/06,-74,0,100,26,17443,0,484,17927,7.52%,7.73%,
106/11/03,-42,0,0,-42,17517,0,384,17901,7.55%,7.72%,
106/11/02,8,0,0,8,17559,0,384,17943,7.57%,7.74%,
106/11/01,-5,0,0,-5,17551,0,384,17935,7.57%,7.74%,
106/10/31,-41,0,0,-41,17556,0,384,17940,7.57%,7.74%,
106/10/30,-71,0,0,-71,17597,0,384,17981,7.59%,7.76%,
106/10/27,-11,0,0,-11,17668,0,384,18052,7.62%,7.79%,
106/10/26,4,0,-4,0,17679,0,384,18063,7.62%,7.79%,
106/10/25,1,0,0,1,17675,0,388,18063,7.62%,7.79%,
106/10/24,-1,0,0,-1,17674,0,388,18062,7.62%,7.79%,
106/10/23,-6,0,0,-6,17675,0,388,18063,7.62%,7.79%,
106/10/20,-7,0,0,-7,17681,0,388,18069,7.62%,7.79%,
106/10/19,-5,0,1,-4,17688,0,388,18076,7.63%,7.80%,
106/10/18,11,0,0,11,17693,0,387,18080,7.63%,7.80%,
106/10/17,-45,0,0,-45,17682,0,387,18069,7.62%,7.79%,
106/10/16,13,0,0,13,17727,0,387,18114,7.64%,7.81%,
106/10/13,3,0,0,3,17695,0,387,18082,7.63%,7.80%,
106/10/12,-24,0,0,-24,17692,0,387,18079,7.63%,7.80%,
106/10/11,1,0,0,1,17716,0,387,18103,7.64%,7.81%,
106/10/06,16,0,0,16,17715,0,387,18102,7.64%,7.81%,
106/10/05,42,0,0,42,17689,0,387,18076,7.63%,7.80%,
106/10/03,-12,0,0,-12,17647,0,387,18034,7.61%,7.78%,
106/10/02,13,0,5,18,17659,0,387,18046,7.61%,7.78%,
106/09/30,0,0,0,0,17646,0,382,18028,7.61%,7.78%,
106/09/29,-43,0,0,-43,17646,0,382,18028,7.61%,7.78%,
106/09/28,12,0,0,12,17689,0,382,18071,7.63%,7.80%,
106/09/27,-13,0,0,-13,17677,0,382,18059,7.62%,7.79%,
106/09/26,13,0,8,21,17690,0,382,18072,7.63%,7.80%,
106/09/25,67,0,3,70,17677,0,374,18051,7.62%,7.78%,
106/09/22,4,0,-1,3,17610,0,371,17981,7.59%,7.75%,
106/09/21,-44,0,0,-44,17606,0,372,17978,7.59%,7.75%,
106/09/20,-25,0,0,-25,17650,0,372,18022,7.61%,7.77%,
106/09/19,-30,0,0,-30,17675,0,372,18047,7.62%,7.78%,
106/09/18,18,0,0,18,17705,0,372,18077,7.63%,7.79%,
106/09/15,-35,0,0,-35,17687,0,372,18059,7.63%,7.79%,
106/09/14,0,0,0,0,17722,0,372,18094,7.64%,7.80%,
106/09/13,33,0,1,34,17721,0,372,18093,7.64%,7.80%,
106/09/12,10,0,0,10,17688,0,371,18059,7.63%,7.79%,
106/09/11,-27,0,0,-27,17678,0,371,18049,7.62%,7.78%,
106/09/08,-10,0,0,-10,17705,0,371,18076,7.63%,7.79%,
106/09/07,10,0,0,10,17715,0,371,18086,7.64%,7.80%,
106/09/06,4,0,0,4,17551,0,371,17922,7.57%,7.73%,
106/09/05,20,0,0,20,17547,0,371,17918,7.57%,7.73%,
106/09/04,37,0,0,37,17527,0,371,17898,7.56%,7.72%,
106/09/01,32,0,0,32,17490,0,371,17861,7.54%,7.70%,
106/08/31,51,0,0,51,17458,0,371,17829,7.53%,7.69%,
106/08/30,47,0,0,47,17407,0,371,17778,7.51%,7.67%,
106/08/29,-39,0,0,-39,17360,0,371,17731,7.49%,7.65%,
106/08/28,-18,0,0,-18,17399,0,371,17770,7.50%,7.66%,
106/08/25,-2,0,0,-2,17417,0,371,17788,7.51%,7.67%,
106/08/24,-65,0,0,-65,17419,0,371,17790,7.51%,7.67%,
106/08/23,-3,0,47,44,17484,0,371,17855,7.54%,7.70%,
106/08/22,-13,0,29,16,17487,0,324,17811,7.54%,7.68%,
106/08/21,-72,0,25,-47,17500,0,295,17795,7.55%,7.68%,
106/08/18,-20,0,68,48,17572,0,270,17842,7.58%,7.70%,
106/08/17,-13,0,160,147,17592,0,202,17794,7.59%,7.68%,
106/08/16,-104,0,39,-65,17605,0,42,17647,7.59%,7.61%,
106/08/15,-19,0,0,-19,17709,0,3,17712,7.64%,7.64%,
106/08/14,-25,0,0,-25,17728,0,3,17731,7.64%,7.64%,
106/08/11,-36,0,0,-36,17753,0,3,17756,7.66%,7.66%,
106/08/10,-40,0,3,-37,17789,0,3,17792,7.67%,7.67%,
106/08/09,-30,0,-6,-36,17829,0,0,17829,7.69%,7.69%,
106/08/08,12,0,0,12,17859,0,0,17859,7.70%,7.70%,
106/08/07,-27,0,0,-27,17847,0,0,17847,7.70%,7.70%,
106/08/04,-1,0,-1,-2,17874,0,0,17874,7.71%,7.71%,
106/08/03,-74,0,0,-74,17875,0,0,17875,7.71%,7.71%,
106/08/02,-140,0,-2,-142,17949,0,0,17949,7.74%,7.74%,
106/08/01,147,0,0,147,18071,0,0,18071,7.79%,7.79%,
106/07/31,129,0,0,129,17924,0,0,17924,7.73%,7.73%,
106/07/28,125,0,0,125,17795,0,0,17795,7.67%,7.67%,
106/07/27,92,0,-2,90,17670,0,0,17670,7.62%,7.62%,
106/07/26,-72,0,-3,-75,17578,0,0,17578,7.58%,7.58%,
106/07/25,-136,0,0,-136,17650,0,3,17653,7.61%,7.61%,
106/07/24,-113,0,3,-110,17786,0,3,17789,7.67%,7.67%,
106/07/21,-251,0,0,-251,17899,0,0,17899,7.72%,7.72%,
106/07/20,-297,0,0,-297,18150,0,0,18150,7.83%,7.83%,
106/07/19,-231,0,-0,-231,18447,0,0,18447,7.96%,7.96%,
106/07/18,271,0,-4,267,18753,0,0,18753,8.09%,8.09%,
106/07/17,-130,0,-2,-132,18482,0,0,18482,7.97%,7.97%,
106/07/14,-185,0,0,-185,18612,0,0,18612,8.03%,8.03%,
106/07/13,-216,0,0,-216,18797,0,0,18797,8.11%,8.11%,
106/07/12,-67,0,-4,-71,19013,0,0,19013,8.20%,8.20%,
106/07/11,-106,0,-37,-143,19080,0,0,19080,8.23%,8.23%,
106/07/10,-99,0,0,-99,19186,0,0,19186,8.27%,8.27%,
106/07/07,-92,0,0,-92,19285,0,0,19285,8.32%,8.32%,
106/07/06,-101,0,0,-101,19377,0,0,19377,8.36%,8.36%,
106/07/05,-1,0,0,-1,19478,0,0,19478,8.40%,8.40%,
106/07/04,99,0,-6,93,19479,0,0,19479,8.40%,8.40%,
106/07/03,48,0,-25,23,19766,0,0,19766,8.52%,8.52%,
106/06/30,133,0,-25,108,19718,0,0,19718,8.50%,8.50%,
106/06/29,-28,0,-5,-33,19585,0,0,19585,8.45%,8.45%,
106/06/28,-6,0,-17,-23,19613,0,0,19613,8.46%,8.46%,
106/06/27,146,0,-10,136,19619,0,0,19619,8.46%,8.46%,
106/06/26,159,0,0,159,19473,0,0,19473,8.40%,8.40%,
106/06/23,-28,0,-50,-78,19314,0,0,19314,8.33%,8.33%,
106/06/22,79,0,-5,74,19342,0,0,19342,8.34%,8.34%,
106/06/21,165,0,-22,143,19263,0,0,19263,8.31%,8.31%,
106/06/20,98,0,-51,47,19098,0,0,19098,8.24%,8.24%,
106/06/19,98,0,-9,89,19069,0,0,19069,8.22%,8.22%,
106/06/16,127,0,-109,18,18971,0,0,18971,8.18%,8.18%,
106/06/15,43,0,-39,4,18844,0,83,18927,8.13%,8.17%,
106/06/14,187,0,0,187,18930,0,122,19052,8.16%,8.21%,
106/06/13,346,0,-4,342,18743,0,122,18865,8.08%,8.13%,
106/06/12,63,0,0,63,18457,0,126,18583,7.96%,8.01%,
106/06/09,-54,0,-1,-55,18394,0,126,18520,7.93%,7.98%,
106/06/08,13,0,0,13,18448,0,127,18575,7.96%,8.01%,
106/06/07,-27,0,-1,-28,18611,0,127,18738,8.03%,8.08%,
106/06/06,252,-17,-5,230,18638,0,128,18766,8.04%,8.10%,
106/06/05,91,-12,-7,72,18386,17,133,18536,7.93%,7.99%,
106/06/03,0,0,0,0,18295,29,140,18464,7.89%,7.96%,
106/06/02,-22,0,0,-22,18295,29,140,18464,7.89%,7.97%,
106/06/01,-29,0,-7,-36,18317,29,140,18486,7.90%,7.98%,
106/05/31,-24,0,0,-24,18346,29,147,18522,7.91%,7.99%,
106/05/26,-3,0,0,-3,18370,29,147,18546,7.92%,8.00%,
106/05/25,33,0,0,33,18373,29,147,18549,7.92%,8.00%,
106/05/24,36,0,59,95,18340,29,147,18516,7.91%,7.99%,
106/05/23,-63,0,46,-17,18304,29,88,18421,7.89%,7.94%,
106/05/22,-153,0,42,-111,18367,29,42,18438,7.92%,7.95%,
106/05/19,-85,0,0,-85,18520,29,0,18549,7.99%,8.00%,
106/05/18,-106,0,0,-106,18605,29,0,18634,8.02%,8.03%,
106/05/17,-99,0,-10,-109,18711,29,0,18740,8.07%,8.08%,
106/05/16,-101,0,0,-101,18810,29,0,18839,8.11%,8.12%,
106/05/15,-101,0,0,-101,18911,29,0,18940,8.16%,8.17%,
106/05/12,-82,0,0,-82,19012,29,0,19041,8.20%,8.21%,
106/05/11,-25,0,0,-25,19094,29,0,19123,8.23%,8.24%,
106/05/10,-102,0,0,-102,19119,29,0,19148,8.24%,8.25%,
106/05/09,-193,0,0,-193,19221,29,0,19250,8.29%,8.30%,
106/05/08,-71,0,0,-71,19414,29,0,19443,8.37%,8.38%,
106/05/05,-15,0,0,-15,19485,29,0,19514,8.40%,8.41%,
106/05/04,-90,0,0,-90,19500,29,0,19529,8.41%,8.42%,
106/05/03,-72,0,0,-72,19590,29,0,19619,8.45%,8.46%,
106/05/02,-120,0,0,-120,19662,29,0,19691,8.48%,8.49%,
106/04/28,-81,0,-11,-92,19782,29,0,19811,8.53%,8.54%,
106/04/27,-71,0,0,-71,19863,29,0,19892,8.57%,8.58%,
106/04/26,-34,0,-8,-42,19924,29,0,19953,8.59%,8.60%,
106/04/25,-208,0,0,-208,19958,29,0,19987,8.61%,8.62%,
106/04/24,-319,0,0,-319,20166,29,0,20195,8.70%,8.71%,
106/04/21,-97,0,0,-97,20485,29,0,20514,8.83%,8.84%,
106/04/20,-47,0,0,-47,20582,29,0,20611,8.88%,8.89%,
106/04/19,-49,0,-5,-54,20609,29,0,20638,9.38%,9.39%,
106/04/18,-28,0,-10,-38,20658,29,0,20687,9.40%,9.41%,
106/04/17,-83,0,-29,-112,20686,29,0,20715,9.41%,9.42%,
106/04/14,-71,-1,-73,-145,20769,29,0,20798,9.45%,9.46%,
106/04/13,-58,0,-20,-78,20840,30,0,20870,9.48%,9.49%,
106/04/12,-116,0,-140,-256,20898,30,0,20928,9.51%,9.52%,
106/04/11,-89,0,0,-89,20994,30,0,21024,9.55%,9.56%,
106/04/10,-165,0,0,-165,21083,30,0,21113,9.59%,9.60%,
106/04/07,-175,0,0,-175,21248,30,0,21278,9.67%,9.68%,
106/04/06,-646,0,-9,-655,21423,30,0,21453,9.75%,9.76%,
106/04/05,124,0,-20,104,22069,30,0,22099,10.04%,10.05%,
106/03/31,315,0,-22,293,21945,30,0,21975,9.99%,10.00%,
106/03/30,96,0,0,96,21630,30,0,21660,9.84%,9.85%,
106/03/29,202,0,-5,197,21534,30,0,21564,9.80%,9.81%,
106/03/28,105,0,-1,104,21332,30,0,21362,9.71%,9.72%,
106/03/27,318,0,-91,227,21227,30,0,21257,9.66%,9.67%,
106/03/24,49,0,12,61,20909,30,12,20951,9.52%,9.54%,
106/03/23,-4,0,-88,-92,20860,30,0,20890,9.49%,9.50%,
106/03/22,25,0,-156,-131,20864,30,0,20894,9.50%,9.51%,
106/03/21,51,16,-100,-33,20859,30,0,20889,9.49%,9.50%,
106/03/20,-213,14,-100,-299,20788,14,1,20803,9.46%,9.47%,
106/03/17,195,0,0,195,20959,0,101,21060,9.54%,9.59%,
106/03/16,-156,0,100,-56,20704,0,101,20805,9.42%,9.47%,
106/03/15,-117,0,1,-116,20860,0,1,20861,9.49%,9.49%,
106/03/14,-74,0,0,-74,20905,0,0,20905,9.51%,9.51%,
106/03/13,21,0,-15,6,20953,0,0,20953,9.54%,9.54%,
106/03/10,5,0,0,5,20932,0,2,20934,9.53%,9.53%,
106/03/09,23,0,1,24,20927,0,2,20929,9.52%,9.52%,
106/03/08,-9,0,0,-9,20904,0,1,20905,9.51%,9.51%,
106/03/07,18,0,0,18,20913,0,1,20914,9.52%,9.52%,
106/03/06,-40,0,0,-40,20895,0,1,20896,9.51%,9.51%,
106/03/03,36,0,0,36,20935,0,1,20936,9.53%,9.53%,
106/03/02,163,0,0,163,20853,0,1,20854,9.49%,9.49%,
106/03/01,75,0,1,76,20690,0,1,20691,9.42%,9.42%,
106/02/24,90,0,-12,78,20615,0,0,20615,9.38%,9.38%,
106/02/23,18,0,-9,9,20525,0,0,20525,9.34%,9.34%,
106/02/22,10,0,-14,-4,20507,0,0,20507,9.33%,9.33%,
106/02/21,-13,0,0,-13,20497,0,0,20497,9.33%,9.33%,
106/02/20,86,0,-24,62,20510,0,0,20510,9.33%,9.33%,
106/02/18,0,0,-2,-2,20424,0,0,20424,9.29%,9.29%,
106/02/17,89,0,0,89,20424,0,1,20425,9.29%,9.29%,
106/02/16,57,0,0,57,20335,0,1,20336,9.25%,9.25%,
106/02/15,169,0,0,169,20278,0,1,20279,9.23%,9.23%,
106/02/14,93,0,0,93,20109,0,1,20110,9.15%,9.15%,
106/02/13,-14,0,0,-14,20016,0,1,20017,9.11%,9.11%,
106/02/10,-117,0,1,-116,20030,0,1,20031,9.12%,9.12%,
106/02/09,-64,0,-1,-65,20147,0,0,20147,9.17%,9.17%,
106/02/08,53,0,0,53,20211,0,0,20211,9.20%,9.20%,
106/02/07,-122,0,0,-122,20158,0,0,20158,9.17%,9.17%,
106/02/06,-62,0,0,-62,20252,0,0,20252,9.22%,9.22%,
106/02/03,-7,0,0,-7,20314,0,0,20314,9.24%,9.24%,
106/02/02,44,0,0,44,20321,0,0,20321,9.25%,9.25%,
106/01/24,2,0,0,2,20277,0,0,20277,9.23%,9.23%,
106/01/23,-32,0,0,-32,20320,0,0,20320,9.25%,9.25%,
106/01/20,-25,0,0,-25,20296,0,0,20296,9.24%,9.24%,
106/01/19,-24,0,-2,-26,20321,0,0,20321,9.25%,9.25%,
106/01/18,49,0,-2,47,20318,0,0,20318,9.25%,9.25%,
106/01/17,-128,0,0,-128,20269,0,0,20269,9.22%,9.22%,
106/01/16,-138,0,0,-138,20370,0,0,20370,9.27%,9.27%,
106/01/13,-6,0,0,-6,20415,0,0,20415,9.29%,9.29%,
106/01/12,-85,0,0,-85,20421,0,0,20421,9.29%,9.29%,
106/01/11,-158,0,0,-158,20471,0,0,20471,9.32%,9.32%,
106/01/10,-126,0,0,-126,20467,0,0,20467,9.31%,9.31%,
106/01/09,-29,0,0,-29,20573,0,0,20573,9.36%,9.36%,
106/01/06,-36,0,-1,-37,20602,0,0,20602,9.38%,9.38%,
106/01/05,-63,0,0,-63,20638,0,0,20638,9.39%,9.39%,
106/01/04,-20,0,-4,-24,20701,0,0,20701,9.42%,9.42%,
106/01/03,-91,0,0,-91,20621,0,1,20622,9.38%,9.38%,
105/12/30,6,0,1,7,20706,0,1,20707,9.42%,9.42%,
105/12/29,16,0,-52,-36,20700,0,0,20700,9.42%,9.42%,
105/12/28,40,0,0,40,20684,0,27,20711,9.41%,9.42%,
105/12/27,9,0,0,9,20644,0,27,20671,9.39%,9.40%,
105/12/26,-14,0,0,-14,20635,0,27,20662,9.39%,9.40%,
105/12/23,-70,0,8,-62,20649,0,27,20676,9.40%,9.41%,
105/12/22,2,0,0,2,20719,0,19,20738,9.43%,9.44%,
105/12/21,77,0,3,80,20717,0,19,20736,9.43%,9.44%,
105/12/20,156,0,4,160,20648,0,16,20664,9.40%,9.41%,
105/12/19,94,0,0,94,20492,0,12,20504,9.33%,9.34%,
105/12/16,72,0,3,75,20398,0,12,20410,9.28%,9.29%,
105/12/15,51,0,0,51,20326,0,9,20335,9.25%,9.25%,
105/12/14,97,0,0,97,20275,0,9,20284,9.23%,9.23%,
105/12/13,158,0,0,158,20178,0,9,20187,9.18%,9.18%,
105/12/12,1,0,7,8,20020,0,9,20029,9.11%,9.11%,
105/12/09,101,0,0,101,20019,0,2,20021,9.11%,9.11%,
105/12/08,152,0,1,153,19918,0,2,19920,9.06%,9.06%,
105/12/07,168,0,-1,167,19766,0,1,19767,9.00%,9.00%,
105/12/06,83,0,1,84,19598,0,2,19600,8.92%,8.92%,
105/12/05,45,0,0,45,19480,0,1,19481,8.86%,8.86%,
105/12/02,92,0,-2,90,19435,0,1,19436,8.84%,8.84%,
105/12/01,42,0,0,42,19343,0,3,19346,8.80%,8.80%,
105/11/30,218,0,-2,216,19301,0,3,19304,8.78%,8.78%,
105/11/29,107,0,0,107,19083,0,5,19088,8.68%,8.68%,
105/11/28,194,0,-1,193,18976,0,5,18981,8.64%,8.64%,
105/11/25,1,0,-2,-1,18782,0,6,18788,8.55%,8.55%,
105/11/24,0,0,0,0,18781,0,8,18789,8.55%,8.55%,
105/11/23,0,0,0,0,18781,0,8,18789,8.55%,8.55%,
105/11/22,69,0,0,69,18781,0,8,18789,8.55%,8.55%,
105/11/21,87,0,0,87,18712,0,8,18720,8.52%,8.52%,
105/11/18,69,0,0,69,18625,0,8,18633,8.48%,8.48%,
105/11/17,95,0,0,95,18556,0,8,18564,8.44%,8.44%,
105/11/16,101,0,-1,100,18461,0,8,18469,8.40%,8.40%,
105/11/15,82,0,0,82,18360,0,9,18369,8.35%,8.35%,
105/11/14,68,0,2,70,18278,0,9,18287,8.32%,8.32%,
105/11/11,67,0,0,67,18210,0,7,18217,8.29%,8.29%,
105/11/10,-6,0,0,-6,18143,0,7,18150,8.26%,8.26%,
105/11/09,-2,0,-11,-13,18149,0,7,18156,8.26%,8.26%,
105/11/08,71,0,0,71,18151,0,18,18169,8.26%,8.27%,
105/11/07,1,0,3,4,18080,0,18,18098,8.23%,8.24%,
105/11/04,64,0,0,64,18079,0,15,18094,8.23%,8.24%,
105/11/03,-2,0,4,2,18015,0,15,18030,8.20%,8.21%,
105/11/02,28,0,11,39,18017,0,11,18028,8.20%,8.21%,
105/11/01,67,0,0,67,17989,0,0,17989,8.19%,8.19%,
105/10/31,88,0,0,88,17922,0,0,17922,8.16%,8.16%,
105/10/28,77,0,0,77,17834,0,0,17834,8.12%,8.12%,
105/10/27,57,0,0,57,17757,0,0,17757,8.08%,8.08%,
105/10/26,85,0,-1,84,17700,0,0,17700,8.05%,8.05%,
105/10/25,-30,0,-12,-42,17615,0,0,17615,8.02%,8.02%,
105/10/24,30,0,0,30,17645,0,1,17646,8.03%,8.03%,
105/10/21,-83,0,1,-82,17615,0,1,17616,8.02%,8.02%,
105/10/20,-38,0,-5,-43,17698,0,0,17698,8.05%,8.05%,
105/10/19,-18,0,0,-18,17736,0,1,17737,8.07%,8.07%,
105/10/18,0,0,0,0,17754,0,1,17755,8.08%,8.08%,
105/10/17,0,0,0,0,17754,0,1,17755,8.08%,8.08%,
105/10/14,-9,0,0,-9,17754,0,1,17755,8.08%,8.08%,
105/10/13,3,0,0,3,17688,0,1,17689,8.05%,8.05%,
105/10/12,-3,0,0,-3,17685,0,1,17686,8.05%,8.05%,
105/10/11,18,0,1,19,17688,0,1,17689,8.05%,8.05%,
105/10/07,3,0,0,3,17662,0,0,17662,8.04%,8.04%,
105/10/06,-1,0,0,-1,17659,0,0,17659,8.04%,8.04%,
105/10/05,-7,0,0,-7,17660,0,0,17660,8.04%,8.04%,
105/10/04,-8,0,0,-8,17667,0,0,17667,8.04%,8.04%,
105/10/03,-16,0,0,-16,17675,0,0,17675,8.04%,8.04%,
105/09/30,5,0,0,5,17691,0,0,17691,8.05%,8.05%,
105/09/29,-1,0,0,-1,17686,0,0,17686,8.05%,8.05%,
105/09/26,6,0,0,6,17687,0,0,17687,8.05%,8.05%,
105/09/23,0,0,0,0,17681,0,0,17681,8.05%,8.05%,
105/09/22,42,-73,0,-31,17681,0,0,17681,8.05%,8.05%,
105/09/21,65,0,0,65,17639,73,0,17712,8.03%,8.06%,
105/09/20,50,0,0,50,17574,73,0,17647,8.00%,8.03%,
105/09/19,-3,0,0,-3,17524,73,0,17597,7.97%,8.00%,
105/09/14,-7,0,0,-7,17527,73,0,17600,7.98%,8.01%,
105/09/13,-4,0,-11,-15,17534,73,0,17607,7.98%,8.01%,
105/09/12,17,0,1,18,17538,73,5,17616,7.98%,8.02%,
105/09/10,0,0,-1,-1,17521,73,4,17598,7.97%,8.01%,
105/09/09,31,0,0,31,17521,73,5,17599,7.97%,8.01%,
105/09/08,105,0,0,105,17490,73,5,17568,7.96%,8.00%,
105/09/07,1,73,0,74,17385,73,5,17463,7.91%,7.95%,
105/09/06,28,0,5,33,17384,0,5,17389,7.91%,7.91%,
105/09/05,34,0,0,34,17356,0,0,17356,7.90%,7.90%,
105/09/02,9,0,0,9,17322,0,0,17322,7.88%,7.88%,
105/09/01,4,0,0,4,17313,0,0,17313,7.88%,7.88%,
105/08/31,68,0,-7,61,17309,0,0,17309,7.88%,7.88%,
105/08/30,24,0,0,24,17241,0,7,17248,7.85%,7.85%,
105/08/29,-23,0,0,-23,17217,0,7,17224,7.83%,7.83%,
105/08/26,7,0,0,7,17240,0,7,17247,7.85%,7.85%,
105/08/25,86,0,0,86,17233,0,7,17240,7.84%,7.84%,
105/08/24,40,0,0,40,17147,0,7,17154,7.80%,7.80%,
105/08/23,59,0,0,59,17107,0,7,17114,7.78%,7.78%,
105/08/22,-23,0,0,-23,17048,0,7,17055,7.76%,7.76%,
105/08/19,-45,0,0,-45,17071,0,7,17078,7.77%,7.77%,
105/08/18,6,0,0,6,17116,0,7,17123,7.79%,7.79%,
105/08/17,32,0,-1,31,17110,0,7,17117,7.79%,7.79%,
105/08/16,-18,0,-4,-22,17078,0,8,17086,7.77%,7.77%,
105/08/15,5,0,0,5,17096,0,12,17108,7.78%,7.79%,
105/08/12,53,0,0,53,17091,0,12,17103,7.78%,7.79%,
105/08/11,2,0,-2,0,17038,0,12,17050,7.75%,7.76%,
105/08/10,-5,0,0,-5,17036,0,14,17050,7.75%,7.76%,
105/08/09,0,0,0,0,17041,0,14,17055,7.75%,7.76%,
105/08/08,42,0,0,42,17041,0,14,17055,7.75%,7.76%,
105/08/05,0,0,-1,-1,16999,0,14,17013,7.74%,7.75%,
105/08/04,5,0,-5,0,16999,0,15,17014,7.74%,7.75%,
105/08/03,-6,0,-1,-7,16994,0,20,17014,7.73%,7.74%,
105/08/02,0,0,0,0,17000,0,21,17021,7.74%,7.75%,
105/08/01,1,0,0,1,17000,0,21,17021,7.74%,7.75%,
105/07/29,-1,0,0,-1,16999,0,21,17020,7.74%,7.75%,
105/07/28,6,0,1,7,17000,0,21,17021,7.74%,7.75%,
105/07/27,7,0,0,7,16994,0,20,17014,7.73%,7.74%,
105/07/26,2,0,0,2,16987,0,20,17007,7.73%,7.74%,
105/07/25,4,0,0,4,16985,0,20,17005,7.73%,7.74%,
105/07/22,14,0,0,14,16981,0,20,17001,7.73%,7.74%,
105/07/21,10,0,7,17,16967,0,20,16987,7.72%,7.73%,
105/07/20,20,0,0,20,16957,0,13,16970,7.72%,7.73%,
105/07/19,0,0,0,0,16937,0,13,16950,7.71%,7.72%,
105/07/18,0,0,0,0,16937,0,13,16950,7.71%,7.72%,
105/07/15,-33,0,0,-33,16993,0,13,17006,7.73%,7.74%,
105/07/14,21,0,0,21,17026,0,13,17039,7.75%,7.76%,
105/07/13,0,0,0,0,17005,0,13,17018,7.74%,7.75%,
105/07/12,10,0,0,10,17005,0,13,17018,7.74%,7.75%,
105/07/11,-34,0,0,-34,16995,0,13,17008,7.73%,7.74%,
105/07/07,-39,0,-4,-43,17029,0,13,17042,7.75%,7.76%,
105/07/06,10,0,0,10,17068,0,17,17085,7.77%,7.78%,
105/07/05,-11,0,0,-11,17058,0,17,17075,7.76%,7.77%,
105/07/04,11,0,0,11,17069,0,17,17086,7.77%,7.78%,
105/07/01,-3,0,0,-3,17058,0,17,17075,7.76%,7.77%,
105/06/30,-81,0,0,-81,17061,0,17,17078,7.76%,7.77%,
105/06/29,0,0,10,10,17142,0,17,17159,7.80%,7.81%,
105/06/28,5,0,0,5,17142,0,7,17149,7.80%,7.80%,
105/06/27,1,0,0,1,17137,0,7,17144,7.80%,7.80%,
105/06/24,-17,0,0,-17,17136,0,7,17143,7.80%,7.80%,
105/06/23,-1,0,0,-1,17153,0,7,17160,7.81%,7.81%,
105/06/22,0,0,0,0,17154,0,7,17161,7.81%,7.81%,
105/06/21,0,0,0,0,17154,0,7,17161,7.81%,7.81%,
105/06/20,1,0,1,2,17154,0,7,17161,7.81%,7.81%,
105/06/17,0,0,0,0,17153,0,6,17159,7.81%,7.81%,
105/06/16,0,0,0,0,17153,0,6,17159,7.81%,7.81%,
105/06/15,4,0,0,4,17153,0,6,17159,7.81%,7.81%,
105/06/14,-19,0,0,-19,17149,0,6,17155,7.80%,7.80%,
105/06/13,-13,0,0,-13,17168,0,6,17174,7.81%,7.81%,
105/06/08,1,0,0,1,17181,0,6,17187,7.82%,7.82%,
105/06/07,31,0,0,31,17180,0,6,17186,7.82%,7.82%,
105/06/06,-16,0,0,-16,17149,0,6,17155,7.80%,7.80%,
105/06/04,0,0,0,0,17165,0,6,17171,7.81%,7.81%,
105/06/03,20,0,0,20,17165,0,6,17171,7.81%,7.81%,
105/06/02,8,0,0,8,17145,0,6,17151,7.80%,7.80%,
105/06/01,-3,0,0,-3,17137,0,6,17143,7.80%,7.80%,
105/05/31,-19,0,0,-19,17140,0,6,17146,7.80%,7.80%,
105/05/30,30,0,0,30,17159,0,6,17165,7.81%,7.81%,
105/05/27,0,0,0,0,17129,0,6,17135,7.79%,7.79%,
105/05/26,-18,0,0,-18,17129,0,6,17135,7.79%,7.79%,
105/05/25,-4,0,0,-4,17147,0,6,17153,7.80%,7.80%,
105/05/24,-2,0,0,-2,17151,0,6,17157,7.80%,7.80%,
105/05/23,-12,0,0,-12,17153,0,6,17159,7.81%,7.81%,
105/05/20,-12,0,0,-12,17109,0,6,17115,7.79%,7.79%,
105/05/19,-29,0,0,-29,17121,0,6,17127,7.79%,7.79%,
105/05/18,-6,0,0,-6,17150,0,6,17156,7.80%,7.80%,
105/05/17,18,0,0,18,17156,0,6,17162,7.81%,7.81%,
105/05/16,-74,0,0,-74,17138,0,6,17144,7.80%,7.80%,
105/05/13,-9,0,0,-9,17212,0,6,17218,7.83%,7.83%,
105/05/12,1,0,0,1,17221,0,6,17227,7.84%,7.84%,
105/05/11,-2,0,0,-2,17220,0,6,17226,7.84%,7.84%,
105/05/10,-12,0,0,-12,17222,0,6,17228,7.84%,7.84%,
105/05/09,20,0,0,20,17234,0,6,17240,7.84%,7.84%,
105/05/06,-8,0,0,-8,17214,0,6,17220,7.83%,7.83%,
105/05/05,-31,0,0,-31,17222,0,6,17228,7.84%,7.84%,
105/05/04,-4,0,0,-4,17253,0,6,17259,7.85%,7.85%,
105/05/03,-16,0,0,-16,17257,0,6,17263,7.85%,7.85%,
105/04/29,-59,0,0,-59,17273,0,6,17279,7.86%,7.86%,
105/04/28,-21,0,-1,-22,17332,0,6,17338,7.89%,7.89%,
105/04/27,19,0,0,19,17353,0,7,17360,7.90%,7.90%,
105/04/26,26,0,0,26,17334,0,7,17341,7.89%,7.89%,
105/04/25,14,0,0,14,17308,0,7,17315,7.88%,7.88%,
105/04/22,16,0,0,16,17294,0,7,17301,7.87%,7.87%,
105/04/21,19,0,0,19,17278,0,7,17285,7.86%,7.86%,
105/04/20,66,0,0,66,17259,0,7,17266,7.85%,7.85%,
105/04/19,23,0,0,23,17193,0,7,17200,7.82%,7.82%,
105/04/18,-20,0,0,-20,17170,0,7,17177,7.81%,7.81%,
105/04/15,-22,0,0,-22,17190,0,7,17197,7.82%,7.82%,
105/04/14,-29,0,0,-29,17212,0,7,17219,7.83%,7.83%,
105/04/13,12,0,0,12,17241,0,7,17248,7.85%,7.85%,
105/04/12,-5,0,0,-5,17229,0,7,17236,7.84%,7.84%,
105/04/11,-5,0,0,-5,17234,0,7,17241,7.84%,7.84%,
105/04/08,14,0,0,14,17239,0,7,17246,7.84%,7.84%,
105/04/07,-2,0,1,-1,17225,0,7,17232,7.84%,7.84%,
105/04/06,-48,0,0,-48,17227,0,6,17233,7.84%,7.84%,
105/04/01,-3,0,-5,-8,17275,0,6,17281,7.86%,7.86%,
105/03/31,37,0,0,37,17278,0,11,17289,7.86%,7.87%,
105/03/30,36,0,0,36,17241,0,11,17252,7.85%,7.86%,
105/03/29,45,0,0,45,17205,0,11,17216,7.83%,7.84%,
105/03/28,-32,0,0,-32,17160,0,11,17171,7.81%,7.82%,
105/03/25,0,0,0,0,17192,0,11,17203,7.82%,7.83%,
105/03/24,10,0,0,10,17192,0,11,17203,7.82%,7.83%,
105/03/23,23,0,0,23,17182,0,11,17193,7.82%,7.83%,
105/03/22,-3,0,-1,-4,17159,0,11,17170,7.81%,7.82%,
105/03/21,-10,0,0,-10,17162,0,12,17174,7.81%,7.82%,
105/03/18,7,0,0,7,17172,0,12,17184,7.81%,7.82%,
105/03/17,-5,0,0,-5,17165,0,12,17177,7.81%,7.82%,
105/03/16,47,0,0,47,17170,0,12,17182,7.81%,7.82%,
105/03/15,-28,0,0,-28,17124,0,12,17136,7.79%,7.80%,
105/03/14,-18,0,0,-18,17152,0,12,17164,7.80%,7.81%,
105/03/11,111,0,5,116,17169,0,12,17181,7.81%,7.82%,
105/03/10,9,0,0,9,17058,0,7,17065,7.76%,7.76%,
105/03/09,4,0,2,6,17049,0,7,17056,7.76%,7.76%,
105/03/08,-33,0,0,-33,17045,0,5,17050,7.76%,7.76%,
105/03/07,26,0,0,26,17078,0,5,17083,7.77%,7.77%,
105/03/04,-1,0,0,-1,17052,0,5,17057,7.76%,7.76%,
105/03/03,0,0,0,0,17053,0,5,17058,7.76%,7.76%,
105/03/02,0,0,0,0,17053,0,5,17058,7.76%,7.76%,
105/03/01,1,0,0,1,17053,0,5,17058,7.76%,7.76%,
105/02/26,3,0,1,4,17052,0,5,17057,7.76%,7.76%,
105/02/25,5,0,0,5,17049,0,4,17053,7.76%,7.76%,
105/02/24,0,0,1,1,17044,0,4,17048,7.76%,7.76%,
105/02/23,0,0,0,0,17044,0,3,17047,7.76%,7.76%,
105/02/22,-12,0,0,-12,17044,0,3,17047,7.76%,7.76%,
105/02/19,29,0,-1,28,17056,0,3,17059,7.76%,7.76%,
105/02/18,52,0,0,52,17027,0,4,17031,7.75%,7.75%,
105/02/17,0,0,0,0,16975,0,4,16979,7.72%,7.72%,
105/02/16,1,0,0,1,16975,0,4,16979,7.72%,7.72%,
105/02/15,-7,0,1,-6,16974,0,4,16978,7.72%,7.72%,
105/02/03,-4,0,0,-4,16981,0,3,16984,7.73%,7.73%,
105/02/02,14,0,0,14,16985,0,3,16988,7.73%,7.73%,
105/02/01,-1,0,1,0,16971,0,3,16974,7.72%,7.72%,
105/01/30,0,0,-2,-2,16972,0,2,16974,7.72%,7.72%,
105/01/29,3,0,0,3,16972,0,4,16976,7.72%,7.72%,
105/01/28,1,0,0,1,16969,0,4,16973,7.72%,7.72%,
105/01/27,0,0,0,0,16968,0,4,16972,7.72%,7.72%,
105/01/26,7,0,0,7,16968,0,4,16972,7.72%,7.72%,
105/01/25,12,0,1,13,16961,0,4,16965,7.72%,7.72%,
105/01/22,32,0,-1,31,16949,0,3,16952,7.71%,7.71%,
105/01/21,26,0,0,26,16917,0,4,16921,7.70%,7.70%,
105/01/20,-22,0,0,-22,16891,0,4,16895,7.69%,7.69%,
105/01/19,-13,0,0,-13,16913,0,4,16917,7.70%,7.70%,
105/01/18,-18,0,1,-17,16926,0,4,16930,7.70%,7.70%,
105/01/15,4,0,0,4,16944,0,3,16947,7.71%,7.71%,
105/01/14,-4,0,0,-4,16940,0,3,16943,7.71%,7.71%,
105/01/13,1,0,0,1,16944,0,3,16947,7.71%,7.71%,
105/01/12,-10,0,0,-10,16943,0,3,16946,7.71%,7.71%,
105/01/11,-22,0,0,-22,16953,0,3,16956,7.71%,7.71%,
105/01/08,5,0,0,5,16975,0,3,16978,7.72%,7.72%,
105/01/07,-6,0,1,-5,16970,0,3,16973,7.72%,7.72%,
105/01/06,-3,0,0,-3,16976,0,2,16978,7.72%,7.72%,
105/01/05,11,0,0,11,16979,0,2,16981,7.73%,7.73%,
105/01/04,31,0,0,31,16968,0,2,16970,7.72%,7.72%,
104/12/31,22,0,0,22,16937,0,2,16939,7.71%,7.71%,
104/12/30,30,0,0,30,16915,0,2,16917,7.70%,7.70%,
104/12/29,0,0,0,0,16885,0,2,16887,7.68%,7.68%,
104/12/28,-2,0,0,-2,16885,0,2,16887,7.68%,7.68%,
104/12/25,-1,0,0,-1,16887,0,2,16889,7.68%,7.68%,
104/12/24,-49,0,0,-49,16888,0,2,16890,7.68%,7.68%,
104/12/23,-9,0,0,-9,16937,0,2,16939,7.71%,7.71%,
104/12/22,-32,0,0,-32,16946,0,2,16948,7.71%,7.71%,
104/12/21,-2,0,0,-2,16978,0,2,16980,7.73%,7.73%,
104/12/18,-5,0,0,-5,16980,0,2,16982,7.73%,7.73%,
104/12/17,-4,0,0,-4,16985,0,2,16987,7.73%,7.73%,
104/12/16,-4,0,0,-4,16989,0,2,16991,7.73%,7.73%,
104/12/15,-6,0,0,-6,16993,0,2,16995,7.73%,7.73%,
104/12/14,-8,0,0,-8,16999,0,2,17001,7.74%,7.74%,
104/12/11,0,0,1,1,17007,0,2,17009,7.74%,7.74%,
104/12/10,4,0,0,4,17007,0,1,17008,7.74%,7.74%,
104/12/09,3,0,0,3,17003,0,1,17004,7.74%,7.74%,
104/12/08,3,0,0,3,17000,0,1,17001,7.74%,7.74%,
104/12/07,15,0,-1,14,16997,0,1,16998,7.73%,7.73%,
104/12/04,-2,0,0,-2,16982,0,2,16984,7.73%,7.73%,
104/12/03,10,0,-1,9,16984,0,2,16986,7.73%,7.73%,
104/12/02,8,0,0,8,16974,0,3,16977,7.72%,7.72%,
104/12/01,22,0,0,22,16966,0,3,16969,7.72%,7.72%,
104/11/30,7,0,0,7,16944,0,3,16947,7.71%,7.71%,
104/11/27,-2,0,0,-2,16937,0,3,16940,7.71%,7.71%,
104/11/26,5,0,0,5,16939,0,3,16942,7.71%,7.71%,
104/11/25,2,0,0,2,16934,0,3,16937,7.71%,7.71%,
104/11/24,-13,0,0,-13,16932,0,3,16935,7.70%,7.70%,
104/11/23,-12,0,0,-12,16945,0,3,16948,7.71%,7.71%,
104/11/20,-19,0,0,-19,16957,0,3,16960,7.72%,7.72%,
104/11/19,-9,0,0,-9,16976,0,3,16979,7.72%,7.72%,
104/11/18,-19,0,0,-19,16985,0,3,16988,7.73%,7.73%,
104/11/17,-14,0,0,-14,17004,0,3,17007,7.74%,7.74%,
104/11/16,-26,0,-1,-27,17018,0,3,17021,7.74%,7.74%,
104/11/13,1,0,0,1,17044,0,4,17048,7.76%,7.76%,
104/11/12,-8,0,0,-8,17043,0,4,17047,7.76%,7.76%,
104/11/11,-39,0,0,-39,17051,0,4,17055,7.76%,7.76%,
104/11/10,-14,0,0,-14,17090,0,4,17094,7.78%,7.78%,
104/11/09,0,0,0,0,17104,0,4,17108,7.78%,7.78%,
104/11/06,4,0,0,4,17104,0,4,17108,7.78%,7.78%,
104/11/05,2,0,0,2,17100,0,4,17104,7.78%,7.78%,
104/11/04,44,0,1,45,17098,0,4,17102,7.78%,7.78%,
104/11/03,14,0,1,15,17054,0,3,17057,7.76%,7.76%,
104/11/02,-36,0,0,-36,17040,0,2,17042,7.75%,7.75%,
104/10/30,-7,0,0,-7,17076,0,2,17078,7.77%,7.77%,
104/10/29,-10,0,0,-10,17083,0,2,17085,7.77%,7.77%,
104/10/28,-1,0,0,-1,17093,0,2,17095,7.78%,7.78%,
104/10/27,-10,0,-1,-11,17094,0,2,17096,7.78%,7.78%,
104/10/26,-5,0,0,-5,17104,0,3,17107,7.78%,7.78%,
104/10/23,-8,0,0,-8,17109,0,3,17112,7.79%,7.79%,
104/10/22,-16,0,0,-16,17117,0,3,17120,7.79%,7.79%,
104/10/21,2,0,0,2,17133,0,3,17136,7.80%,7.80%,
104/10/20,9,0,0,9,17131,0,3,17134,7.80%,7.80%,
104/10/19,11,0,0,11,17122,0,3,17125,7.79%,7.79%,
104/10/16,2,0,0,2,17111,0,3,17114,7.79%,7.79%,
104/10/15,7,0,0,7,17109,0,3,17112,7.79%,7.79%,
104/10/14,12,0,0,12,17102,0,3,17105,7.78%,7.78%,
104/10/13,-21,0,0,-21,17090,0,3,17093,7.78%,7.78%,
104/10/12,-3,0,0,-3,17111,0,3,17114,7.79%,7.79%,
104/10/08,3,0,0,3,17114,0,3,17117,7.79%,7.79%,
104/10/07,10,0,0,10,17111,0,3,17114,7.79%,7.79%,
104/10/06,-1,0,0,-1,17101,0,3,17104,7.78%,7.78%,
104/10/05,-2,0,0,-2,17102,0,3,17105,7.78%,7.78%,
104/10/02,-13,0,0,-13,17104,0,3,17107,7.78%,7.78%,
104/10/01,-15,0,1,-14,17117,0,3,17120,7.79%,7.79%,
104/09/30,-13,0,0,-13,17132,0,2,17134,7.80%,7.80%,
104/09/25,-19,0,1,-18,17145,0,2,17147,7.80%,7.80%,
104/09/24,-12,0,0,-12,17164,0,1,17165,7.81%,7.81%,
104/09/23,-18,0,0,-18,17176,0,1,17177,7.82%,7.82%,
104/09/22,-3,0,0,-3,17194,0,1,17195,7.82%,7.82%,
104/09/21,-31,-52,1,-82,17197,0,1,17198,7.83%,7.83%,
104/09/18,-23,0,0,-23,17228,52,0,17280,7.84%,7.86%,
104/09/17,-22,0,0,-22,17251,52,0,17303,7.85%,7.87%,
104/09/16,-30,0,0,-30,17273,52,0,17325,7.86%,7.88%,
104/09/15,-26,0,-1,-27,17303,52,0,17355,7.87%,7.89%,
104/09/14,-4,0,0,-4,17329,52,1,17382,7.89%,7.91%,
104/09/11,-15,0,-1,-16,17333,52,1,17386,7.89%,7.91%,
104/09/10,2,0,0,2,17348,52,2,17402,7.89%,7.91%,
104/09/09,2,0,1,3,17346,52,2,17400,7.89%,7.91%,
104/09/08,-7,0,0,-7,17344,52,1,17397,7.89%,7.91%,
104/09/07,-24,0,0,-24,17351,52,1,17404,7.90%,7.92%,
104/09/04,-24,0,-1,-25,17375,52,1,17428,7.91%,7.93%,
104/09/03,-17,0,0,-17,17399,52,2,17453,7.92%,7.94%,
104/09/02,-23,0,0,-23,17416,52,2,17470,7.93%,7.95%,
104/09/01,-45,-7,-1,-53,17439,52,2,17493,7.94%,7.96%,
104/08/31,-14,-4,0,-18,17484,59,3,17546,7.96%,7.99%,
104/08/28,-21,0,0,-21,17498,63,3,17564,7.96%,7.99%,
104/08/27,-56,0,-5,-61,17519,63,3,17585,7.97%,8.00%,
104/08/26,-71,0,-8,-79,17575,63,8,17646,8.00%,8.03%,
104/08/25,4,0,-2,2,17646,63,16,17725,8.03%,8.07%,
104/08/24,-63,0,9,-54,17642,63,18,17723,8.03%,8.07%,
104/08/21,-50,0,-3,-53,17705,63,9,17777,8.06%,8.09%,
104/08/20,-24,0,-1,-25,17755,63,12,17830,8.08%,8.11%,
104/08/19,-41,0,-5,-46,17779,63,13,17855,8.09%,8.12%,
104/08/18,-22,0,-8,-30,17820,63,18,17901,8.11%,8.15%,
104/08/17,-23,0,-3,-26,17842,63,26,17931,8.12%,8.16%,
104/08/14,-47,0,-1,-48,17865,63,29,17957,8.13%,8.17%,
104/08/13,3,0,0,3,17912,63,30,18005,8.15%,8.19%,
104/08/12,-11,0,13,2,17909,63,30,18002,8.15%,8.19%,
104/08/11,-34,0,-19,-53,17920,63,17,18000,8.15%,8.19%,
104/08/10,7,0,-6,1,17954,63,36,18053,8.17%,8.22%,
104/08/07,-4,0,-1,-5,17947,63,42,18052,8.17%,8.22%,
104/08/06,30,0,-6,24,17951,63,43,18057,8.17%,8.22%,
104/08/05,4,0,9,13,17921,63,49,18033,8.16%,8.21%,
104/08/04,7,0,14,21,17917,63,40,18020,8.15%,8.20%,
104/08/03,-8,0,-1,-9,17910,63,26,17999,8.15%,8.19%,
104/07/31,16,0,-12,4,17918,63,27,18008,8.15%,8.19%,
104/07/30,0,0,-1,-1,17902,63,39,18004,8.15%,8.20%,
104/07/29,-50,0,1,-49,17902,63,40,18005,8.15%,8.20%,
104/07/28,-4,5,3,4,17952,63,39,18054,8.17%,8.22%,
104/07/27,-66,0,15,-51,17956,58,36,18050,8.17%,8.21%,
104/07/24,-36,1,-2,-37,18022,58,21,18101,8.20%,8.24%,
104/07/23,-18,0,8,-10,18058,57,23,18138,8.22%,8.26%,
104/07/22,-21,0,7,-14,18076,57,15,18148,8.23%,8.26%,
104/07/21,21,0,0,21,18097,57,8,18162,8.24%,8.27%,
104/07/20,-2,0,0,-2,18076,57,8,18141,8.23%,8.26%,
104/07/17,-15,48,0,33,18078,57,8,18143,8.23%,8.26%,
104/07/16,7,0,-1,6,18093,9,8,18110,8.23%,8.24%,
104/07/15,-15,3,0,-12,18086,9,9,18104,8.23%,8.24%,
104/07/14,-29,0,-2,-31,18101,6,9,18116,8.24%,8.25%,
104/07/13,-32,0,-3,-35,18130,6,11,18147,8.25%,8.26%,
104/07/09,-63,0,2,-61,18162,6,14,18182,8.26%,8.27%,
104/07/08,-149,0,5,-144,18225,6,12,18243,8.29%,8.30%,
104/07/07,-52,0,0,-52,18374,6,7,18387,8.36%,8.37%,
104/07/06,-4,0,0,-4,18436,6,7,18449,8.39%,8.40%,
104/07/03,-31,0,0,-31,18440,6,7,18453,8.39%,8.40%,
104/07/02,-10,0,0,-10,18471,6,7,18484,8.41%,8.42%,
104/07/01,-3,0,1,-2,18481,6,7,18494,8.41%,8.42%,
104/06/30,-11,0,0,-11,18484,6,6,18496,8.41%,8.42%,
104/06/29,-18,0,0,-18,18495,6,6,18507,8.42%,8.43%,
104/06/26,26,0,0,26,18513,6,6,18525,8.42%,8.43%,
104/06/25,6,0,0,6,18487,6,6,18499,8.41%,8.42%,
104/06/24,-82,0,0,-82,18481,6,6,18493,8.41%,8.42%,
104/06/23,-15,0,4,-11,18563,6,6,18575,8.45%,8.46%,
104/06/22,-101,6,0,-95,18578,6,2,18586,8.45%,8.45%,
104/06/18,-37,0,1,-36,18679,0,2,18681,8.50%,8.50%,
104/06/17,-143,0,0,-143,18716,0,1,18717,8.52%,8.52%,
104/06/16,-62,0,1,-61,18859,0,1,18860,8.58%,8.58%,
104/06/15,11,0,-1,10,18921,0,0,18921,8.61%,8.61%,
104/06/12,-25,0,0,-25,18940,0,1,18941,8.62%,8.62%,
104/06/11,-54,0,-1,-55,18965,0,1,18966,8.63%,8.63%,
104/06/10,-31,0,0,-31,18989,0,2,18991,8.64%,8.64%,
104/06/09,-17,0,0,-17,19020,0,2,19022,8.66%,8.66%,
104/06/08,-3,0,0,-3,19037,0,2,19039,8.66%,8.66%,
104/06/05,-79,0,0,-79,19040,0,2,19042,8.66%,8.66%,
104/06/04,-114,0,-1,-115,19119,0,2,19121,8.70%,8.70%,
104/06/03,-167,0,0,-167,19285,0,3,19288,8.78%,8.78%,
104/06/02,-125,0,-1,-126,19452,0,3,19455,8.85%,8.85%,
104/06/01,-60,0,0,-60,19595,0,4,19599,8.92%,8.92%,
104/05/29,-59,0,0,-59,19655,0,4,19659,8.94%,8.94%,
104/05/28,-61,-38,0,-99,19714,0,4,19718,8.97%,8.97%,
104/05/27,-74,0,0,-74,19775,38,4,19817,9.00%,9.02%,
104/05/26,-55,0,0,-55,19849,38,4,19891,9.03%,9.05%,
104/05/25,-36,0,0,-36,19918,38,4,19960,9.06%,9.08%,
104/05/22,-121,0,0,-121,19954,38,4,19996,9.08%,9.10%,
104/05/21,-107,0,-7,-114,20075,38,4,20117,9.14%,9.16%,
104/05/20,-36,0,-3,-39,20182,38,11,20231,9.18%,9.20%,
104/05/19,-38,0,-2,-40,20218,38,14,20270,9.20%,9.22%,
104/05/18,-91,0,0,-91,20256,38,16,20310,9.22%,9.24%,
104/05/15,-35,0,-2,-37,20347,38,16,20401,9.26%,9.28%,
104/05/14,-48,0,-4,-52,20382,38,18,20438,9.28%,9.31%,
104/05/13,-71,0,0,-71,20430,38,22,20490,9.30%,9.33%,
104/05/12,14,0,1,15,20501,38,22,20561,9.33%,9.36%,
104/05/11,-16,0,3,-13,20487,38,21,20546,9.32%,9.35%,
104/05/08,-32,0,0,-32,20503,38,18,20559,9.33%,9.36%,
104/05/07,-40,0,0,-40,20535,38,18,20591,9.35%,9.38%,
104/05/06,-25,0,2,-23,20575,38,18,20631,9.36%,9.39%,
104/05/05,-6,0,0,-6,20600,38,16,20654,9.37%,9.39%,
104/05/04,-54,0,0,-54,20606,38,16,20660,9.38%,9.40%,
104/04/30,36,0,0,36,20660,38,16,20714,9.40%,9.42%,
104/04/29,63,0,4,67,20624,38,16,20678,9.39%,9.41%,
104/04/28,50,-1,1,50,20561,38,12,20611,9.36%,9.38%,
104/04/27,22,0,0,22,20461,39,11,20511,9.31%,9.33%,
104/04/24,33,0,9,42,20439,39,11,20489,9.30%,9.32%,
104/04/23,-139,0,-2,-141,20406,39,2,20447,9.29%,9.31%,
104/04/22,-46,0,1,-45,20551,39,4,20594,9.35%,9.37%,
104/04/21,-197,0,1,-196,20597,39,3,20639,9.37%,9.39%,
104/04/20,-20,0,2,-18,20794,39,2,20835,9.46%,9.48%,
104/04/17,-64,0,0,-64,20814,39,0,20853,9.47%,9.49%,
104/04/16,-62,0,-15,-77,20878,39,0,20917,9.50%,9.52%,
104/04/15,-179,39,0,-140,20900,39,15,20954,9.51%,9.53%,
104/04/14,-49,0,0,-49,21079,0,15,21094,9.59%,9.60%,
104/04/13,-52,0,0,-52,21128,0,15,21143,9.62%,9.63%,
104/04/10,-76,0,0,-76,21170,0,15,21185,9.63%,9.64%,
104/04/09,-90,0,0,-90,21246,0,15,21261,9.67%,9.68%,
104/04/08,483,0,0,483,21336,0,15,21351,9.71%,9.72%,
104/04/07,417,0,0,417,20853,0,15,20868,9.49%,9.50%,
104/04/02,3,0,0,3,20436,0,15,20451,9.30%,9.31%,
104/04/01,-148,0,0,-148,20433,0,15,20448,9.30%,9.31%,
104/03/31,-31,0,2,-29,20581,0,15,20596,9.37%,9.38%,
104/03/30,-29,0,0,-29,20615,0,13,20628,9.38%,9.39%,
104/03/27,41,0,0,41,20644,0,13,20657,9.39%,9.40%,
104/03/26,-193,0,1,-192,20603,0,13,20616,9.38%,9.39%,
104/03/25,-159,0,4,-155,20796,0,12,20808,9.46%,9.47%,
104/03/24,-143,0,0,-143,20955,0,8,20963,9.54%,9.54%,
104/03/23,7,0,0,7,21098,0,8,21106,9.60%,9.60%,
104/03/20,-30,0,0,-30,21091,0,8,21099,9.60%,9.60%,
104/03/19,-23,0,1,-22,21121,0,8,21129,9.61%,9.61%,
104/03/18,-63,0,0,-63,21144,0,7,21151,9.62%,9.62%,
104/03/17,-13,0,0,-13,21207,0,7,21214,9.65%,9.65%,
104/03/16,-35,0,2,-33,21220,0,7,21227,9.66%,9.66%,
104/03/13,-42,0,0,-42,21255,0,5,21260,9.67%,9.67%,
104/03/12,-67,0,0,-67,21297,0,5,21302,9.69%,9.69%,
104/03/11,-47,0,0,-47,21364,0,5,21369,9.72%,9.72%,
104/03/10,-71,0,0,-71,21411,0,5,21416,9.74%,9.74%,
104/03/09,-41,0,0,-41,21482,0,5,21487,9.78%,9.78%,
104/03/06,-83,0,0,-83,21523,0,5,21528,9.80%,9.80%,
104/03/05,-20,0,-1,-21,21606,0,5,21611,9.83%,9.83%,
104/03/04,-82,0,0,-82,21626,0,6,21632,9.84%,9.84%,
104/03/03,-82,0,0,-82,21708,0,6,21714,9.88%,9.88%,
104/03/02,-52,0,0,-52,21790,0,6,21796,9.92%,9.92%,
104/02/26,-116,0,0,-116,21971,0,6,21977,10.00%,10.00%,
104/02/25,-111,0,-1,-112,22087,0,6,22093,10.05%,10.05%,
104/02/24,-67,0,0,-67,22198,0,7,22205,10.10%,10.10%,
104/02/13,-64,0,-1,-65,22265,0,7,22272,10.13%,10.13%,
104/02/12,-63,0,0,-63,22329,0,8,22337,10.16%,10.16%,
104/02/11,-18,0,0,-18,22392,0,8,22400,10.19%,10.19%,
104/02/10,-37,0,7,-30,22410,0,8,22418,10.20%,10.20%,
104/02/09,-42,0,0,-42,22447,0,1,22448,10.22%,10.22%,
104/02/06,-66,0,0,-66,22489,0,1,22490,10.24%,10.24%,
104/02/05,-34,0,0,-34,22555,0,1,22556,10.27%,10.27%,
104/02/04,-88,0,0,-88,22589,0,1,22590,10.28%,10.28%,
104/02/03,-25,0,0,-25,22677,0,1,22678,10.32%,10.32%,
104/02/02,-99,0,0,-99,22729,0,1,22730,10.34%,10.34%,
104/01/30,-41,0,0,-41,22828,0,1,22829,10.39%,10.39%,
104/01/29,-70,0,0,-70,22869,0,1,22870,10.41%,10.41%,
104/01/28,-38,0,0,-38,22989,0,1,22990,10.46%,10.46%,
104/01/27,-145,0,0,-145,23027,0,1,23028,10.48%,10.48%,
104/01/26,-46,0,0,-46,23172,0,1,23173,10.55%,10.55%,
104/01/23,-79,0,0,-79,23168,0,1,23169,10.54%,10.54%,
104/01/22,-49,0,0,-49,23247,0,1,23248,10.58%,10.58%,
104/01/21,-57,0,0,-57,23296,0,1,23297,10.60%,10.60%,
104/01/20,-3,0,0,-3,23353,0,1,23354,10.63%,10.63%,
104/01/19,-59,0,0,-59,23356,0,1,23357,10.63%,10.63%,
104/01/16,-113,0,-2,-115,23415,0,1,23416,10.66%,10.66%,
104/01/15,-66,0,0,-66,23528,0,3,23531,10.71%,10.71%,
104/01/14,-69,0,0,-69,23594,0,3,23597,10.74%,10.74%,
104/01/13,-56,0,1,-55,23663,0,3,23666,10.77%,10.77%,
104/01/12,-28,0,0,-28,23719,0,2,23721,10.79%,10.79%,
104/01/09,-91,0,1,-90,23747,0,2,23749,10.81%,10.81%,
104/01/08,-66,0,0,-66,23838,0,1,23839,10.85%,10.85%,
104/01/07,-98,0,0,-98,23904,0,1,23905,10.88%,10.88%,
104/01/06,-119,0,0,-119,24002,0,1,24003,10.92%,10.92%,
104/01/05,-46,0,0,-46,24121,0,1,24122,10.98%,10.98%,
