日期,外資買賣超,投信買賣超,自營商買賣超,單日合計買賣超,外資估計持股,投信估計持股,自營商估計持股,單日合計估計持股,外資持股比重,三大法人持股比重,
107/03/31,0,0,0,0,62241,123,6240,68604,5.83%,6.43%,
107/03/30,72,0,0,72,62241,123,6240,68604,5.83%,6.43%,
107/03/29,45,0,0,45,62169,123,6240,68532,5.82%,6.42%,
107/03/28,394,0,0,394,62124,123,6240,68487,5.82%,6.42%,
107/03/27,5,0,0,5,61730,123,6240,68093,5.78%,6.38%,
107/03/26,196,0,0,196,61725,123,6240,68088,5.78%,6.38%,
107/03/23,-19,0,-3,-22,61529,123,6240,67892,5.76%,6.36%,
107/03/22,-9,0,0,-9,61548,123,6243,67914,5.76%,6.36%,
107/03/21,9,0,-1,8,61617,123,6243,67983,5.77%,6.37%,
107/03/20,-3,-1,-5,-9,61608,123,6244,67975,5.77%,6.37%,
107/03/19,-2,0,0,-2,61611,124,6249,67984,5.77%,6.37%,
107/03/16,-189,0,0,-189,61613,124,6249,67986,5.77%,6.37%,
107/03/15,-7,0,5,-2,61802,124,6249,68175,5.79%,6.39%,
107/03/14,-10,0,0,-10,61809,124,6244,68177,5.79%,6.39%,
107/03/13,110,0,1,111,61819,124,6244,68187,5.79%,6.39%,
107/03/12,15,0,-2,13,61709,124,6243,68076,5.78%,6.38%,
107/03/09,55,0,0,55,61694,124,6245,68063,5.78%,6.38%,
107/03/08,35,0,0,35,61639,124,6245,68008,5.77%,6.37%,
107/03/07,-2,0,0,-2,61605,124,6245,67974,5.77%,6.37%,
107/03/06,-11,0,0,-11,61607,124,6245,67976,5.77%,6.37%,
107/03/05,-103,0,0,-103,61618,124,6245,67987,5.77%,6.37%,
107/03/02,-120,1,0,-119,61721,124,6245,68090,5.78%,6.38%,
107/03/01,45,0,0,45,61841,123,6245,68209,5.79%,6.39%,
107/02/27,101,0,-2,99,61796,123,6245,68164,5.79%,6.39%,
107/02/26,24,0,0,24,61695,123,6247,68065,5.78%,6.38%,
107/02/23,33,0,0,33,61671,123,6247,68041,5.77%,6.37%,
107/02/22,10,0,0,10,61638,123,6247,68008,5.77%,6.37%,
107/02/21,190,0,-3,187,61628,123,6247,67998,5.77%,6.37%,
107/02/12,-25,0,0,-25,61448,123,6250,67821,5.75%,6.35%,
107/02/09,-61,0,0,-61,61473,123,6250,67846,5.76%,6.36%,
107/02/08,3,1,0,4,61534,123,6250,67907,5.76%,6.36%,
107/02/07,-276,5,-4,-275,61531,122,6250,67903,5.76%,6.36%,
107/02/06,-132,0,10,-122,61807,117,6254,68178,5.79%,6.39%,
107/02/05,61,0,1,62,61939,117,6244,68300,5.80%,6.40%,
107/02/02,1,0,-1,0,61878,117,6243,68238,5.79%,6.39%,
107/02/01,-67,0,0,-67,61877,117,6244,68238,5.79%,6.39%,
107/01/31,5,-1,0,4,61944,117,6244,68305,5.80%,6.40%,
107/01/30,-62,0,0,-62,61939,118,6244,68301,5.80%,6.40%,
107/01/29,-59,0,0,-59,62001,118,6244,68363,5.80%,6.40%,
107/01/26,40,0,3,43,62050,118,6244,68412,5.81%,6.41%,
107/01/25,-34,0,2,-32,62010,118,6241,68369,5.81%,6.41%,
107/01/24,16,0,0,16,62044,118,6239,68401,5.81%,6.41%,
107/01/23,80,0,0,80,62028,118,6239,68385,5.81%,6.41%,
107/01/22,-44,0,0,-44,61948,118,6239,68305,5.80%,6.40%,
107/01/19,-2,0,0,-2,61992,118,6239,68349,5.80%,6.40%,
107/01/18,13,0,0,13,61994,118,6239,68351,5.80%,6.40%,
107/01/17,196,0,0,196,61981,118,6239,68338,5.80%,6.40%,
107/01/16,78,0,0,78,61785,118,6239,68142,5.78%,6.38%,
107/01/15,5,0,0,5,61707,118,6239,68064,5.78%,6.38%,
107/01/12,15,0,1,16,61702,118,6239,68059,5.78%,6.38%,
107/01/11,-23,0,1,-22,61687,118,6238,68043,5.78%,6.38%,
107/01/10,-17,0,0,-17,61710,118,6237,68065,5.78%,6.38%,
107/01/09,-10,0,-2,-12,61727,118,6237,68082,5.78%,6.38%,
107/01/08,-12,0,-5,-17,61737,118,6239,68094,5.78%,6.38%,
107/01/05,51,0,0,51,61749,118,6244,68111,5.78%,6.38%,
107/01/04,-18,0,0,-18,61698,118,6244,68060,5.78%,6.38%,
107/01/03,-20,0,2,-18,61716,118,6244,68078,5.78%,6.38%,
107/01/02,14,0,0,14,61736,118,6242,68096,5.78%,6.38%,
106/12/29,195,0,0,195,61715,118,6242,68075,5.78%,6.38%,
106/12/28,7,0,0,7,61520,109,6242,67871,5.76%,6.36%,
106/12/27,-89,1,0,-88,61513,109,6242,67864,5.76%,6.36%,
106/12/26,-93,0,0,-93,61602,108,6242,67952,5.77%,6.37%,
106/12/25,27,0,0,27,61695,108,6242,68045,5.78%,6.38%,
106/12/22,298,0,0,298,61667,108,6242,68017,5.77%,6.37%,
106/12/21,104,0,0,104,61369,108,6242,67719,5.75%,6.35%,
106/12/20,35,0,0,35,61265,108,6242,67615,5.74%,6.34%,
106/12/19,65,0,2,67,61230,108,6242,67580,5.73%,6.33%,
106/12/18,48,0,-1,47,61177,108,6240,67525,5.73%,6.32%,
106/12/15,-100,0,0,-100,61129,108,6241,67478,5.72%,6.31%,
106/12/14,14,0,0,14,61229,108,6241,67578,5.73%,6.32%,
106/12/13,50,0,0,50,61215,108,6241,67564,5.73%,6.32%,
106/12/12,64,0,0,64,61165,108,6241,67514,5.73%,6.32%,
106/12/11,22,0,0,22,61101,108,6241,67450,5.72%,6.31%,
106/12/08,90,0,0,90,61079,108,6241,67428,5.72%,6.31%,
106/12/07,-34,0,0,-34,60989,108,6241,67338,5.71%,6.30%,
106/12/06,-21,1,1,-19,61023,108,6241,67372,5.71%,6.30%,
106/12/05,39,0,0,39,61044,107,6240,67391,5.72%,6.31%,
106/12/04,231,0,0,231,61005,107,6240,67352,5.71%,6.30%,
106/12/01,68,0,0,68,60774,107,6240,67121,5.69%,6.28%,
106/11/30,435,0,-3,432,60706,107,6240,67053,5.68%,6.27%,
106/11/29,-42,-5,0,-47,60271,107,6243,66621,5.64%,6.24%,
106/11/28,40,-2,0,38,60313,112,6243,66668,5.65%,6.25%,
106/11/27,-7,0,0,-7,60273,114,6243,66630,5.64%,6.24%,
106/11/24,80,0,0,80,60280,114,6243,66637,5.64%,6.24%,
106/11/23,47,0,0,47,60200,114,6243,66557,5.64%,6.24%,
106/11/22,256,0,0,256,60153,114,6243,66510,5.63%,6.23%,
106/11/21,50,0,0,50,59897,114,6243,66254,5.61%,6.21%,
106/11/20,5,0,0,5,59847,114,6243,66204,5.60%,6.20%,
106/11/17,19,0,0,19,59842,114,6243,66199,5.60%,6.20%,
106/11/16,29,0,0,29,59823,114,6243,66180,5.60%,6.20%,
106/11/15,54,0,0,54,59794,114,6243,66151,5.60%,6.20%,
106/11/14,44,-1,0,43,59740,114,6243,66097,5.59%,6.19%,
106/11/13,208,0,0,208,59696,115,6243,66054,5.59%,6.19%,
106/11/10,20,0,0,20,59488,115,6243,65846,5.57%,6.17%,
106/11/09,8,-2,0,6,59468,115,6243,65826,5.57%,6.17%,
106/11/08,-1,0,0,-1,59460,117,6243,65820,5.57%,6.17%,
106/11/07,-3,0,0,-3,59461,117,6243,65821,5.57%,6.17%,
106/11/06,16,0,0,16,59464,117,6243,65824,5.57%,6.17%,
106/11/03,175,0,0,175,59448,117,6243,65808,5.57%,6.17%,
106/11/02,70,0,0,70,59273,117,6243,65633,5.55%,6.15%,
106/11/01,136,-2,0,134,59203,117,6243,65563,5.54%,6.14%,
106/10/31,19,0,0,19,59067,119,6243,65429,5.53%,6.13%,
106/10/30,124,0,0,124,59048,119,6243,65410,5.53%,6.13%,
106/10/27,100,0,0,100,58924,119,6243,65286,5.52%,6.12%,
106/10/26,68,0,0,68,58824,119,6243,65186,5.51%,6.11%,
106/10/25,173,0,0,173,58756,119,6243,65118,5.50%,6.10%,
106/10/24,144,-1,0,143,58583,119,6243,64945,5.48%,6.08%,
106/10/23,90,0,0,90,58439,120,6243,64802,5.47%,6.07%,
106/10/20,497,0,0,497,58349,120,6243,64712,5.46%,6.06%,
106/10/19,114,0,0,114,57743,120,6243,64106,5.41%,6.01%,
106/10/18,58,-1,0,57,57629,120,6243,63992,5.40%,6.00%,
106/10/17,441,-1,0,440,57571,121,6243,63935,5.39%,5.99%,
106/10/16,147,0,0,147,57130,122,6243,63495,5.35%,5.95%,
106/10/13,136,0,0,136,56983,122,6243,63348,5.33%,5.93%,
106/10/12,22,0,0,22,56847,122,6243,63212,5.32%,5.92%,
106/10/11,210,0,0,210,56825,122,6243,63190,5.32%,5.92%,
106/10/06,155,0,0,155,56615,122,6243,62980,5.30%,5.90%,
106/10/05,202,0,0,202,56460,122,6243,62825,5.29%,5.89%,
106/10/03,-100,-9,0,-109,56258,122,6243,62623,5.27%,5.87%,
106/10/02,-67,0,-7,-74,56358,131,6243,62732,5.28%,5.88%,
106/09/30,0,0,0,0,56425,131,6250,62806,5.28%,5.88%,
106/09/29,45,0,0,45,56425,146,6250,62821,5.28%,5.88%,
106/09/28,-153,0,0,-153,56380,146,6250,62776,5.28%,5.88%,
106/09/27,22,0,0,22,56533,146,6250,62929,5.29%,5.89%,
106/09/26,-3,0,5,2,56511,146,6250,62907,5.29%,5.89%,
106/09/25,171,0,0,171,56514,146,6245,62905,5.29%,5.89%,
106/09/22,133,0,0,133,56343,146,6245,62734,5.27%,5.87%,
106/09/21,-244,0,0,-244,56210,146,6245,62601,5.26%,5.86%,
106/09/20,-176,0,2,-174,56174,146,6245,62565,5.26%,5.86%,
106/09/19,133,-1,0,132,56200,146,6243,62589,5.26%,5.86%,
106/09/18,140,0,0,140,56067,147,6243,62457,5.25%,5.85%,
106/09/15,308,-1,0,307,55927,147,6243,62317,5.24%,5.84%,
106/09/14,11,0,0,11,55619,148,6243,62010,5.21%,5.81%,
106/09/13,50,0,0,50,55608,148,6243,61999,5.21%,5.81%,
106/09/12,86,0,0,86,55558,148,6243,61949,5.20%,5.80%,
106/09/11,183,0,0,183,55472,148,6243,61863,5.19%,5.79%,
106/09/08,250,0,0,250,55289,148,6243,61680,5.18%,5.78%,
106/09/07,166,0,0,166,55038,148,6243,61429,5.15%,5.75%,
106/09/06,-60,-1,0,-61,54872,148,6243,61263,5.14%,5.74%,
106/09/05,1,0,0,1,54932,149,6243,61324,5.14%,5.74%,
106/09/04,46,0,0,46,54931,149,6243,61323,5.14%,5.74%,
106/09/01,-12,0,0,-12,54885,149,6243,61277,5.14%,5.74%,
106/08/31,139,0,0,139,54897,149,6243,61289,5.14%,5.74%,
106/08/30,56,0,0,56,54652,149,6243,61044,5.12%,5.72%,
106/08/29,58,0,0,58,54596,149,6243,60988,5.11%,5.71%,
106/08/28,-141,0,0,-141,54538,149,6243,60930,5.11%,5.71%,
106/08/25,125,0,0,125,54679,149,6243,61071,5.12%,5.72%,
106/08/24,60,0,2,62,54554,149,6243,60946,5.11%,5.71%,
106/08/23,-178,-1,0,-179,54494,149,6241,60884,5.10%,5.70%,
106/08/22,177,0,0,177,54672,150,6241,61063,5.12%,5.72%,
106/08/21,144,0,0,144,54495,150,6241,60886,5.10%,5.70%,
106/08/18,-6,0,0,-6,54351,150,6241,60742,5.09%,5.69%,
106/08/17,63,0,-4,59,54357,150,6241,60748,5.09%,5.69%,
106/08/16,72,0,-4,68,54294,150,6245,60689,5.08%,5.68%,
106/08/15,10,0,-2,8,54222,150,6249,60621,5.08%,5.68%,
106/08/14,38,0,2,40,54212,150,6251,60613,5.08%,5.68%,
106/08/11,-55,0,0,-55,54174,150,6249,60573,5.07%,5.67%,
106/08/10,13,0,-7,6,54919,150,6249,61318,5.14%,5.74%,
106/08/09,51,0,1,52,54906,150,6256,61312,5.14%,5.74%,
106/08/08,33,-1,-5,27,54872,150,6255,61277,5.14%,5.74%,
106/08/07,114,0,0,114,54839,151,6260,61250,5.13%,5.73%,
106/08/04,201,2,-16,187,54645,151,6260,61056,5.12%,5.72%,
106/08/03,26,0,-12,14,54444,149,6276,60869,5.10%,5.70%,
106/08/02,117,-1,10,126,54418,149,6288,60855,5.09%,5.69%,
106/08/01,133,0,0,133,54301,150,6278,60729,5.08%,5.68%,
106/07/31,13,0,215,228,54168,150,6278,60596,5.07%,5.67%,
106/07/28,124,0,0,124,54155,150,6063,60368,5.07%,5.65%,
106/07/27,318,0,0,318,54031,150,6063,60244,5.06%,5.64%,
106/07/26,60,0,-27,33,53713,150,6063,59926,5.03%,5.61%,
106/07/25,-37,0,0,-37,53653,150,6090,59893,5.02%,5.60%,
106/07/24,703,0,-2,701,54080,150,6090,60320,5.06%,5.64%,
106/07/21,-12,0,0,-12,53377,150,6092,59619,5.00%,5.58%,
106/07/20,2,0,0,2,53389,150,6092,59631,5.00%,5.58%,
106/07/19,22,0,0,22,53387,150,6092,59629,5.00%,5.58%,
106/07/18,-9,3,-5,-11,53242,150,6092,59484,4.98%,5.56%,
106/07/17,29,1,-26,4,53251,147,6097,59495,4.99%,5.58%,
106/07/14,27,-2,-4,21,54872,146,6123,61141,5.14%,5.73%,
106/07/13,66,-2,-11,53,54845,148,6127,61120,5.13%,5.72%,
106/07/12,16,-2,-21,-7,54779,150,6138,61067,5.13%,5.72%,
106/07/11,45,0,27,72,54763,152,6159,61074,5.13%,5.72%,
106/07/10,-45,-1,0,-46,54718,152,6132,61002,5.12%,5.71%,
106/07/07,-21,0,0,-21,54763,153,6132,61048,5.13%,5.72%,
106/07/06,-4,0,0,-4,54860,153,6132,61145,5.14%,5.73%,
106/07/05,-47,0,-2,-49,55064,153,6132,61349,5.15%,5.74%,
106/07/04,76,-1,0,75,55111,153,6134,61398,5.16%,5.75%,
106/07/03,22,0,-2,20,55035,154,6134,61323,5.15%,5.74%,
106/06/30,49,0,0,49,55013,154,6136,61303,5.15%,5.74%,
106/06/29,132,0,0,132,54964,147,6136,61247,5.15%,5.74%,
106/06/28,148,0,2,150,54982,147,6136,61265,5.15%,5.74%,
106/06/27,259,-1,0,258,54834,147,6134,61115,5.13%,5.72%,
106/06/26,250,-2,62,310,54575,148,6134,60857,5.11%,5.70%,
106/06/23,65,-1,0,64,54325,150,6072,60547,5.09%,5.67%,
106/06/22,132,0,0,132,54260,151,6072,60483,5.08%,5.66%,
106/06/21,203,0,45,248,54128,151,6072,60351,5.07%,5.65%,
106/06/20,-12,-3,35,20,53925,151,6027,60103,5.05%,5.63%,
106/06/19,-26,-2,3,-25,53850,154,5992,59996,5.04%,5.62%,
106/06/16,-234,0,0,-234,53876,156,5989,60021,5.04%,5.62%,
106/06/15,-54,0,-27,-81,54110,156,5989,60255,5.07%,5.65%,
106/06/14,42,0,0,42,54012,156,6016,60184,5.06%,5.64%,
106/06/13,238,0,-19,219,53970,156,6016,60142,5.05%,5.63%,
106/06/12,96,0,1,97,53732,156,6035,59923,5.03%,5.61%,
106/06/09,52,-2,0,50,53636,156,6034,59826,5.02%,5.60%,
106/06/08,48,0,2,50,53584,158,6034,59776,5.02%,5.60%,
106/06/07,19,-1,25,43,53336,158,6032,59526,4.99%,5.57%,
106/06/06,59,0,0,59,53317,159,6007,59483,4.99%,5.57%,
106/06/05,-19,-2,0,-21,53258,159,6007,59424,4.99%,5.57%,
106/06/03,0,-1,0,-1,53277,161,6007,59445,4.99%,5.57%,
106/06/02,5,-4,1,2,53277,162,6007,59446,4.99%,5.57%,
106/06/01,-16,0,-29,-45,53272,166,6006,59444,4.99%,5.57%,
106/05/31,-310,0,0,-310,53288,166,6035,59489,4.99%,5.57%,
106/05/26,186,-6,0,180,53598,166,6035,59799,5.02%,5.60%,
106/05/25,197,-1,0,196,53412,172,6035,59619,5.00%,5.58%,
106/05/24,276,0,-3,273,53215,173,6035,59423,4.98%,5.56%,
106/05/23,-28,0,0,-28,52939,173,6038,59150,4.96%,5.54%,
106/05/22,38,0,0,38,52967,173,6038,59178,4.96%,5.54%,
106/05/19,-126,0,0,-126,52929,173,6038,59140,4.95%,5.53%,
106/05/18,-19,-1,0,-20,53055,173,6038,59266,4.97%,5.55%,
106/05/17,-44,0,1,-43,53074,174,6038,59286,4.97%,5.55%,
106/05/16,-63,123,0,60,53118,174,6037,59329,4.97%,5.55%,
106/05/15,-124,42,0,-82,53181,51,6037,59269,4.98%,5.55%,
106/05/12,-25,0,0,-25,53305,9,6037,59351,4.99%,5.56%,
106/05/11,-9,0,0,-9,53330,9,6037,59376,4.99%,5.56%,
106/05/10,-13,0,0,-13,53089,9,6037,59135,4.97%,5.54%,
106/05/09,-39,0,0,-39,53252,9,6037,59298,4.99%,5.56%,
106/05/08,43,0,0,43,53241,9,6037,59287,4.98%,5.55%,
106/05/05,9,0,-3,6,53198,9,6037,59244,4.98%,5.55%,
106/05/04,31,0,0,31,53189,9,6040,59238,4.98%,5.55%,
106/05/03,-35,0,0,-35,53158,9,6040,59207,4.98%,5.55%,
106/05/02,13,0,0,13,53193,9,6040,59242,4.98%,5.55%,
106/04/28,-25,0,0,-25,52180,9,6040,58229,4.88%,5.45%,
106/04/27,-60,0,0,-60,52205,9,6040,58254,4.89%,5.46%,
106/04/26,1,0,3,4,52265,9,6040,58314,4.89%,5.46%,
106/04/25,128,0,0,128,52264,9,6037,58310,4.89%,5.46%,
106/04/24,31,0,0,31,52136,9,6037,58182,4.88%,5.45%,
106/04/21,201,0,0,201,52105,9,6037,58151,4.88%,5.45%,
106/04/20,208,0,0,208,51904,9,6037,57950,4.86%,5.43%,
106/04/19,32,0,-4,28,51696,9,6037,57742,4.84%,5.41%,
106/04/18,85,0,0,85,51664,9,6041,57714,4.84%,5.41%,
106/04/17,-89,0,4,-85,51629,9,6041,57679,4.83%,5.40%,
106/04/14,-253,0,0,-253,51718,9,6037,57764,4.84%,5.41%,
106/04/13,133,0,-1,132,51971,9,6037,58017,4.87%,5.44%,
106/04/12,-26,0,-1,-27,51838,9,6038,57885,4.85%,5.42%,
106/04/11,416,0,0,416,51864,9,6039,57912,4.86%,5.43%,
106/04/10,-17,0,0,-17,51448,9,6039,57496,4.82%,5.39%,
106/04/07,-96,0,-2,-98,51465,9,6039,57513,4.82%,5.39%,
106/04/06,195,0,6,201,51561,9,6041,57611,4.83%,5.40%,
106/04/05,-82,0,0,-82,51366,9,6035,57410,4.81%,5.38%,
106/03/31,13,0,0,13,51448,9,6035,57492,4.82%,5.39%,
106/03/30,13,0,0,13,51435,15,6035,57485,4.81%,5.38%,
106/03/29,289,0,0,289,51422,15,6035,57472,4.81%,5.38%,
106/03/28,269,0,0,269,51133,15,6035,57183,4.79%,5.36%,
106/03/27,99,0,1,100,50864,15,6035,56914,4.76%,5.33%,
106/03/24,-27,0,0,-27,50765,15,6034,56814,4.75%,5.32%,
106/03/23,-102,0,0,-102,50792,15,6034,56841,4.75%,5.32%,
106/03/22,25,0,1,26,50894,15,6034,56943,4.76%,5.33%,
106/03/21,-92,-4,0,-96,50869,15,6033,56917,4.76%,5.33%,
106/03/20,-45,-4,0,-49,50961,19,6033,57013,4.77%,5.34%,
106/03/17,352,0,0,352,51016,23,6033,57072,4.78%,5.35%,
106/03/16,236,0,1,237,50664,23,6033,56720,4.74%,5.31%,
106/03/15,-41,0,4,-37,50428,23,6032,56483,4.72%,5.29%,
106/03/14,55,0,0,55,50376,23,6028,56427,4.72%,5.29%,
106/03/13,43,0,0,43,50321,23,6028,56372,4.71%,5.28%,
106/03/10,-283,0,1,-282,50278,23,6028,56329,4.71%,5.28%,
106/03/09,-251,0,2,-249,50561,23,6027,56611,4.73%,5.30%,
106/03/08,-218,0,0,-218,50812,23,6025,56860,4.76%,5.33%,
106/03/07,-35,0,2,-33,51030,23,6025,57078,4.78%,5.35%,
106/03/06,-93,0,0,-93,51065,23,6023,57111,4.78%,5.35%,
106/03/03,-23,0,0,-23,51125,23,6023,57171,4.79%,5.36%,
106/03/02,-54,0,0,-54,51148,23,6023,57194,4.79%,5.36%,
106/03/01,636,0,2,638,51202,23,6023,57248,4.79%,5.36%,
106/02/24,5,0,-7,-2,50566,23,6021,56610,4.73%,5.30%,
106/02/23,153,0,1,154,50561,23,6028,56612,4.73%,5.30%,
106/02/22,268,0,9,277,50408,23,6027,56458,4.72%,5.29%,
106/02/21,113,0,2,115,50140,23,6018,56181,4.69%,5.26%,
106/02/20,19,0,0,19,50027,23,6016,56066,4.68%,5.25%,
106/02/18,0,0,0,0,50008,23,6016,56047,4.68%,5.25%,
106/02/17,168,0,0,168,50008,23,6016,56047,4.68%,5.25%,
106/02/16,48,0,-1,47,49872,23,6016,55911,4.67%,5.24%,
106/02/15,62,0,0,62,49824,23,6017,55864,4.66%,5.23%,
106/02/14,-19,0,3,-16,49762,23,6017,55802,4.66%,5.23%,
106/02/13,183,0,0,183,49781,23,6014,55818,4.66%,5.23%,
106/02/10,271,0,1,272,49598,23,6014,55635,4.64%,5.21%,
106/02/09,112,0,-4,108,49327,23,6013,55363,4.62%,5.19%,
106/02/08,-125,0,-2,-127,49215,23,6017,55255,4.61%,5.18%,
106/02/07,-108,0,0,-108,49340,23,6019,55382,4.62%,5.19%,
106/02/06,-129,0,-1,-130,49448,23,6019,55490,4.63%,5.20%,
106/02/03,180,21,0,201,49567,23,6020,55610,4.64%,5.21%,
106/02/02,-238,0,3,-235,49387,2,6020,55409,4.62%,5.18%,
106/01/24,359,0,-8,351,49625,2,6017,55644,4.65%,5.21%,
106/01/23,-26,-3,0,-29,49266,2,6025,55293,4.61%,5.17%,
106/01/20,30,0,0,30,49292,5,6025,55322,4.61%,5.18%,
106/01/19,37,0,-3,34,49262,5,6025,55292,4.61%,5.18%,
106/01/18,89,0,0,89,49225,5,6028,55258,4.61%,5.18%,
106/01/17,27,0,0,27,49137,5,6028,55170,4.60%,5.17%,
106/01/16,-16,0,-2,-18,49110,5,6028,55143,4.60%,5.17%,
106/01/13,110,0,0,110,49126,5,6030,55161,4.60%,5.17%,
106/01/12,53,0,0,53,49016,5,6030,55051,4.59%,5.16%,
106/01/11,105,0,0,105,48963,5,6030,54998,4.58%,5.15%,
106/01/10,19,0,0,19,48858,5,6030,54893,4.57%,5.14%,
106/01/09,12,0,-2,10,48839,5,6030,54874,4.57%,5.14%,
106/01/06,-13,-8,0,-21,48827,5,6032,54864,4.57%,5.14%,
106/01/05,28,0,0,28,48840,13,6032,54885,4.57%,5.14%,
106/01/04,-7,0,0,-7,48812,13,6032,54857,4.57%,5.14%,
106/01/03,-30,0,0,-30,48819,13,6032,54864,4.57%,5.14%,
105/12/30,25,0,3,28,48849,13,6032,54894,4.57%,5.14%,
105/12/29,-6,0,0,-6,48824,13,6029,54866,4.57%,5.14%,
105/12/28,-11,0,1,-10,48830,13,6029,54872,4.57%,5.14%,
105/12/27,3,0,0,3,48841,13,6028,54882,4.57%,5.14%,
105/12/26,-3,0,0,-3,48838,13,6028,54879,4.57%,5.14%,
105/12/23,-26,0,0,-26,48841,13,6028,54882,4.57%,5.14%,
105/12/22,-33,0,3,-30,48867,13,6028,54908,4.57%,5.14%,
105/12/21,-36,0,15,-21,48900,13,6025,54938,4.58%,5.15%,
105/12/20,20,0,15,35,48936,13,6010,54959,4.58%,5.14%,
105/12/19,-22,0,1,-21,48916,13,5995,54924,4.58%,5.14%,
105/12/16,-158,0,14,-144,48938,13,5994,54945,4.58%,5.14%,
105/12/15,27,0,0,27,49096,13,5980,55089,4.60%,5.16%,
105/12/14,127,0,0,127,49069,13,5980,55062,4.59%,5.15%,
105/12/13,27,0,0,27,48742,13,5980,54735,4.56%,5.12%,
105/12/12,26,0,25,51,48715,13,5980,54708,4.56%,5.12%,
105/12/09,8,0,0,8,48689,13,5955,54657,4.56%,5.12%,
105/12/08,51,0,0,51,48681,13,5955,54649,4.56%,5.12%,
105/12/07,13,0,0,13,48630,13,5955,54598,4.55%,5.11%,
105/12/06,77,0,5,82,48617,13,5955,54585,4.55%,5.11%,
105/12/05,-228,0,-1,-229,48540,13,5950,54503,4.54%,5.10%,
105/12/02,97,0,-9,88,48768,13,5951,54732,4.56%,5.12%,
105/12/01,-46,0,0,-46,48671,13,5960,54644,4.56%,5.12%,
105/11/30,270,0,-7,263,48717,13,5960,54690,4.56%,5.12%,
105/11/29,45,0,1,46,48447,13,5967,54427,4.53%,5.09%,
105/11/28,58,0,5,63,48402,13,5966,54381,4.53%,5.09%,
105/11/25,83,0,0,83,48344,13,5961,54318,4.53%,5.09%,
105/11/24,91,0,0,91,48261,13,5961,54235,4.52%,5.08%,
105/11/23,-25,0,0,-25,48170,13,5961,54144,4.51%,5.07%,
105/11/22,129,0,8,137,48195,13,5961,54169,4.51%,5.07%,
105/11/21,-70,0,0,-70,48066,13,5953,54032,4.50%,5.06%,
105/11/18,373,0,1,374,48136,13,5953,54102,4.51%,5.07%,
105/11/17,-2,0,-2,-4,47763,13,5952,53728,4.47%,5.03%,
105/11/16,15,0,-4,11,47765,13,5954,53732,4.47%,5.03%,
105/11/15,-74,0,0,-74,47750,13,5958,53721,4.47%,5.03%,
105/11/14,-146,0,-6,-152,47824,13,5958,53795,4.48%,5.04%,
105/11/11,-150,0,-2,-152,47970,13,5964,53947,4.49%,5.05%,
105/11/10,66,0,-9,57,48120,13,5966,54099,4.50%,5.06%,
105/11/09,-81,0,-60,-141,48054,13,5975,54042,4.50%,5.06%,
105/11/08,-13,0,0,-13,48135,13,6035,54183,4.51%,5.08%,
105/11/07,-5,0,8,3,48148,13,6035,54196,4.51%,5.08%,
105/11/04,-57,0,0,-57,48153,13,6027,54193,4.51%,5.08%,
105/11/03,-86,0,16,-70,48210,13,6027,54250,4.51%,5.08%,
105/11/02,-91,-1,59,-33,48296,13,6011,54320,4.52%,5.08%,
105/11/01,5,0,6,11,48387,14,5952,54353,4.53%,5.09%,
105/10/31,-17,0,3,-14,48382,14,5946,54342,4.53%,5.09%,
105/10/28,10,0,0,10,48399,14,5943,54356,4.53%,5.09%,
105/10/27,2,0,0,2,48389,14,5943,54346,4.53%,5.09%,
105/10/26,-4,0,0,-4,48387,14,5943,54344,4.53%,5.09%,
105/10/25,-102,0,0,-102,48391,14,5943,54348,4.53%,5.09%,
105/10/24,-17,0,-2,-19,48493,14,5943,54450,4.54%,5.10%,
105/10/21,-41,1,-7,-47,48510,14,5945,54469,4.54%,5.10%,
105/10/20,-25,0,-24,-49,48205,13,5952,54170,4.51%,5.07%,
105/10/19,-7,0,-4,-11,48230,13,5976,54219,4.51%,5.07%,
105/10/18,9,0,-3,6,48237,13,5980,54230,4.52%,5.08%,
105/10/17,29,0,0,29,48228,13,5983,54224,4.51%,5.07%,
105/10/14,-125,0,16,-109,48199,13,5983,54195,4.51%,5.07%,
105/10/13,-4,0,3,-1,48222,13,5967,54202,4.51%,5.07%,
105/10/12,-24,0,1,-23,48226,13,5964,54203,4.51%,5.07%,
105/10/11,49,0,2,51,48250,13,5963,54226,4.52%,5.08%,
105/10/07,-3,0,0,-3,48201,13,5961,54175,4.51%,5.07%,
105/10/06,53,0,0,53,48449,13,5961,54423,4.54%,5.10%,
105/10/05,107,0,0,107,48396,13,5961,54370,4.53%,5.09%,
105/10/04,66,0,-1,65,48289,13,5961,54263,4.52%,5.08%,
105/10/03,-117,0,-2,-119,48223,13,5962,54198,4.51%,5.07%,
105/09/30,-17,-0,0,-17,48340,13,5964,54317,4.52%,5.08%,
105/09/29,63,0,0,63,48357,0,5964,54321,4.53%,5.09%,
105/09/26,44,0,10,54,48294,0,5964,54258,4.52%,5.08%,
105/09/23,72,0,0,72,48250,0,5954,54204,4.52%,5.08%,
105/09/22,76,0,0,76,48178,0,5954,54132,4.51%,5.07%,
105/09/21,246,0,-12,234,48102,0,5954,54056,4.50%,5.06%,
105/09/20,-16,0,-1,-17,47856,0,5966,53822,4.48%,5.04%,
105/09/19,-23,0,2,-21,47872,0,5967,53839,4.48%,5.04%,
105/09/14,63,0,0,63,47895,0,5965,53860,4.48%,5.04%,
105/09/13,-23,0,0,-23,47832,0,5965,53797,4.48%,5.04%,
105/09/12,-72,0,0,-72,47855,0,5965,53820,4.48%,5.04%,
105/09/10,0,0,-6,-6,47927,0,5965,53892,4.49%,5.05%,
105/09/09,-31,0,-5,-36,47927,0,5971,53898,4.49%,5.05%,
105/09/08,52,0,0,52,47958,0,5976,53934,4.49%,5.05%,
105/09/07,52,0,-9,43,47906,0,5976,53882,4.48%,5.04%,
105/09/06,55,0,4,59,47854,0,5985,53839,4.48%,5.04%,
105/09/05,19,0,0,19,47799,0,5981,53780,4.47%,5.03%,
105/09/02,2,0,0,2,47780,0,5981,53761,4.47%,5.03%,
105/09/01,-267,0,0,-267,47778,0,5981,53759,4.47%,5.03%,
105/08/31,104,0,-15,89,48045,0,5981,54026,4.50%,5.06%,
105/08/30,-49,0,0,-49,47941,0,5996,53937,4.49%,5.05%,
105/08/29,-83,0,-3,-86,47990,0,5996,53986,4.49%,5.05%,
105/08/26,-15,0,-7,-22,48306,0,5999,54305,4.52%,5.08%,
105/08/25,20,0,0,20,48321,0,6006,54327,4.52%,5.08%,
105/08/24,-49,0,0,-49,48301,0,6006,54307,4.52%,5.08%,
105/08/23,21,0,0,21,48350,0,6006,54356,4.53%,5.09%,
105/08/22,-56,0,-31,-87,48329,0,6006,54335,4.52%,5.08%,
105/08/19,-69,0,0,-69,48385,0,6037,54422,4.53%,5.10%,
105/08/18,48,0,0,48,48054,0,6037,54091,4.50%,5.07%,
105/08/17,161,0,0,161,48006,0,6037,54043,4.49%,5.06%,
105/08/16,8,0,0,8,47272,0,6037,53309,4.42%,4.99%,
105/08/15,95,0,0,95,47264,0,6037,53301,4.42%,4.99%,
105/08/12,54,0,0,54,47169,0,6037,53206,4.42%,4.99%,
105/08/11,25,0,-159,-134,47115,0,6037,53152,4.41%,4.98%,
105/08/10,39,0,149,188,47090,0,6196,53286,4.41%,4.99%,
105/08/09,21,0,0,21,47051,0,6047,53098,4.40%,4.97%,
105/08/08,106,-13,0,93,47030,0,6047,53077,4.40%,4.97%,
105/08/05,43,0,0,43,46924,4,6047,52975,4.39%,4.96%,
105/08/04,56,-2,-22,32,47454,4,6047,53505,4.44%,5.01%,
105/08/03,-2,0,-5,-7,47793,6,6069,53868,4.47%,5.04%,
105/08/02,-1,0,0,-1,47795,6,6074,53875,4.47%,5.04%,
105/08/01,84,0,1,85,47796,6,6074,53876,4.47%,5.04%,
105/07/29,-6,-6,0,-12,47712,6,6073,53791,4.47%,5.04%,
105/07/28,47,0,4,51,47718,12,6073,53803,4.47%,5.04%,
105/07/27,42,0,0,42,47671,12,6069,53752,4.46%,5.03%,
105/07/26,26,0,0,26,47629,12,6069,53710,4.46%,5.03%,
105/07/25,10,0,2,12,47701,12,6069,53782,4.46%,5.03%,
105/07/22,112,-1,1,112,47691,12,6067,53770,4.46%,5.03%,
105/07/21,252,-3,43,292,47579,13,6066,53658,4.45%,5.02%,
105/07/20,103,0,10,113,47327,16,6023,53366,4.43%,5.00%,
105/07/19,47,-1,10,56,47224,16,6013,53253,4.42%,4.98%,
105/07/18,71,0,0,71,47177,17,6003,53197,4.42%,4.98%,
105/07/15,42,0,0,42,47106,17,6003,53126,4.41%,4.97%,
105/07/14,41,-1,-1,39,47299,17,6003,53319,4.43%,4.99%,
105/07/13,116,0,0,116,47258,18,6004,53280,4.42%,4.98%,
105/07/12,36,0,0,36,47142,18,6004,53164,4.41%,4.97%,
105/07/11,-12,0,0,-12,47106,18,6004,53128,4.41%,4.97%,
105/07/07,-13,0,-1,-14,47118,18,6004,53140,4.41%,4.97%,
105/07/06,14,0,-3,11,47131,18,6005,53154,4.41%,4.97%,
105/07/05,13,0,0,13,47117,18,6008,53143,4.41%,4.97%,
105/07/04,38,0,0,38,47104,18,6008,53130,4.41%,4.97%,
105/07/01,22,0,0,22,47066,18,6008,53092,4.41%,4.97%,
105/06/30,33,0,-12,21,47044,18,6008,53070,4.40%,4.96%,
105/06/29,-13,0,0,-13,47011,21,6020,53052,4.40%,4.97%,
105/06/28,-16,3,0,-13,47024,21,6020,53065,4.40%,4.97%,
105/06/27,3,-44,-1,-42,47040,18,6020,53078,4.40%,4.97%,
105/06/24,-71,-44,-10,-125,47037,62,6021,53120,4.40%,4.97%,
105/06/23,26,0,0,26,47108,106,6031,53245,4.41%,4.99%,
105/06/22,18,0,0,18,47082,106,6031,53219,4.41%,4.99%,
105/06/21,8,0,0,8,47064,106,6031,53201,4.41%,4.99%,
105/06/20,13,0,20,33,47056,106,6031,53193,4.40%,4.98%,
105/06/17,-4,0,0,-4,47043,106,6011,53160,4.40%,4.97%,
105/06/16,-93,0,0,-93,47047,106,6011,53164,4.40%,4.97%,
105/06/15,-23,0,0,-23,47140,106,6011,53257,4.41%,4.98%,
105/06/14,-1,0,6,5,47163,106,6011,53280,4.41%,4.98%,
105/06/13,-127,0,0,-127,47164,106,6005,53275,4.41%,4.98%,
105/06/08,-227,0,-1,-228,47291,106,6005,53402,4.43%,5.00%,
105/06/07,19,0,1,20,47518,106,6006,53630,4.45%,5.02%,
105/06/06,-13,0,0,-13,47499,106,6005,53610,4.45%,5.02%,
105/06/04,0,0,0,0,47512,106,6005,53623,4.45%,5.02%,
105/06/03,28,0,0,28,47512,106,6005,53623,4.45%,5.02%,
105/06/02,27,0,0,27,47498,106,6005,53609,4.45%,5.02%,
105/06/01,43,0,0,43,47471,106,6005,53582,4.44%,5.01%,
105/05/31,81,0,0,81,47344,106,6005,53455,4.43%,5.00%,
105/05/30,40,0,0,40,47263,106,6005,53374,4.42%,4.99%,
105/05/27,62,0,0,62,47223,106,6005,53334,4.42%,4.99%,
105/05/26,5,2,0,7,47161,106,6005,53272,4.41%,4.98%,
105/05/25,41,0,0,41,47156,104,6005,53265,4.41%,4.98%,
105/05/24,32,0,0,32,47115,104,6005,53224,4.41%,4.98%,
105/05/23,175,0,1,176,47083,104,6005,53192,4.41%,4.98%,
105/05/20,33,0,0,33,46958,104,6004,53066,4.40%,4.97%,
105/05/19,40,0,0,40,46925,104,6004,53033,4.39%,4.96%,
105/05/18,47,0,0,47,46885,104,6004,52993,4.39%,4.96%,
105/05/17,13,0,0,13,46838,104,6004,52946,4.38%,4.95%,
105/05/16,-27,0,0,-27,46825,104,6004,52933,4.38%,4.95%,
105/05/13,-104,0,-6,-110,46852,104,6004,52960,4.39%,4.96%,
105/05/12,-23,0,0,-23,46956,104,6010,53070,4.40%,4.97%,
105/05/11,-1,0,0,-1,46829,104,6010,52943,4.38%,4.95%,
105/05/10,-12,2,0,-10,46830,104,6010,52944,4.38%,4.95%,
105/05/09,-55,0,-4,-59,46744,102,6010,52856,4.38%,4.95%,
105/05/06,-106,0,0,-106,46799,102,6014,52915,4.38%,4.95%,
105/05/05,-130,0,0,-130,46905,102,6014,53021,4.39%,4.96%,
105/05/04,-60,0,0,-60,47035,102,6014,53151,4.40%,4.97%,
105/05/03,-27,0,0,-27,47095,102,6014,53211,4.41%,4.98%,
105/04/29,-36,0,-3,-39,47122,102,6014,53238,4.41%,4.98%,
105/04/28,-83,0,-8,-91,47158,102,6017,53277,4.41%,4.98%,
105/04/27,-26,0,0,-26,47241,102,6025,53368,4.42%,4.99%,
105/04/26,-73,0,0,-73,47267,102,6025,53394,4.42%,4.99%,
105/04/25,67,0,0,67,47326,102,6025,53453,4.43%,5.00%,
105/04/22,-21,0,5,-16,47259,102,6025,53386,4.42%,4.99%,
105/04/21,23,0,-6,17,47280,102,6020,53402,4.43%,5.00%,
105/04/20,-59,0,0,-59,47257,102,6026,53385,4.42%,4.99%,
105/04/19,-55,0,-9,-64,47316,102,6026,53444,4.43%,5.00%,
105/04/18,-2,0,-2,-4,47371,102,6035,53508,4.43%,5.01%,
105/04/15,-16,85,0,69,47373,102,6037,53512,4.43%,5.01%,
105/04/14,12,0,0,12,47389,17,6037,53443,4.44%,5.01%,
105/04/13,67,0,0,67,47377,17,6037,53431,4.43%,5.00%,
105/04/12,-277,0,0,-277,47310,17,6037,53364,4.43%,5.00%,
105/04/11,-72,0,0,-72,47587,17,6037,53641,4.45%,5.02%,
105/04/08,63,0,0,63,47659,17,6037,53713,4.46%,5.03%,
105/04/07,-61,0,-2,-63,47596,17,6037,53650,4.46%,5.03%,
105/04/06,9,0,-5,4,47657,17,6039,53713,4.46%,5.03%,
105/04/01,-27,0,2,-25,47648,17,6044,53709,4.46%,5.03%,
105/03/31,22,0,4,26,47675,17,6042,53734,4.46%,5.03%,
105/03/30,-7,0,3,-4,47653,19,6038,53710,4.46%,5.03%,
105/03/29,-63,0,0,-63,47660,19,6035,53714,4.46%,5.03%,
105/03/28,15,0,-2,13,47723,19,6035,53777,4.47%,5.04%,
105/03/25,-118,0,-23,-141,47708,19,6037,53764,4.47%,5.04%,
105/03/24,-31,0,0,-31,47826,19,6060,53905,4.48%,5.05%,
105/03/23,-3,0,0,-3,47857,19,6060,53936,4.48%,5.05%,
105/03/22,-15,0,-7,-22,47870,19,6060,53949,4.48%,5.05%,
105/03/21,-3,0,0,-3,47885,19,6067,53971,4.48%,5.05%,
105/03/18,-9,0,0,-9,47888,19,6067,53974,4.48%,5.05%,
105/03/17,34,0,0,34,47897,19,6067,53983,4.48%,5.05%,
105/03/16,-11,0,10,-1,47941,19,6067,54027,4.49%,5.06%,
105/03/15,-18,0,-1,-19,47951,19,6057,54027,4.49%,5.06%,
105/03/14,39,0,3,42,47956,19,6058,54033,4.49%,5.06%,
105/03/11,48,0,-3,45,47917,19,6055,53991,4.49%,5.06%,
105/03/10,6,0,4,10,47869,19,6058,53946,4.48%,5.05%,
105/03/09,-4,0,0,-4,47863,19,6054,53936,4.48%,5.05%,
105/03/08,-133,5,-36,-164,47857,19,6054,53930,4.48%,5.05%,
105/03/07,-42,0,0,-42,47992,14,6090,54096,4.49%,5.06%,
105/03/04,10,0,0,10,48038,14,6090,54142,4.50%,5.07%,
105/03/03,3,0,0,3,48028,14,6090,54132,4.50%,5.07%,
105/03/02,27,-2,0,25,48025,14,6090,54129,4.50%,5.07%,
105/03/01,-7,0,0,-7,47998,16,6090,54104,4.49%,5.06%,
105/02/26,34,0,0,34,47990,16,6090,54096,4.49%,5.06%,
105/02/25,50,0,0,50,47956,16,6090,54062,4.49%,5.06%,
105/02/24,60,0,0,60,47906,16,6090,54012,4.48%,5.05%,
105/02/23,71,0,-5,66,47846,16,6090,53952,4.48%,5.05%,
105/02/22,71,0,-3,68,47775,16,6095,53886,4.47%,5.04%,
105/02/19,17,0,0,17,47704,16,6098,53818,4.47%,5.04%,
105/02/18,37,0,-1,36,48144,16,6098,54258,4.51%,5.08%,
105/02/17,92,0,0,92,48050,16,6099,54165,4.50%,5.07%,
105/02/16,51,0,7,58,47972,16,6099,54087,4.49%,5.06%,
105/02/15,-27,-1,1,-27,47921,16,6092,54029,4.49%,5.06%,
105/02/03,71,0,0,71,47934,17,6091,54042,4.49%,5.06%,
105/02/02,344,0,0,344,47945,17,6091,54053,4.49%,5.06%,
105/02/01,313,0,-4,309,47762,17,6091,53870,4.47%,5.04%,
105/01/30,0,1,6,7,47026,17,6095,53138,4.40%,4.97%,
105/01/29,278,0,24,302,47026,16,6089,53131,4.40%,4.97%,
105/01/28,29,0,5,34,46789,16,6065,52870,4.38%,4.95%,
105/01/27,9,0,0,9,46525,16,6060,52601,4.35%,4.92%,
105/01/26,5,0,0,5,46516,16,6060,52592,4.35%,4.92%,
105/01/25,32,0,-12,20,46511,16,6060,52587,4.35%,4.92%,
105/01/22,-55,0,16,-39,46479,16,6072,52567,4.35%,4.92%,
105/01/21,9,0,6,15,46534,16,6056,52606,4.36%,4.93%,
105/01/20,46,-1,-13,32,46525,16,6050,52591,4.35%,4.92%,
105/01/19,81,0,4,85,46479,17,6063,52559,4.35%,4.92%,
105/01/18,137,0,10,147,46398,17,6059,52474,4.34%,4.91%,
105/01/15,-150,-1,0,-151,46261,17,6049,52327,4.33%,4.90%,
105/01/14,-22,0,2,-20,46411,18,6049,52478,4.34%,4.91%,
105/01/13,-125,0,0,-125,46433,18,6047,52498,4.35%,4.92%,
105/01/12,-15,0,0,-15,46557,18,6047,52622,4.36%,4.93%,
105/01/11,-37,0,0,-37,46548,18,6047,52613,4.36%,4.93%,
105/01/08,48,0,13,61,46585,18,6047,52650,4.36%,4.93%,
105/01/07,-61,0,2,-59,46517,18,6034,52569,4.35%,4.92%,
105/01/06,-7,0,0,-7,46578,18,6032,52628,4.36%,4.93%,
105/01/05,29,0,0,29,46585,18,6032,52635,4.36%,4.93%,
105/01/04,-32,0,-3,-35,46556,18,6032,52606,4.36%,4.93%,
104/12/31,17,0,3,20,46588,18,6035,52641,4.36%,4.93%,
104/12/30,63,0,-10,53,46571,0,6032,52603,4.36%,4.93%,
104/12/29,61,-61,0,0,46508,0,6042,52550,4.35%,4.92%,
104/12/28,109,-55,0,54,46447,0,6042,52489,4.35%,4.92%,
104/12/25,138,0,0,138,46324,42,6042,52408,4.34%,4.91%,
104/12/24,174,0,0,174,46186,42,6042,52270,4.32%,4.89%,
104/12/23,99,0,0,99,46012,42,6042,52096,4.31%,4.88%,
104/12/22,-81,0,0,-81,45913,42,6042,51997,4.30%,4.87%,
104/12/21,189,0,-2,187,45994,42,6042,52078,4.31%,4.88%,
104/12/18,-127,0,3,-124,45805,42,6044,51891,4.29%,4.86%,
104/12/17,40,0,0,40,45967,42,6041,52050,4.30%,4.87%,
104/12/16,88,0,-14,74,45927,42,6041,52010,4.30%,4.87%,
104/12/15,-33,0,5,-28,45839,42,6055,51936,4.29%,4.86%,
104/12/14,73,-0,0,73,45872,42,6050,51964,4.29%,4.86%,
104/12/11,17,0,0,17,45799,42,6050,51891,4.29%,4.86%,
104/12/10,-168,0,0,-168,45782,42,6050,51874,4.29%,4.86%,
104/12/09,-86,0,0,-86,45950,42,6050,52042,4.30%,4.87%,
104/12/08,-20,0,-10,-30,46036,42,6050,52128,4.31%,4.88%,
104/12/07,105,0,-1,104,46046,42,6060,52148,4.31%,4.88%,
104/12/04,97,0,0,97,45941,42,6061,52044,4.30%,4.87%,
104/12/03,-27,0,-1,-28,45846,42,6061,51949,4.29%,4.86%,
104/12/02,-36,0,0,-36,45873,42,6062,51977,4.29%,4.86%,
104/12/01,-1,0,0,-1,45909,42,6062,52013,4.30%,4.87%,
104/11/30,-162,0,0,-162,45910,42,6062,52014,4.30%,4.87%,
104/11/27,25,0,0,25,46072,42,6062,52176,4.31%,4.88%,
104/11/26,-22,0,0,-22,46047,42,6062,52151,4.31%,4.88%,
104/11/25,-89,0,0,-89,45969,42,6062,52073,4.30%,4.87%,
104/11/24,-57,0,0,-57,46040,42,6062,52144,4.31%,4.88%,
104/11/23,-22,0,0,-22,46087,42,6062,52191,4.31%,4.88%,
104/11/20,-12,0,0,-12,46109,42,6062,52213,4.32%,4.89%,
104/11/19,-9,0,0,-9,46121,42,6062,52225,4.32%,4.89%,
104/11/18,-250,0,0,-250,46130,42,6062,52234,4.32%,4.89%,
104/11/17,-4,0,-6,-10,46380,42,6062,52484,4.34%,4.91%,
104/11/16,-138,0,-4,-142,46384,42,6068,52494,4.34%,4.91%,
104/11/13,-163,0,-1,-164,46532,42,6072,52646,4.36%,4.93%,
104/11/12,-111,0,0,-111,46695,42,6073,52810,4.37%,4.94%,
104/11/11,-228,0,0,-228,46806,42,6073,52921,4.38%,4.95%,
104/11/10,-87,0,0,-87,47034,42,6073,53149,4.40%,4.97%,
104/11/09,-89,0,0,-89,47121,42,6073,53236,4.41%,4.98%,
104/11/06,15,0,-3,12,46983,42,6073,53098,4.40%,4.97%,
104/11/05,118,0,0,118,46968,42,6076,53086,4.40%,4.97%,
104/11/04,272,13,4,289,46850,42,6076,52968,4.39%,4.96%,
104/11/03,62,0,2,64,46578,29,6072,52679,4.36%,4.93%,
104/11/02,-108,0,0,-108,46516,29,6070,52615,4.35%,4.92%,
104/10/30,-197,0,1,-196,46624,29,6070,52723,4.36%,4.93%,
104/10/29,-316,0,0,-316,46831,29,6069,52929,4.38%,4.95%,
104/10/28,-165,0,0,-165,47147,29,6069,53245,4.41%,4.98%,
104/10/27,-107,0,0,-107,47312,29,6069,53410,4.43%,5.00%,
104/10/26,-261,0,0,-261,47419,29,6069,53517,4.44%,5.01%,
104/10/23,-636,0,0,-636,47680,29,6069,53778,4.46%,5.03%,
104/10/22,-509,0,5,-504,48316,29,6069,54414,4.52%,5.09%,
104/10/21,-180,0,-1,-181,48825,29,6064,54918,4.57%,5.14%,
104/10/20,62,0,1,63,49005,29,6065,55099,4.59%,5.16%,
104/10/19,65,0,1,66,48943,29,6064,55036,4.58%,5.15%,
104/10/16,190,0,-2,188,48878,29,6063,54970,4.58%,5.15%,
104/10/15,115,0,0,115,48678,29,6065,54772,4.56%,5.13%,
104/10/14,27,0,0,27,48163,29,6065,54257,4.51%,5.08%,
104/10/13,70,0,0,70,48136,29,6065,54230,4.51%,5.08%,
104/10/12,121,0,1,122,48066,29,6065,54160,4.50%,5.07%,
104/10/08,3,0,0,3,47945,29,6064,54038,4.49%,5.06%,
104/10/07,69,0,0,69,47942,29,6064,54035,4.49%,5.06%,
104/10/06,22,0,0,22,47873,29,6064,53966,4.48%,5.05%,
104/10/05,106,0,7,113,47851,29,6064,53944,4.48%,5.05%,
104/10/02,81,11,-1,91,47745,29,6057,53831,4.47%,5.04%,
104/10/01,5,0,0,5,47664,18,6058,53740,4.46%,5.03%,
104/09/30,-24,0,0,-24,47659,18,6058,53735,4.46%,5.03%,
104/09/25,-39,0,0,-39,47683,42,6058,53783,4.46%,5.03%,
104/09/24,-145,0,0,-145,47722,42,6058,53822,4.47%,5.04%,
104/09/23,-81,0,0,-81,47867,42,6058,53967,4.48%,5.05%,
104/09/22,-7,-0,0,-7,47948,42,6058,54048,4.49%,5.06%,
104/09/21,-148,8,9,-131,47955,43,6058,54056,4.49%,5.06%,
104/09/18,-729,0,2,-727,48103,35,6049,54187,4.50%,5.07%,
104/09/17,-162,0,8,-154,48832,35,6047,54914,4.57%,5.14%,
104/09/16,28,0,1,29,48994,35,6039,55068,4.59%,5.16%,
104/09/15,-41,0,0,-41,48966,35,6038,55039,4.58%,5.15%,
104/09/14,-27,0,-14,-41,49007,35,6038,55080,4.59%,5.16%,
104/09/11,-54,0,0,-54,49034,35,6052,55121,4.59%,5.16%,
104/09/10,70,0,1,71,49088,35,6052,55175,4.59%,5.16%,
104/09/09,221,0,15,236,49018,35,6051,55104,4.59%,5.16%,
104/09/08,37,0,-1,36,48787,35,6036,54858,4.57%,5.14%,
104/09/07,42,0,0,42,48750,35,6037,54822,4.56%,5.13%,
104/09/04,-19,0,-1,-20,48708,35,6037,54780,4.56%,5.13%,
104/09/03,30,0,-1,29,48727,35,6038,54800,4.56%,5.13%,
104/09/02,53,0,0,53,48697,35,6039,54771,4.56%,5.13%,
104/09/01,12,-14,-13,-15,48644,35,6039,54718,4.55%,5.12%,
104/08/31,87,-8,0,79,48632,49,6052,54733,4.55%,5.12%,
104/08/28,10,1,-22,-11,48545,57,6052,54654,4.54%,5.11%,
104/08/27,-26,0,-29,-55,48535,56,6074,54665,4.54%,5.11%,
104/08/26,33,0,-5,28,48561,56,6103,54720,4.55%,5.13%,
104/08/25,44,4,3,51,48528,56,6108,54692,4.54%,5.12%,
104/08/24,-605,0,-2,-607,48484,52,6105,54641,4.54%,5.12%,
104/08/21,10,0,-1,9,49089,52,6107,55248,4.60%,5.18%,
104/08/20,36,0,-2,34,49079,52,6108,55239,4.59%,5.17%,
104/08/19,-308,0,-7,-315,49043,52,6110,55205,4.59%,5.17%,
104/08/18,-87,0,-31,-118,49351,52,6117,55520,4.62%,5.20%,
104/08/17,-75,0,-12,-87,49277,52,6148,55477,4.61%,5.19%,
104/08/14,-5,0,-2,-7,49352,52,6160,55564,4.62%,5.20%,
104/08/13,29,0,1,30,49357,52,6162,55571,4.62%,5.20%,
104/08/12,11,0,42,53,49309,52,6161,55522,4.62%,5.20%,
104/08/11,-37,0,-58,-95,49298,52,6119,55469,4.61%,5.19%,
104/08/10,118,0,-8,110,49335,52,6177,55564,4.62%,5.20%,
104/08/07,-23,0,-6,-29,49217,52,6185,55454,4.61%,5.19%,
104/08/06,-53,0,-2,-55,49240,52,6191,55483,4.61%,5.20%,
104/08/05,228,0,20,248,49293,52,6193,55538,4.61%,5.20%,
104/08/04,159,0,35,194,49065,52,6173,55290,4.59%,5.17%,
104/08/03,17,0,-18,-1,48906,52,6138,55096,4.58%,5.16%,
104/07/31,-23,0,-29,-52,48889,52,6156,55097,4.58%,5.16%,
104/07/30,118,0,-2,116,48912,52,6185,55149,4.58%,5.16%,
104/07/29,131,0,-1,130,48794,52,6187,55033,4.57%,5.15%,
104/07/28,152,11,33,196,48663,52,6188,54903,4.56%,5.14%,
104/07/27,-15,0,42,27,48511,41,6155,54707,4.54%,5.12%,
104/07/24,-62,3,3,-56,48526,41,6113,54680,4.54%,5.12%,
104/07/23,-9,0,19,10,48588,38,6110,54736,4.55%,5.13%,
104/07/22,-139,0,20,-119,48597,38,6091,54726,4.55%,5.12%,
104/07/21,-26,1,0,-25,48736,38,6071,54845,4.56%,5.13%,
104/07/20,-24,0,0,-24,48762,37,6071,54870,4.56%,5.13%,
104/07/17,83,13,0,96,48786,37,6071,54894,4.57%,5.14%,
104/07/16,301,0,0,301,48703,24,6071,54798,4.56%,5.13%,
104/07/15,-140,7,0,-133,48402,24,6071,54497,4.53%,5.10%,
104/07/14,19,0,-16,3,48712,17,6071,54800,4.56%,5.13%,
104/07/13,105,0,-8,97,49063,17,6087,55167,4.59%,5.16%,
104/07/09,-73,0,9,-64,48958,17,6095,55070,4.58%,5.15%,
104/07/08,71,0,14,85,49069,17,6086,55172,4.59%,5.16%,
104/07/07,350,0,0,350,48998,17,6072,55087,4.59%,5.16%,
104/07/06,-78,0,0,-78,48648,17,6072,54737,4.55%,5.12%,
104/07/03,-304,0,0,-304,48726,17,6072,54815,4.56%,5.13%,
104/07/02,-66,0,0,-66,49030,17,6072,55119,4.59%,5.16%,
104/07/01,81,0,0,81,49096,17,6072,55185,4.60%,5.17%,
104/06/30,-125,0,0,-125,49015,17,6072,55104,4.59%,5.16%,
104/06/29,-105,0,0,-105,49140,69,6072,55281,4.60%,5.18%,
104/06/26,-14,0,0,-14,49245,69,6072,55386,4.61%,5.19%,
104/06/25,89,0,18,107,49259,69,6072,55400,4.61%,5.19%,
104/06/24,-126,0,0,-126,49170,69,6054,55293,4.60%,5.17%,
104/06/23,-11,0,13,2,49286,69,6054,55409,4.61%,5.18%,
104/06/22,-173,3,0,-170,49297,69,6041,55407,4.61%,5.18%,
104/06/18,-3,0,0,-3,49641,66,6041,55748,4.65%,5.22%,
104/06/17,-308,0,-4,-312,49644,66,6041,55751,4.65%,5.22%,
104/06/16,-211,0,0,-211,49952,66,6045,56063,4.68%,5.25%,
104/06/15,24,0,0,24,50163,66,6045,56274,4.70%,5.27%,
104/06/12,16,0,0,16,50139,66,6045,56250,4.69%,5.26%,
104/06/11,-106,0,2,-104,50123,66,6045,56234,4.69%,5.26%,
104/06/10,-18,0,9,-9,50229,66,6043,56338,4.70%,5.27%,
104/06/09,-57,0,-1,-58,50162,66,6034,56262,4.70%,5.27%,
104/06/08,-33,0,0,-33,50219,66,6035,56320,4.70%,5.27%,
104/06/05,-380,-1,0,-381,50252,66,6035,56353,4.70%,5.27%,
104/06/04,-159,3,-1,-157,50632,67,6035,56734,4.74%,5.31%,
104/06/03,-136,0,-4,-140,50791,64,6036,56891,4.75%,5.32%,
104/06/02,-23,0,0,-23,51014,64,6040,57118,4.78%,5.35%,
104/06/01,-59,0,0,-59,51037,64,6040,57141,4.78%,5.35%,
104/05/29,-4,0,0,-4,51096,64,6040,57200,4.78%,5.35%,
104/05/28,-48,3,0,-45,51100,64,6040,57204,4.78%,5.35%,
104/05/27,-75,0,0,-75,51148,61,6040,57249,4.79%,5.36%,
104/05/26,-88,0,0,-88,51223,61,6040,57324,4.80%,5.37%,
104/05/25,-410,0,-15,-425,51311,61,6040,57412,4.80%,5.37%,
104/05/22,-150,0,-9,-159,51697,61,6055,57813,4.84%,5.41%,
104/05/21,-216,0,-40,-256,51847,61,6064,57972,4.85%,5.42%,
104/05/20,-90,0,-12,-102,52063,61,6104,58228,4.87%,5.45%,
104/05/19,-83,0,-9,-92,52153,61,6116,58330,4.88%,5.46%,
104/05/18,-111,0,0,-111,52236,61,6125,58422,4.89%,5.47%,
104/05/15,-83,0,-5,-88,52354,61,6125,58540,4.90%,5.48%,
104/05/14,-25,1,-31,-55,52437,61,6130,58628,4.91%,5.49%,
104/05/13,-10,0,0,-10,52462,60,6161,58683,4.91%,5.49%,
104/05/12,128,0,7,135,52472,60,6161,58693,4.91%,5.49%,
104/05/11,153,0,9,162,52274,60,6154,58488,4.89%,5.47%,
104/05/08,173,0,0,173,52099,60,6145,58304,4.88%,5.46%,
104/05/07,144,0,0,144,51938,60,6145,58143,4.86%,5.44%,
104/05/06,226,0,0,226,51794,60,6145,57999,4.85%,5.43%,
104/05/05,129,0,1,130,51568,60,6145,57773,4.83%,5.41%,
104/05/04,6,0,0,6,51439,60,6144,57643,4.82%,5.40%,
104/04/30,443,0,3,446,51433,60,6144,57637,4.81%,5.39%,
104/04/29,319,-1,40,358,50990,60,6141,57191,4.77%,5.35%,
104/04/28,287,-1,6,292,50671,61,6101,56833,4.74%,5.32%,
104/04/27,279,0,11,290,50384,62,6095,56541,4.72%,5.30%,
104/04/24,588,-1,26,613,50105,62,6084,56251,4.69%,5.27%,
104/04/23,397,0,3,400,49517,63,6058,55638,4.64%,5.21%,
104/04/22,-42,0,2,-40,49110,63,6055,55228,4.60%,5.17%,
104/04/21,14,0,1,15,49142,63,6053,55258,4.60%,5.17%,
104/04/20,44,-3,11,52,49118,63,6052,55233,4.60%,5.17%,
104/04/17,101,0,0,101,49074,66,6041,55181,4.59%,5.16%,
104/04/16,-107,0,-67,-174,48923,66,6041,55030,4.58%,5.15%,
104/04/15,-255,49,-3,-209,48980,66,6108,55154,4.58%,5.16%,
104/04/14,0,0,0,0,49359,17,6111,55487,4.62%,5.19%,
104/04/13,66,0,0,66,49359,17,6111,55487,4.62%,5.19%,
104/04/10,77,0,0,77,49293,17,6111,55421,4.61%,5.18%,
104/04/09,160,0,0,160,49216,17,6111,55344,4.61%,5.18%,
104/04/08,88,0,-7,81,49209,17,6111,55337,4.61%,5.18%,
104/04/07,316,0,0,316,49349,17,6118,55484,4.62%,5.19%,
104/04/02,230,0,0,230,49033,17,6118,55168,4.59%,5.16%,
104/04/01,15,0,-2,13,48813,17,6118,54948,4.57%,5.14%,
104/03/31,155,0,0,155,48798,17,6120,54935,4.57%,5.15%,
104/03/30,72,0,7,79,48647,21,6120,54788,4.55%,5.13%,
104/03/27,227,0,4,231,48606,21,6113,54740,4.55%,5.12%,
104/03/26,97,0,16,113,48431,21,6109,54561,4.53%,5.10%,
104/03/25,41,0,10,51,48360,21,6093,54474,4.53%,5.10%,
104/03/24,22,0,0,22,48319,21,6083,54423,4.52%,5.09%,
104/03/23,172,0,0,172,48297,21,6083,54401,4.52%,5.09%,
104/03/20,-370,0,4,-366,48125,21,6083,54229,4.50%,5.07%,
104/03/19,117,0,2,119,48495,21,6079,54595,4.54%,5.11%,
104/03/18,54,0,-14,40,48378,21,6077,54476,4.53%,5.10%,
104/03/17,54,0,-0,54,48461,21,6091,54573,4.54%,5.11%,
104/03/16,43,0,29,72,48407,21,6091,54519,4.53%,5.10%,
104/03/13,39,0,0,39,48364,21,6062,54447,4.53%,5.10%,
104/03/12,-1,0,0,-1,48325,21,6062,54408,4.52%,5.09%,
104/03/11,-30,0,-3,-33,48326,21,6062,54409,4.52%,5.09%,
104/03/10,-24,0,-6,-30,48346,21,6065,54432,4.53%,5.10%,
104/03/09,13,0,0,13,48359,21,6071,54451,4.53%,5.10%,
104/03/06,6,0,14,20,48346,21,6071,54438,4.53%,5.10%,
104/03/05,8,0,-1,7,48358,21,6057,54436,4.53%,5.10%,
104/03/04,-17,6,0,-11,48350,21,6058,54429,4.53%,5.10%,
104/03/03,-46,0,0,-46,48327,15,6058,54400,4.52%,5.09%,
104/03/02,60,0,0,60,48393,15,6058,54466,4.53%,5.10%,
104/02/26,81,0,1,82,48413,15,6058,54486,4.53%,5.10%,
104/02/25,-42,0,3,-39,48298,15,6057,54370,4.52%,5.09%,
104/02/24,0,0,0,0,48223,15,6054,54292,4.51%,5.08%,
104/02/13,-18,-1,-18,-37,48223,15,6054,54292,4.51%,5.08%,
104/02/12,41,0,1,42,48241,16,6072,54329,4.52%,5.09%,
104/02/11,-187,0,-19,-206,48681,16,6071,54768,4.56%,5.13%,
104/02/10,-458,0,13,-445,48836,16,6090,54942,4.57%,5.14%,
104/02/09,-70,0,0,-70,49419,16,6077,55512,4.63%,5.20%,
104/02/06,-103,0,10,-93,49475,16,6077,55568,4.63%,5.20%,
104/02/05,-36,0,-0,-36,49571,16,6067,55654,4.64%,5.21%,
104/02/04,-72,0,-0,-72,49592,16,6067,55675,4.64%,5.21%,
104/02/03,-32,0,0,-32,49233,16,6067,55316,4.61%,5.18%,
104/02/02,4,0,0,4,49522,16,6067,55605,4.64%,5.21%,
104/01/30,-105,0,0,-105,49518,16,6067,55601,4.64%,5.21%,
104/01/29,145,0,7,152,49623,16,6067,55706,4.65%,5.22%,
104/01/28,189,0,20,209,49428,16,6060,55504,4.63%,5.20%,
104/01/27,-43,0,-100,-143,49235,16,6040,55291,4.61%,5.18%,
104/01/26,-13,0,-50,-63,49318,16,6140,55474,4.62%,5.20%,
104/01/23,-18,0,-30,-48,49331,16,6190,55537,4.62%,5.20%,
104/01/22,277,-1,3,279,49328,16,6220,55564,4.62%,5.20%,
104/01/21,3,0,-0,3,49051,17,6217,55285,4.59%,5.17%,
104/01/20,89,0,0,89,48215,17,6217,54449,4.51%,5.09%,
104/01/19,-12,0,-31,-43,48368,17,6217,54602,4.53%,5.11%,
104/01/16,-293,0,-43,-336,48374,17,6248,54639,4.53%,5.12%,
104/01/15,-159,0,-4,-163,48467,17,6291,54775,4.54%,5.13%,
104/01/14,-103,0,64,-39,48616,17,6295,54928,4.55%,5.14%,
104/01/13,-343,0,154,-189,48719,17,6231,54967,4.56%,5.15%,
104/01/12,-422,0,4,-418,49052,17,6077,55146,4.59%,5.16%,
104/01/09,13,0,6,19,49334,17,6073,55424,4.62%,5.19%,
104/01/08,3,0,0,3,49108,17,6067,55192,4.60%,5.17%,
104/01/07,-239,-1,-50,-290,49094,17,6067,55178,4.60%,5.17%,
104/01/06,-126,0,-1,-127,49333,18,6117,55468,4.62%,5.19%,
104/01/05,-125,0,-166,-291,49459,18,6118,55595,4.63%,5.20%,
