日期,外資買賣超,投信買賣超,自營商買賣超,單日合計買賣超,外資估計持股,投信估計持股,自營商估計持股,單日合計估計持股,外資持股比重,三大法人持股比重,
107/03/31,150,0,-25,125,10912,200,376,11488,13.63%,14.35%,
107/03/30,-3,0,-7,-10,10762,200,401,11363,13.45%,14.20%,
107/03/29,15,0,-7,8,10765,200,408,11373,13.45%,14.21%,
107/03/28,48,0,-7,41,10740,200,415,11355,13.42%,14.19%,
107/03/27,-72,0,-61,-133,10692,200,422,11314,13.36%,14.14%,
107/03/26,216,0,9,225,10754,200,483,11437,13.44%,14.29%,
107/03/23,61,0,-2,59,10528,200,474,11202,13.15%,13.99%,
107/03/22,5,50,-87,-32,10457,200,476,11133,13.07%,13.91%,
107/03/21,-134,75,-17,-76,10442,150,563,11155,13.05%,13.94%,
107/03/20,500,0,-60,440,10556,75,580,11211,13.19%,14.01%,
107/03/19,-65,0,12,-53,10066,75,640,10781,12.58%,13.47%,
107/03/16,666,75,49,790,10111,75,628,10814,12.63%,13.51%,
107/03/15,1784,0,0,1784,9445,0,579,10024,11.80%,12.52%,
107/03/14,33,0,4,37,7661,0,579,8240,9.57%,10.29%,
107/03/13,59,0,0,59,7628,0,575,8203,9.53%,10.25%,
107/03/12,7,0,0,7,7569,0,575,8144,9.46%,10.18%,
107/03/09,25,0,0,25,7562,0,575,8137,9.45%,10.17%,
107/03/08,10,0,6,16,7537,0,575,8112,9.42%,10.14%,
107/03/07,49,0,13,62,7527,0,569,8096,9.40%,10.11%,
107/03/06,13,0,8,21,7478,0,556,8034,9.34%,10.03%,
107/03/05,5,0,-17,-12,7465,0,548,8013,9.33%,10.01%,
107/03/02,2,0,0,2,7460,0,565,8025,9.32%,10.03%,
107/03/01,1,0,0,1,7457,0,565,8022,9.32%,10.03%,
107/02/27,-1,0,0,-1,7456,0,565,8021,9.31%,10.02%,
107/02/26,-5,0,0,-5,7457,0,565,8022,9.32%,10.03%,
107/02/23,-2,0,10,8,7462,0,565,8027,9.32%,10.03%,
107/02/22,25,0,36,61,7464,0,555,8019,9.32%,10.01%,
107/02/21,4,0,0,4,7439,0,519,7958,9.29%,9.94%,
107/02/12,-26,0,0,-26,7435,0,519,7954,9.29%,9.94%,
107/02/09,-9,0,0,-9,7461,0,519,7980,9.32%,9.97%,
107/02/08,-21,0,0,-21,7470,0,519,7989,9.33%,9.98%,
107/02/07,-47,0,0,-47,7491,0,519,8010,9.36%,10.01%,
107/02/06,-29,0,1,-28,7537,0,519,8056,9.42%,10.07%,
107/02/05,0,0,-11,-11,7566,0,518,8084,9.45%,10.10%,
107/02/02,-22,0,11,-11,7566,0,529,8095,9.45%,10.11%,
107/02/01,-5,0,-1,-6,7588,0,518,8106,9.48%,10.13%,
107/01/31,9,0,0,9,7593,0,519,8112,9.49%,10.14%,
107/01/30,0,0,0,0,7584,0,519,8103,9.47%,10.12%,
107/01/29,2,0,0,2,7584,0,519,8103,9.47%,10.12%,
107/01/26,-1,0,-17,-18,7582,0,519,8101,9.47%,10.12%,
107/01/25,2,0,0,2,7583,0,536,8119,9.47%,10.14%,
107/01/24,3,0,0,3,7581,0,536,8117,9.47%,10.14%,
107/01/23,-3,0,1,-2,7578,0,536,8114,9.47%,10.14%,
107/01/22,-4,0,17,13,7581,0,535,8116,9.47%,10.14%,
107/01/19,2,0,0,2,7585,0,518,8103,9.48%,10.13%,
107/01/18,-18,0,1,-17,7571,0,518,8089,9.46%,10.11%,
107/01/17,-30,0,0,-30,7589,0,517,8106,9.48%,10.13%,
107/01/16,5,0,1,6,7619,0,517,8136,9.52%,10.17%,
107/01/15,-12,0,0,-12,7614,0,516,8130,9.51%,10.15%,
107/01/12,2,0,0,2,7612,0,516,8128,9.51%,10.15%,
107/01/11,-25,0,-30,-55,7610,0,516,8126,9.51%,10.15%,
107/01/10,-15,0,0,-15,7635,0,546,8181,9.54%,10.22%,
107/01/09,-16,0,0,-16,7650,0,546,8196,9.56%,10.24%,
107/01/08,-26,0,-6,-32,7666,0,546,8212,9.58%,10.26%,
107/01/05,-2,0,-24,-26,7692,0,552,8244,9.61%,10.30%,
107/01/04,-10,0,0,-10,7694,0,576,8270,9.61%,10.33%,
107/01/03,-27,0,90,63,7704,0,576,8280,9.62%,10.34%,
107/01/02,8,0,158,166,7731,0,486,8217,9.66%,10.27%,
106/12/29,-2,0,0,-2,7723,0,328,8051,9.65%,10.06%,
106/12/28,5,-4,-1,0,7725,0,328,8053,9.65%,10.06%,
106/12/27,-4,-4,0,-8,7720,0,329,8049,9.64%,10.05%,
106/12/26,0,-3,0,-3,7714,0,329,8043,9.64%,10.05%,
106/12/25,7,0,0,7,7714,0,329,8043,9.64%,10.05%,
106/12/22,8,0,0,8,7707,0,329,8036,9.63%,10.04%,
106/12/21,-2,0,0,-2,7699,0,329,8028,9.62%,10.03%,
106/12/20,-10,0,2,-8,7709,0,329,8038,9.63%,10.04%,
106/12/19,-1,0,0,-1,7719,0,327,8046,9.64%,10.05%,
106/12/18,0,0,0,0,7720,0,327,8047,9.64%,10.05%,
106/12/15,-1,0,0,-1,7720,0,327,8047,9.64%,10.05%,
106/12/14,-3,0,0,-3,7721,0,327,8048,9.65%,10.06%,
106/12/13,-9,0,0,-9,7724,0,327,8051,9.65%,10.06%,
106/12/12,0,0,0,0,7733,0,327,8060,9.66%,10.07%,
106/12/11,-7,0,0,-7,7733,0,327,8060,9.66%,10.07%,
106/12/08,-16,0,0,-16,7740,0,327,8067,9.67%,10.08%,
106/12/07,-8,0,0,-8,7756,0,327,8083,9.69%,10.10%,
106/12/06,-12,0,0,-12,7764,0,327,8091,9.70%,10.11%,
106/12/05,-5,0,0,-5,7776,0,327,8103,9.71%,10.12%,
106/12/04,-1,0,0,-1,7781,0,327,8108,9.72%,10.13%,
106/12/01,-14,0,0,-14,7782,0,327,8109,9.72%,10.13%,
106/11/30,1,0,0,1,7796,0,327,8123,9.74%,10.15%,
106/11/29,14,0,3,17,7795,0,327,8122,9.74%,10.15%,
106/11/28,10,0,0,10,7781,0,324,8105,9.72%,10.12%,
106/11/27,2,0,0,2,7771,0,324,8095,9.71%,10.11%,
106/11/24,1,0,1,2,7769,0,324,8093,9.71%,10.11%,
106/11/23,21,0,0,21,7768,0,323,8091,9.70%,10.10%,
106/11/22,2,0,8,10,7747,0,323,8070,9.68%,10.08%,
106/11/21,2,0,0,2,7745,0,315,8060,9.68%,10.07%,
106/11/20,4,0,0,4,7743,0,315,8058,9.67%,10.06%,
106/11/17,-2,0,0,-2,7739,0,315,8054,9.67%,10.06%,
106/11/16,6,0,0,6,7741,0,315,8056,9.67%,10.06%,
106/11/15,0,0,0,0,7735,0,315,8050,9.66%,10.05%,
106/11/14,0,0,0,0,7735,0,315,8050,9.66%,10.05%,
106/11/13,-4,0,1,-3,7735,0,315,8050,9.66%,10.05%,
106/11/10,-4,0,1,-3,7739,0,314,8053,9.67%,10.06%,
106/11/09,-2,0,0,-2,7743,0,313,8056,9.67%,10.06%,
106/11/08,6,0,0,6,7745,0,313,8058,9.68%,10.07%,
106/11/07,10,0,-3,7,7739,0,313,8052,9.67%,10.06%,
106/11/06,7,0,-1,6,7729,0,316,8045,9.66%,10.05%,
106/11/03,2,0,0,2,7722,0,317,8039,9.65%,10.05%,
106/11/02,6,0,0,6,7720,0,317,8037,9.64%,10.04%,
106/11/01,3,0,0,3,7714,0,317,8031,9.64%,10.04%,
106/10/31,-1,0,-1,-2,7711,0,317,8028,9.63%,10.03%,
106/10/30,-6,0,0,-6,7712,0,318,8030,9.63%,10.03%,
106/10/27,-11,0,0,-11,7718,0,318,8036,9.64%,10.04%,
106/10/26,31,0,0,31,7729,0,318,8047,9.66%,10.06%,
106/10/25,11,0,0,11,7698,0,318,8016,9.62%,10.02%,
106/10/24,7,0,0,7,7687,0,318,8005,9.60%,10.00%,
106/10/23,10,0,0,10,7680,0,318,7998,9.59%,9.99%,
106/10/20,7,0,-2,5,7670,0,318,7988,9.58%,9.98%,
106/10/19,3,-1,0,2,7663,0,320,7983,9.57%,9.97%,
106/10/18,0,0,1,1,7660,0,320,7980,9.57%,9.97%,
106/10/17,-2,0,0,-2,7660,0,319,7979,9.57%,9.97%,
106/10/16,0,0,0,0,7662,0,319,7981,9.57%,9.97%,
106/10/13,2,0,0,2,7662,0,319,7981,9.57%,9.97%,
106/10/12,1,0,0,1,7660,0,319,7979,9.57%,9.97%,
106/10/11,-2,0,0,-2,7659,0,319,7978,9.57%,9.97%,
106/10/06,0,0,0,0,7661,0,319,7980,9.57%,9.97%,
106/10/05,-1,0,0,-1,7661,0,319,7980,9.57%,9.97%,
106/10/03,-4,0,0,-4,7662,0,319,7981,9.57%,9.97%,
106/10/02,-3,0,-1,-4,7666,0,319,7985,9.58%,9.98%,
106/09/30,0,0,0,0,7669,0,320,7989,9.58%,9.98%,
106/09/29,-2,0,0,-2,7669,0,320,7989,9.58%,9.98%,
106/09/28,0,0,0,0,7671,0,320,7991,9.58%,9.98%,
106/09/27,-3,0,0,-3,7671,0,320,7991,9.58%,9.98%,
106/09/26,3,0,0,3,7674,0,320,7994,9.59%,9.99%,
106/09/25,2,0,0,2,7671,0,320,7991,9.58%,9.98%,
106/09/22,-4,0,2,-2,7669,0,320,7989,9.58%,9.98%,
106/09/21,-2,0,0,-2,7673,0,318,7991,9.59%,9.99%,
106/09/20,15,0,0,15,7675,0,318,7993,9.59%,9.99%,
106/09/19,-10,0,1,-9,7660,0,318,7978,9.57%,9.97%,
106/09/18,-51,0,0,-51,7670,0,317,7987,9.58%,9.98%,
106/09/15,-29,0,-2,-31,7721,0,317,8038,9.65%,10.05%,
106/09/14,7,0,0,7,7750,0,319,8069,9.68%,10.08%,
106/09/13,12,0,0,12,7743,0,319,8062,9.67%,10.07%,
106/09/12,3,0,0,3,7731,0,319,8050,9.66%,10.06%,
106/09/11,0,0,0,0,7728,0,319,8047,9.65%,10.05%,
106/09/08,0,-1,0,-1,7728,0,319,8047,9.65%,10.05%,
106/09/07,-1,0,-1,-2,7728,0,319,8047,9.65%,10.05%,
106/09/06,-9,0,0,-9,7729,0,320,8049,9.66%,10.06%,
106/09/05,-3,0,0,-3,7738,0,320,8058,9.67%,10.07%,
106/09/04,-9,0,0,-9,7741,0,320,8061,9.67%,10.07%,
106/09/01,4,0,0,4,7750,0,320,8070,9.68%,10.08%,
106/08/31,-1,0,-2,-3,7746,0,320,8066,9.68%,10.08%,
106/08/30,-2,0,-3,-5,7747,0,322,8069,9.68%,10.08%,
106/08/29,-4,0,0,-4,7749,0,325,8074,9.68%,10.09%,
106/08/28,-3,0,-7,-10,7753,0,325,8078,9.69%,10.10%,
106/08/25,1,0,-11,-10,7756,0,332,8088,9.69%,10.10%,
106/08/24,1,-2,0,-1,7755,0,343,8098,9.69%,10.12%,
106/08/23,-19,-3,-20,-42,7754,0,343,8097,9.69%,10.12%,
106/08/22,-32,0,-18,-50,7773,0,363,8136,9.71%,10.16%,
106/08/21,-27,0,0,-27,7801,0,381,8182,9.75%,10.23%,
106/08/18,-14,0,0,-14,7828,0,381,8209,9.78%,10.26%,
106/08/17,-12,0,0,-12,7842,0,381,8223,9.80%,10.28%,
106/08/16,-8,0,-5,-13,7854,0,381,8235,9.81%,10.29%,
106/08/15,-9,0,0,-9,7862,0,386,8248,9.82%,10.30%,
106/08/14,-4,0,-6,-10,7871,0,386,8257,9.83%,10.31%,
106/08/11,17,0,0,17,7875,0,392,8267,9.84%,10.33%,
106/08/10,-91,0,0,-91,7858,0,392,8250,9.82%,10.31%,
106/08/09,-222,0,-80,-302,7949,0,392,8341,9.93%,10.42%,
106/08/08,-26,0,0,-26,8171,0,472,8643,10.21%,10.80%,
106/08/07,-1,0,1,0,8197,0,472,8669,10.24%,10.83%,
106/08/04,-11,0,0,-11,8198,0,471,8669,10.24%,10.83%,
106/08/03,-21,0,0,-21,8209,0,471,8680,10.26%,10.85%,
106/08/02,-14,0,0,-14,8230,0,471,8701,10.28%,10.87%,
106/08/01,-20,-1,0,-21,8244,0,471,8715,10.30%,10.89%,
106/07/31,-23,0,0,-23,8264,0,471,8735,10.32%,10.91%,
106/07/28,-61,0,0,-61,8287,0,471,8758,10.35%,10.94%,
106/07/27,-41,0,0,-41,8348,0,471,8819,10.43%,11.02%,
106/07/26,-29,0,0,-29,8389,0,471,8860,10.48%,11.07%,
106/07/25,1,0,5,6,8418,0,471,8889,10.52%,11.11%,
106/07/24,83,0,0,83,8417,0,466,8883,10.52%,11.10%,
106/07/21,-42,0,0,-42,8338,0,466,8804,10.42%,11.00%,
106/07/20,-236,0,0,-236,8380,0,466,8846,10.47%,11.05%,
106/07/19,-302,0,0,-302,8616,0,466,9082,10.76%,11.34%,
106/07/18,5,0,-25,-20,8918,0,466,9384,11.14%,11.72%,
106/07/17,-4,0,-38,-42,8913,0,491,9404,11.14%,11.75%,
106/07/14,8,0,-25,-17,8917,0,529,9446,11.14%,11.80%,
106/07/13,4,0,-22,-18,8909,0,554,9463,11.13%,11.82%,
106/07/12,-6,0,-42,-48,8905,0,576,9481,11.13%,11.85%,
106/07/11,-13,0,1,-12,8911,0,618,9529,11.13%,11.90%,
106/07/10,-33,0,38,5,8959,0,617,9576,11.19%,11.96%,
106/07/07,-30,0,0,-30,8992,0,579,9571,11.23%,11.95%,
106/07/06,-42,0,0,-42,9022,0,579,9601,11.27%,11.99%,
106/07/05,-24,0,0,-24,9064,0,579,9643,11.32%,12.04%,
106/07/04,-78,0,-1,-79,9088,0,579,9667,11.35%,12.07%,
106/07/03,-52,0,0,-52,9166,0,580,9746,11.45%,12.17%,
106/06/30,-15,0,-1,-16,9218,0,580,9798,11.52%,12.24%,
106/06/29,5,0,-1,4,9233,0,581,9814,11.54%,12.27%,
106/06/28,-8,0,0,-8,9228,0,582,9810,11.53%,12.26%,
106/06/27,18,0,0,18,9236,0,582,9818,11.54%,12.27%,
106/06/26,-6,0,5,-1,9218,0,582,9800,11.52%,12.25%,
106/06/23,11,0,0,11,9224,0,577,9801,11.52%,12.24%,
106/06/22,-7,0,0,-7,9213,0,577,9790,11.51%,12.23%,
106/06/21,33,0,11,44,9220,0,577,9797,11.52%,12.24%,
106/06/20,0,0,5,5,9187,0,566,9753,11.48%,12.19%,
106/06/19,39,0,15,54,9187,0,561,9748,11.48%,12.18%,
106/06/16,59,0,5,64,9148,0,546,9694,11.43%,12.11%,
106/06/15,25,0,0,25,9089,0,541,9630,11.36%,12.04%,
106/06/14,21,0,0,21,9064,0,541,9605,11.32%,12.00%,
106/06/13,32,0,0,32,9043,0,541,9584,11.30%,11.98%,
106/06/12,28,0,-78,-50,9011,0,541,9552,11.26%,11.94%,
106/06/09,21,0,-152,-131,8983,0,619,9602,11.22%,11.99%,
106/06/08,2,0,0,2,8983,0,771,9754,11.22%,12.18%,
106/06/07,8,0,-110,-102,8981,0,771,9752,11.22%,12.18%,
106/06/06,22,-3,10,29,8973,0,881,9854,11.21%,12.31%,
106/06/05,7,-2,-1,4,8951,0,871,9822,11.18%,12.27%,
106/06/03,0,0,0,0,8944,0,872,9816,11.17%,12.26%,
106/06/02,39,0,-10,29,8944,0,872,9816,11.17%,12.26%,
106/06/01,10,-50,0,-40,8905,0,882,9787,11.13%,12.23%,
106/05/31,1,0,-9,-8,8895,0,882,9777,11.11%,12.21%,
106/05/26,-1,0,-5,-6,8894,0,891,9785,11.11%,12.22%,
106/05/25,14,0,-11,3,8895,0,896,9791,11.11%,12.23%,
106/05/24,0,0,0,0,8881,0,907,9788,11.10%,12.23%,
106/05/23,7,0,94,101,8881,0,907,9788,11.10%,12.23%,
106/05/22,-12,0,5,-7,8872,0,813,9685,11.08%,12.10%,
106/05/19,20,0,0,20,8884,0,808,9692,11.10%,12.11%,
106/05/18,19,0,-85,-66,8864,0,808,9672,11.07%,12.08%,
106/05/17,24,0,-25,-1,8845,0,893,9738,11.05%,12.17%,
106/05/16,-9,0,-88,-97,8821,0,918,9739,11.02%,12.17%,
106/05/15,24,0,8,32,8830,0,1006,9836,11.03%,12.29%,
106/05/12,-33,0,479,446,8806,0,998,9804,11.00%,12.25%,
106/05/11,-15,0,80,65,8839,0,519,9358,11.04%,11.69%,
106/05/10,10,0,28,38,8854,0,439,9293,11.06%,11.61%,
106/05/09,-20,0,51,31,8844,0,411,9255,11.05%,11.56%,
106/05/08,1,0,0,1,8864,0,360,9224,11.07%,11.52%,
106/05/05,8,0,0,8,8863,0,360,9223,11.07%,11.52%,
106/05/04,0,0,0,0,8855,0,360,9215,11.06%,11.51%,
106/05/03,-1,0,0,-1,8855,0,360,9215,11.06%,11.51%,
106/05/02,15,0,0,15,8856,0,360,9216,11.06%,11.51%,
106/04/28,3,0,0,3,8841,0,360,9201,11.05%,11.50%,
106/04/27,9,0,0,9,8838,0,360,9198,11.04%,11.49%,
106/04/26,6,0,0,6,8826,0,360,9186,11.03%,11.48%,
106/04/25,-4,0,0,-4,8820,0,360,9180,11.02%,11.47%,
106/04/24,-9,0,0,-9,8824,0,360,9184,11.02%,11.47%,
106/04/21,8,0,0,8,8833,0,360,9193,11.04%,11.49%,
106/04/20,0,0,0,0,8825,0,360,9185,11.03%,11.48%,
106/04/19,3,-45,0,-42,8825,0,360,9185,11.03%,11.48%,
106/04/18,21,-45,0,-24,8822,0,360,9182,11.02%,11.47%,
106/04/17,-11,-30,0,-41,8801,0,360,9161,11.00%,11.45%,
106/04/14,-12,-1,0,-13,8812,22,360,9194,11.01%,11.49%,
106/04/13,1,0,0,1,8824,23,360,9207,11.02%,11.50%,
106/04/12,-3,0,0,-3,8823,23,360,9206,11.02%,11.50%,
106/04/11,-63,0,8,-55,8826,23,360,9209,11.03%,11.51%,
106/04/10,18,0,30,48,8889,23,352,9264,11.11%,11.58%,
106/04/07,-3,0,0,-3,8871,23,322,9216,11.08%,11.51%,
106/04/06,36,0,0,36,8874,23,322,9219,11.09%,11.52%,
106/04/05,-1,0,1,0,8838,23,322,9183,11.04%,11.47%,
106/03/31,-47,0,0,-47,8834,23,321,9178,11.04%,11.47%,
106/03/30,-24,0,0,-24,8881,23,321,9225,11.10%,11.53%,
106/03/29,-69,0,0,-69,8905,23,321,9249,11.13%,11.56%,
106/03/28,-55,0,1,-54,8974,23,321,9318,11.21%,11.64%,
106/03/27,-114,0,2,-112,9029,23,320,9372,11.28%,11.71%,
106/03/24,-77,0,0,-77,9143,23,318,9484,11.42%,11.85%,
106/03/23,-66,0,0,-66,9220,23,318,9561,11.52%,11.95%,
106/03/22,-45,0,0,-45,9286,23,318,9627,11.60%,12.03%,
106/03/21,-67,3,0,-64,9331,23,318,9672,11.66%,12.09%,
106/03/20,-169,3,0,-166,9398,20,318,9736,11.74%,12.16%,
106/03/17,-280,0,0,-280,9567,17,318,9902,11.95%,12.37%,
106/03/16,-23,0,0,-23,9847,17,318,10182,12.30%,12.72%,
106/03/15,-35,0,1,-34,9870,17,318,10205,12.33%,12.75%,
106/03/14,-30,0,0,-30,9905,17,317,10239,12.38%,12.80%,
106/03/13,-51,0,0,-51,9935,17,317,10269,12.41%,12.83%,
106/03/10,-81,0,0,-81,9986,17,317,10320,12.48%,12.90%,
106/03/09,-33,0,-40,-73,10067,17,317,10401,12.58%,13.00%,
106/03/08,-37,0,40,3,10100,17,357,10474,12.62%,13.09%,
106/03/07,-72,0,0,-72,10137,17,317,10471,12.67%,13.09%,
106/03/06,-36,0,0,-36,10209,17,317,10543,12.76%,13.18%,
106/03/03,-15,0,0,-15,10245,17,317,10579,12.80%,13.22%,
106/03/02,-10,0,0,-10,10260,17,317,10594,12.82%,13.24%,
106/03/01,-6,0,0,-6,10270,17,317,10604,12.83%,13.25%,
106/02/24,6,0,0,6,10276,17,317,10610,12.84%,13.26%,
106/02/23,15,0,-40,-25,10270,17,317,10604,12.83%,13.25%,
106/02/22,6,0,3,9,10255,17,357,10629,12.81%,13.28%,
106/02/21,4,0,2,6,10249,17,354,10620,12.81%,13.27%,
106/02/20,11,0,5,16,10245,17,352,10614,12.80%,13.26%,
106/02/18,0,0,0,0,10234,17,347,10598,12.79%,13.24%,
106/02/17,4,0,-11,-7,10234,17,347,10598,12.79%,13.24%,
106/02/16,4,0,6,10,10230,17,358,10605,12.78%,13.25%,
106/02/15,29,0,5,34,10226,17,352,10595,12.78%,13.24%,
106/02/14,2,0,0,2,10197,17,347,10561,12.74%,13.19%,
106/02/13,6,0,0,6,10195,17,347,10559,12.74%,13.19%,
106/02/10,29,-40,0,-11,10189,17,347,10553,12.73%,13.18%,
106/02/09,-18,-56,-5,-79,10160,57,347,10564,12.70%,13.20%,
106/02/08,-76,-56,2,-130,10178,113,352,10643,12.72%,13.30%,
106/02/07,-88,-45,-15,-148,10254,169,350,10773,12.81%,13.46%,
106/02/06,3,0,2,5,10342,214,365,10921,12.92%,13.64%,
106/02/03,8,2,7,17,10339,214,363,10916,12.92%,13.64%,
106/02/02,2,0,-2,0,10331,212,356,10899,12.91%,13.62%,
106/01/24,0,-15,1,-14,10329,212,358,10899,12.91%,13.62%,
106/01/23,-4,-16,0,-20,10329,227,357,10913,12.91%,13.64%,
106/01/20,-3,0,0,-3,10333,243,357,10933,12.91%,13.66%,
106/01/19,-6,0,-2,-8,10336,243,357,10936,12.92%,13.67%,
106/01/18,0,-27,0,-27,10342,243,359,10944,12.92%,13.67%,
106/01/17,-70,0,0,-70,10342,270,359,10971,12.92%,13.71%,
106/01/16,-32,0,-5,-37,10412,270,359,11041,13.01%,13.80%,
106/01/13,0,0,0,0,10444,270,364,11078,13.05%,13.84%,
106/01/12,-1,0,0,-1,10444,270,364,11078,13.05%,13.84%,
106/01/11,-1,0,2,1,10445,270,364,11079,13.05%,13.84%,
106/01/10,0,0,-8,-8,10446,270,362,11078,13.05%,13.84%,
106/01/09,0,-5,3,-2,10446,270,370,11086,13.05%,13.85%,
106/01/06,-6,-6,2,-10,10446,275,367,11088,13.05%,13.85%,
106/01/05,0,1,4,5,10452,281,365,11098,13.06%,13.87%,
106/01/04,5,0,3,8,10452,280,361,11093,13.06%,13.86%,
106/01/03,0,0,3,3,10447,280,358,11085,13.05%,13.85%,
105/12/30,4,0,0,4,10447,280,355,11082,13.05%,13.84%,
105/12/29,1,0,-1,0,10443,280,355,11078,13.05%,13.84%,
105/12/28,1,0,2,3,10442,280,356,11078,13.05%,13.84%,
105/12/27,1,0,0,1,10441,280,354,11075,13.05%,13.84%,
105/12/26,0,0,2,2,10440,280,354,11074,13.05%,13.84%,
105/12/23,-2,0,0,-2,10440,280,352,11072,13.05%,13.84%,
105/12/22,3,0,9,12,10442,280,352,11074,13.05%,13.84%,
105/12/21,-9,0,13,4,10439,280,343,11062,13.04%,13.82%,
105/12/20,-4,0,1,-3,10448,280,330,11058,13.06%,13.82%,
105/12/19,3,0,-4,-1,10452,280,329,11061,13.06%,13.82%,
105/12/16,3,0,5,8,10449,280,333,11062,13.06%,13.83%,
105/12/15,-4,0,6,2,10446,280,328,11054,13.05%,13.81%,
105/12/14,-4,0,6,2,10450,280,322,11052,13.06%,13.81%,
105/12/13,8,0,2,10,10454,280,316,11050,13.06%,13.80%,
105/12/12,1,0,6,7,10446,280,314,11040,13.05%,13.79%,
105/12/09,0,0,1,1,10445,280,308,11033,13.05%,13.78%,
105/12/08,-2,0,11,9,10445,280,307,11032,13.05%,13.78%,
105/12/07,-16,0,0,-16,10447,280,296,11023,13.05%,13.77%,
105/12/06,-6,0,1,-5,10463,280,296,11039,13.07%,13.79%,
105/12/05,1,0,0,1,10469,280,295,11044,13.08%,13.80%,
105/12/02,-1,0,0,-1,10468,280,295,11043,13.08%,13.80%,
105/12/01,0,0,3,3,10469,280,295,11044,13.08%,13.80%,
105/11/30,-2,-5,3,-4,10469,280,292,11041,13.08%,13.79%,
105/11/29,1,0,32,33,10471,285,289,11045,13.08%,13.80%,
105/11/28,1,0,4,5,10470,285,257,11012,13.08%,13.76%,
105/11/25,-11,0,0,-11,10469,285,253,11007,13.08%,13.75%,
105/11/24,-1,0,-5,-6,10480,285,253,11018,13.10%,13.77%,
105/11/23,-2,0,4,2,10481,285,258,11024,13.10%,13.78%,
105/11/22,-1,0,2,1,10483,285,254,11022,13.10%,13.77%,
105/11/21,-3,0,4,1,10484,285,252,11021,13.10%,13.77%,
105/11/18,0,0,6,6,10487,285,248,11020,13.10%,13.77%,
105/11/17,-1,0,3,2,10487,285,242,11014,13.10%,13.76%,
105/11/16,-9,0,2,-7,10488,285,239,11012,13.11%,13.76%,
105/11/15,-11,0,2,-9,10497,285,237,11019,13.12%,13.77%,
105/11/14,-6,0,4,-2,10508,285,235,11028,13.13%,13.78%,
105/11/11,2,0,5,7,10514,285,231,11030,13.14%,13.78%,
105/11/10,9,0,-76,-67,10512,285,226,11023,13.14%,13.78%,
105/11/09,-2,0,-50,-52,10503,285,302,11090,13.12%,13.85%,
105/11/08,3,0,-10,-7,10505,285,352,11142,13.13%,13.93%,
105/11/07,-6,0,-12,-18,10502,285,362,11149,13.12%,13.93%,
105/11/04,-7,-20,-2,-29,10508,285,374,11167,13.13%,13.95%,
105/11/03,-2,-18,-5,-25,10515,305,376,11196,13.14%,13.99%,
105/11/02,-7,0,-11,-18,10517,323,381,11221,13.14%,14.02%,
105/11/01,7,-12,-10,-15,10524,323,392,11239,13.15%,14.04%,
105/10/31,-3,0,-4,-7,10517,335,402,11254,13.14%,14.06%,
105/10/28,1,0,-4,-3,10520,335,406,11261,13.15%,14.08%,
105/10/27,-2,0,4,2,10519,335,410,11264,13.14%,14.07%,
105/10/26,-4,0,-5,-9,10521,335,406,11262,13.15%,14.08%,
105/10/25,11,0,-6,5,10525,335,411,11271,13.15%,14.08%,
105/10/24,0,0,5,5,10514,335,417,11266,13.14%,14.08%,
105/10/21,-8,8,-14,-14,10514,335,412,11261,13.14%,14.07%,
105/10/20,0,7,-2,5,10522,327,426,11275,13.15%,14.09%,
105/10/19,1,0,-7,-6,10522,320,428,11270,13.15%,14.08%,
105/10/18,7,0,-19,-12,10521,320,435,11276,13.15%,14.09%,
105/10/17,5,0,-26,-21,10514,320,454,11288,13.14%,14.11%,
105/10/14,-19,0,-26,-45,10509,320,480,11309,13.13%,14.13%,
105/10/13,3,0,-10,-7,10507,320,506,11333,13.13%,14.16%,
105/10/12,5,0,5,10,10504,320,516,11340,13.13%,14.17%,
105/10/11,7,0,-25,-18,10499,320,511,11330,13.12%,14.16%,
105/10/07,2,0,3,5,10492,320,536,11348,13.11%,14.18%,
105/10/06,14,0,5,19,10490,320,533,11343,13.11%,14.18%,
105/10/05,6,0,2,8,10476,320,528,11324,13.09%,14.15%,
105/10/04,18,0,11,29,10470,320,526,11316,13.08%,14.14%,
105/10/03,-1,0,11,10,10452,320,515,11287,13.06%,14.10%,
105/09/30,3,0,1,4,10453,320,504,11277,13.06%,14.09%,
105/09/29,8,0,1,9,10450,490,503,11443,13.06%,14.30%,
105/09/26,101,0,-66,35,10442,490,502,11434,13.05%,14.29%,
105/09/23,6,0,10,16,10341,490,568,11399,12.92%,14.24%,
105/09/22,2,0,-25,-23,10335,490,558,11383,12.91%,14.22%,
105/09/21,9,30,42,81,10333,490,583,11406,12.91%,14.25%,
105/09/20,-5,0,1,-4,10324,460,541,11325,12.90%,14.15%,
105/09/19,-4,0,9,5,10329,460,540,11329,12.91%,14.16%,
105/09/14,-3,0,6,3,10333,460,531,11324,12.91%,14.15%,
105/09/13,-18,0,4,-14,10336,460,525,11321,12.92%,14.15%,
105/09/12,-19,0,-10,-29,10354,460,521,11335,12.94%,14.17%,
105/09/10,0,0,-13,-13,10373,460,531,11364,12.96%,14.20%,
105/09/09,-2,0,0,-2,10373,460,544,11377,12.96%,14.21%,
105/09/08,5,0,0,5,10375,460,544,11379,12.96%,14.21%,
105/09/07,-2,0,2,0,10370,460,544,11374,12.96%,14.21%,
105/09/06,13,0,6,19,10372,460,542,11374,12.96%,14.21%,
105/09/05,-2,0,5,3,10359,460,536,11355,12.94%,14.18%,
105/09/02,-11,0,10,-1,10361,460,531,11352,12.95%,14.19%,
105/09/01,-10,0,10,0,10372,460,521,11353,12.96%,14.19%,
105/08/31,-5,0,3,-2,10382,460,511,11353,12.97%,14.18%,
105/08/30,-18,0,-1,-19,10387,460,508,11355,12.98%,14.19%,
105/08/29,10,0,5,15,10405,460,509,11374,13.00%,14.21%,
105/08/26,-7,0,15,8,10395,460,504,11359,12.99%,14.19%,
105/08/25,-2,28,5,31,10402,460,489,11351,13.00%,14.19%,
105/08/24,1,47,20,68,10404,432,484,11320,13.00%,14.14%,
105/08/23,-8,0,5,-3,10403,385,464,11252,13.00%,14.06%,
105/08/22,-6,0,2,-4,10411,385,459,11255,13.01%,14.06%,
105/08/19,-4,0,-2,-6,10417,385,457,11259,13.02%,14.07%,
105/08/18,-4,15,0,11,10422,385,459,11266,13.02%,14.07%,
105/08/17,21,0,0,21,10426,370,459,11255,13.03%,14.07%,
105/08/16,-10,0,15,5,10404,370,459,11233,13.00%,14.04%,
105/08/15,17,20,10,47,10414,370,444,11228,13.01%,14.03%,
105/08/12,14,0,5,19,10397,350,434,11181,12.99%,13.97%,
105/08/11,7,67,0,74,10383,350,429,11162,12.97%,13.94%,
105/08/10,1,70,29,100,10376,283,429,11088,12.97%,13.86%,
105/08/09,-6,70,6,70,10375,213,400,10988,12.96%,13.73%,
105/08/08,-34,40,5,11,10381,143,394,10918,12.97%,13.64%,
105/08/05,-49,30,0,-19,10415,103,389,10907,13.01%,13.62%,
105/08/04,-92,23,0,-69,10464,73,389,10926,13.07%,13.65%,
105/08/03,-41,0,0,-41,10556,50,389,10995,13.19%,13.74%,
105/08/02,1,0,0,1,10597,50,389,11036,13.24%,13.79%,
105/08/01,19,0,0,19,10596,50,389,11035,13.24%,13.79%,
105/07/29,-1,0,0,-1,10577,50,389,11016,13.22%,13.77%,
105/07/28,5,0,0,5,10578,50,389,11017,13.22%,13.77%,
105/07/27,5,0,0,5,10573,50,389,11012,13.21%,13.76%,
105/07/26,6,0,0,6,10568,50,389,11007,13.20%,13.75%,
105/07/25,-2,0,0,-2,10562,50,389,11001,13.20%,13.75%,
105/07/22,1,0,0,1,10564,50,389,11003,13.20%,13.75%,
105/07/21,14,0,0,14,10563,50,389,11002,13.20%,13.75%,
105/07/20,5,0,0,5,10549,50,389,10988,13.18%,13.73%,
105/07/19,2,0,0,2,10544,50,389,10983,13.17%,13.72%,
105/07/18,-3,0,0,-3,10542,50,389,10981,13.17%,13.72%,
105/07/15,-15,0,0,-15,10545,50,389,10984,13.18%,13.73%,
105/07/14,-10,0,0,-10,10560,50,389,10999,13.19%,13.74%,
105/07/13,7,50,0,57,10570,50,389,11009,13.21%,13.76%,
105/07/12,-14,0,0,-14,10563,0,389,10952,13.20%,13.69%,
105/07/11,10,0,0,10,10577,0,389,10966,13.22%,13.71%,
105/07/07,-3,0,-5,-8,10604,0,389,10993,13.25%,13.74%,
105/07/06,-2,0,-6,-8,10607,0,394,11001,13.25%,13.74%,
105/07/05,-7,0,-1,-8,10609,0,400,11009,13.26%,13.76%,
105/07/04,9,0,0,9,10616,0,401,11017,13.26%,13.76%,
105/07/01,8,0,0,8,10607,0,401,11008,13.25%,13.75%,
105/06/30,20,0,0,20,10599,0,401,11000,13.24%,13.74%,
105/06/29,1,0,3,4,10579,0,401,10980,13.22%,13.72%,
105/06/28,-14,0,6,-8,10578,0,398,10976,13.22%,13.72%,
105/06/27,-1,-30,0,-31,10609,0,392,11001,13.26%,13.75%,
105/06/24,12,-31,-4,-23,10610,0,392,11002,13.26%,13.75%,
105/06/23,-1,0,0,-1,10598,0,396,10994,13.24%,13.73%,
105/06/22,-4,0,0,-4,10599,0,396,10995,13.24%,13.73%,
105/06/21,1,0,1,2,10603,0,396,10999,13.25%,13.74%,
105/06/20,4,0,1,5,10602,0,395,10997,13.25%,13.74%,
105/06/17,1,0,1,2,10598,0,394,10992,13.24%,13.73%,
105/06/16,-9,0,0,-9,10597,0,393,10990,13.24%,13.73%,
105/06/15,0,0,1,1,10606,0,393,10999,13.25%,13.74%,
105/06/14,1,0,1,2,10606,0,392,10998,13.25%,13.74%,
105/06/13,2,0,0,2,10605,0,391,10996,13.25%,13.74%,
105/06/08,-2,0,0,-2,10603,0,391,10994,13.25%,13.74%,
105/06/07,9,0,0,9,10605,0,391,10996,13.25%,13.74%,
105/06/06,-9,0,-1,-10,10596,0,391,10987,13.24%,13.73%,
105/06/04,0,0,0,0,10605,0,392,10997,13.25%,13.74%,
105/06/03,-1,0,1,0,10605,0,392,10997,13.25%,13.74%,
105/06/02,11,0,2,13,10606,0,391,10997,13.25%,13.74%,
105/06/01,6,0,0,6,10595,0,389,10984,13.24%,13.73%,
105/05/31,-11,0,0,-11,10589,0,389,10978,13.23%,13.72%,
105/05/30,5,0,0,5,10600,0,389,10989,13.24%,13.73%,
105/05/27,-4,0,0,-4,10595,0,389,10984,13.24%,13.73%,
105/05/26,-9,0,-1,-10,10599,0,389,10988,13.24%,13.73%,
105/05/25,-8,-30,1,-37,10608,0,390,10998,13.25%,13.74%,
105/05/24,0,-20,0,-20,10616,0,389,11005,13.26%,13.75%,
105/05/23,30,-20,0,10,10616,0,389,11005,13.26%,13.75%,
105/05/20,-2,0,0,-2,10586,0,389,10975,13.23%,13.72%,
105/05/19,-13,-20,-7,-40,10588,0,389,10977,13.23%,13.72%,
105/05/18,-34,0,-6,-40,10601,0,396,10997,13.25%,13.74%,
105/05/17,54,-20,7,41,10580,0,402,10982,13.22%,13.72%,
105/05/16,-21,0,10,-11,10526,0,395,10921,13.15%,13.64%,
105/05/13,-4,0,14,10,10547,0,385,10932,13.18%,13.66%,
105/05/12,-36,0,0,-36,10551,0,371,10922,13.18%,13.64%,
105/05/11,1,0,0,1,10587,0,371,10958,13.23%,13.69%,
105/05/10,3,0,0,3,10586,0,371,10957,13.23%,13.69%,
105/05/09,10,0,1,11,10583,0,371,10954,13.22%,13.68%,
105/05/06,5,0,0,5,10573,0,370,10943,13.21%,13.67%,
105/05/05,-25,0,0,-25,10568,0,370,10938,13.20%,13.66%,
105/05/04,10,0,0,10,10576,0,370,10946,13.21%,13.67%,
105/05/03,-29,0,0,-29,10566,0,370,10936,13.20%,13.66%,
105/04/29,-18,0,0,-18,10595,0,370,10965,13.24%,13.70%,
105/04/28,-17,0,-3,-20,10613,0,370,10983,13.26%,13.72%,
105/04/27,-30,0,-1,-31,10630,0,373,11003,13.28%,13.75%,
105/04/26,-13,0,0,-13,10660,0,374,11034,13.32%,13.79%,
105/04/25,-23,0,0,-23,10673,0,374,11047,13.34%,13.81%,
105/04/22,-85,0,0,-85,10646,0,374,11020,13.30%,13.77%,
105/04/21,-141,0,-2,-143,10731,0,374,11105,13.41%,13.88%,
105/04/20,-32,0,0,-32,10872,0,376,11248,13.58%,14.05%,
105/04/19,-13,0,0,-13,10904,0,376,11280,13.62%,14.09%,
105/04/18,5,-27,0,-22,10917,0,376,11293,13.64%,14.11%,
105/04/15,-43,-68,-1,-112,10912,0,376,11288,13.63%,14.10%,
105/04/14,-54,-10,-4,-68,10955,44,377,11376,13.69%,14.22%,
105/04/13,51,-15,-10,26,11009,54,381,11444,13.76%,14.30%,
105/04/12,-98,0,6,-92,10958,69,391,11418,13.69%,14.26%,
105/04/11,-462,-15,0,-477,11056,69,385,11510,13.81%,14.38%,
105/04/08,-220,-20,15,-225,11518,84,385,11987,14.39%,14.98%,
105/04/07,-90,-26,-6,-122,11738,104,370,12212,14.67%,15.26%,
105/04/06,-122,-20,0,-142,11828,130,376,12334,14.78%,15.41%,
105/04/01,-178,-15,0,-193,11950,150,376,12476,14.93%,15.59%,
105/03/31,-48,-90,-2,-140,12128,165,376,12669,15.15%,15.83%,
105/03/30,-100,-25,0,-125,12176,188,378,12742,15.21%,15.92%,
105/03/29,-88,-25,0,-113,12276,213,378,12867,15.34%,16.08%,
105/03/28,-23,-15,0,-38,12364,238,378,12980,15.45%,16.22%,
105/03/25,-36,0,0,-36,12387,253,378,13018,15.48%,16.27%,
105/03/24,-46,-45,0,-91,12423,253,378,13054,15.52%,16.31%,
105/03/23,-82,-20,-5,-107,12469,298,378,13145,15.58%,16.42%,
105/03/22,-19,0,-6,-25,12551,318,383,13252,15.68%,16.56%,
105/03/21,-66,0,0,-66,12570,318,389,13277,15.71%,16.59%,
105/03/18,-72,0,0,-72,12636,318,389,13343,15.79%,16.67%,
105/03/17,7,-15,-10,-18,12708,318,389,13415,15.88%,16.76%,
105/03/16,19,0,-4,15,12701,333,399,13433,15.87%,16.78%,
105/03/15,1,-45,-13,-57,12682,333,403,13418,15.85%,16.77%,
105/03/14,18,-45,0,-27,12671,378,416,13465,15.83%,16.82%,
105/03/11,-47,-34,2,-79,12653,423,416,13492,15.81%,16.86%,
105/03/10,-12,-15,-5,-32,12700,457,414,13571,15.87%,16.96%,
105/03/09,-6,-15,1,-20,12712,472,419,13603,15.88%,16.99%,
105/03/08,1,-15,2,-12,12718,487,418,13623,15.89%,17.02%,
105/03/07,-4,0,-8,-12,12717,502,416,13635,15.89%,17.04%,
105/03/04,30,0,0,30,12721,502,424,13647,15.90%,17.06%,
105/03/03,12,0,0,12,12691,502,424,13617,15.86%,17.02%,
105/03/02,10,-45,0,-35,12679,502,424,13605,15.84%,17.00%,
105/03/01,-21,0,0,-21,12669,547,424,13640,15.83%,17.04%,
105/02/26,8,-40,0,-32,12690,547,424,13661,15.86%,17.07%,
105/02/25,6,0,0,6,12682,587,424,13693,15.85%,17.11%,
105/02/24,-6,-44,-6,-56,12676,587,424,13687,15.84%,17.10%,
105/02/23,28,5,-18,15,12682,631,430,13743,15.85%,17.18%,
105/02/22,9,0,-4,5,12654,626,448,13728,15.81%,17.15%,
105/02/19,8,-35,-2,-29,12645,626,452,13723,15.80%,17.15%,
105/02/18,9,-30,-3,-24,12637,661,454,13752,15.79%,17.18%,
105/02/17,-42,-30,1,-71,12628,691,457,13776,15.78%,17.21%,
105/02/16,-55,-24,-10,-89,12670,721,456,13847,15.83%,17.30%,
105/02/15,15,-20,0,-5,12725,745,466,13936,15.90%,17.41%,
105/02/03,4,-25,0,-21,12710,765,466,13941,15.88%,17.42%,
105/02/02,0,-25,0,-25,12716,790,466,13972,15.89%,17.46%,
105/02/01,5,-20,0,-15,12716,815,466,13997,15.89%,17.49%,
105/01/30,0,5,0,5,12711,835,466,14012,15.88%,17.51%,
105/01/29,16,0,0,16,12711,830,466,14007,15.88%,17.50%,
105/01/28,-7,0,0,-7,12695,830,466,13991,15.86%,17.48%,
105/01/27,-22,-25,0,-47,12702,830,466,13998,15.87%,17.49%,
105/01/26,7,-25,3,-15,12724,855,466,14045,15.90%,17.55%,
105/01/25,5,-30,0,-25,12717,880,463,14060,15.89%,17.57%,
105/01/22,-4,0,0,-4,12712,910,463,14085,15.88%,17.60%,
105/01/21,-2,0,0,-2,12716,910,463,14089,15.89%,17.61%,
105/01/20,-1,-4,-1,-6,12718,910,463,14091,15.89%,17.61%,
105/01/19,-12,0,0,-12,12719,914,464,14097,15.89%,17.61%,
105/01/18,-20,0,-13,-33,12731,914,464,14109,15.91%,17.63%,
105/01/15,-36,-4,-1,-41,12751,914,477,14142,15.93%,17.67%,
105/01/14,-1,0,0,-1,12787,918,478,14183,15.98%,17.72%,
105/01/13,-71,0,0,-71,12788,918,478,14184,15.98%,17.72%,
105/01/12,-173,0,0,-173,12859,918,478,14255,16.07%,17.81%,
105/01/11,-160,-19,4,-175,13032,918,478,14428,16.28%,18.02%,
105/01/08,-84,0,10,-74,13192,937,474,14603,16.48%,18.24%,
105/01/07,-39,0,60,21,13276,937,464,14677,16.59%,18.34%,
105/01/06,5,0,0,5,13315,937,404,14656,16.64%,18.32%,
105/01/05,-4,0,0,-4,13310,937,404,14651,16.63%,18.31%,
105/01/04,2,0,0,2,13314,937,404,14655,16.64%,18.32%,
104/12/31,-26,35,0,9,13312,937,404,14653,16.63%,18.31%,
104/12/30,1,0,0,1,13338,740,404,14482,16.67%,18.10%,
104/12/29,5,28,0,33,13337,740,404,14481,16.67%,18.10%,
104/12/28,12,27,0,39,13332,712,404,14448,16.66%,18.05%,
104/12/25,-2,0,0,-2,13320,685,404,14409,16.64%,18.00%,
104/12/24,14,0,0,14,13322,685,404,14411,16.65%,18.01%,
104/12/23,-4,0,0,-4,13308,685,404,14397,16.63%,17.99%,
104/12/22,9,0,0,9,13312,685,404,14401,16.63%,17.99%,
104/12/21,26,0,1,27,13303,685,404,14392,16.62%,17.98%,
104/12/18,-21,0,-5,-26,13277,685,403,14365,16.59%,17.95%,
104/12/17,-40,0,4,-36,13298,685,408,14391,16.62%,17.99%,
104/12/16,-60,0,0,-60,13338,685,404,14427,16.67%,18.03%,
104/12/15,-123,0,11,-112,13398,685,404,14487,16.74%,18.10%,
104/12/14,-227,15,6,-206,13521,685,393,14599,16.90%,18.25%,
104/12/11,33,40,-5,68,13748,670,387,14805,17.18%,18.50%,
104/12/10,13,35,-12,36,13715,630,392,14737,17.14%,18.42%,
104/12/09,10,80,0,90,13692,595,404,14691,17.11%,18.36%,
104/12/08,-70,42,-6,-34,13682,515,404,14601,17.10%,18.25%,
104/12/07,-72,0,-11,-83,13752,473,410,14635,17.18%,18.28%,
104/12/04,-64,0,0,-64,13824,473,421,14718,17.27%,18.39%,
104/12/03,-25,-32,0,-57,13888,473,421,14782,17.35%,18.47%,
104/12/02,-24,-147,0,-171,13913,505,421,14839,17.39%,18.55%,
104/12/01,-31,0,0,-31,13937,652,421,15010,17.42%,18.76%,
104/11/30,-120,0,0,-120,13968,652,421,15041,17.45%,18.79%,
104/11/27,-127,0,0,-127,14088,652,421,15161,17.60%,18.94%,
104/11/26,-144,0,2,-142,14215,652,421,15288,17.76%,19.10%,
104/11/25,-97,0,16,-81,14359,652,419,15430,17.94%,19.28%,
104/11/24,-344,0,0,-344,14456,652,403,15511,18.06%,19.38%,
104/11/23,-272,10,-16,-278,14800,652,403,15855,18.49%,19.81%,
104/11/20,-60,0,0,-60,15072,642,419,16133,18.84%,20.17%,
104/11/19,-35,0,0,-35,15133,642,419,16194,18.91%,20.24%,
104/11/18,-86,0,0,-86,15168,642,419,16229,18.95%,20.28%,
104/11/17,-34,0,0,-34,15254,642,419,16315,19.06%,20.39%,
104/11/16,-76,0,-1,-77,15288,642,419,16349,19.10%,20.43%,
104/11/13,-27,0,0,-27,15364,642,420,16426,19.20%,20.53%,
104/11/12,-81,0,0,-81,15391,642,420,16453,19.23%,20.56%,
104/11/11,-53,0,0,-53,15472,642,420,16534,19.33%,20.66%,
104/11/10,-50,-21,0,-71,15525,642,420,16587,19.40%,20.73%,
104/11/09,-42,0,0,-42,15575,663,420,16658,19.46%,20.81%,
104/11/06,-136,0,0,-136,15617,663,420,16700,19.52%,20.87%,
104/11/05,-59,0,0,-59,15753,663,420,16836,19.69%,21.04%,
104/11/04,-22,2,0,-20,15812,663,420,16895,19.76%,21.11%,
104/11/03,-37,0,0,-37,15834,661,420,16915,19.79%,21.14%,
104/11/02,-108,-21,0,-129,15871,661,420,16952,19.83%,21.18%,
104/10/30,-161,-21,0,-182,15979,682,420,17081,19.97%,21.35%,
104/10/29,-337,-20,0,-357,16140,703,420,17263,20.17%,21.57%,
104/10/28,-74,0,0,-74,16477,723,420,17620,20.59%,22.02%,
104/10/27,-34,-20,0,-54,16551,723,420,17694,20.68%,22.11%,
104/10/26,-52,-20,-18,-90,16585,743,420,17748,20.73%,22.18%,
104/10/23,-53,-35,0,-88,16637,763,438,17838,20.79%,22.29%,
104/10/22,-68,-20,0,-88,16690,798,438,17926,20.86%,22.40%,
104/10/21,-35,-20,0,-55,16758,818,438,18014,20.94%,22.51%,
104/10/20,-39,0,0,-39,16793,838,438,18069,20.99%,22.58%,
104/10/19,-14,0,0,-14,16832,838,438,18108,21.03%,22.62%,
104/10/16,3,-20,0,-17,16846,838,438,18122,21.05%,22.64%,
104/10/15,-45,-20,0,-65,16843,858,438,18139,21.05%,22.67%,
104/10/14,3,-20,0,-17,16888,878,438,18204,21.10%,22.74%,
104/10/13,-1,-20,0,-21,16885,898,438,18221,21.10%,22.77%,
104/10/12,4,-10,20,14,16886,918,438,18242,21.10%,22.79%,
104/10/08,-13,0,11,-2,16882,928,418,18228,21.10%,22.78%,
104/10/07,2,0,0,2,16895,928,407,18230,21.11%,22.78%,
104/10/06,-26,0,0,-26,16893,928,407,18228,21.11%,22.78%,
104/10/05,6,0,1,7,16919,928,407,18254,21.14%,22.81%,
104/10/02,1,1,0,2,16913,928,406,18247,21.14%,22.81%,
104/10/01,-2,0,0,-2,16912,927,406,18245,21.13%,22.80%,
104/09/30,-14,0,0,-14,16914,927,406,18247,21.14%,22.81%,
104/09/25,0,0,0,0,16928,947,406,18281,21.15%,22.84%,
104/09/24,7,0,0,7,16928,947,406,18281,21.15%,22.84%,
104/09/23,6,0,0,6,16921,947,406,18274,21.15%,22.84%,
104/09/22,7,0,0,7,16915,947,406,18268,21.14%,22.83%,
104/09/21,-4,-23,0,-27,16908,947,406,18261,21.13%,22.82%,
104/09/18,38,-5,0,33,16912,970,406,18288,21.13%,22.85%,
104/09/17,6,0,0,6,16874,975,406,18255,21.09%,22.82%,
104/09/16,8,0,0,8,16868,975,406,18249,21.08%,22.81%,
104/09/15,7,0,0,7,16860,975,406,18241,21.07%,22.80%,
104/09/14,7,0,0,7,16853,975,406,18234,21.06%,22.79%,
104/09/11,15,0,-1,14,16846,975,406,18227,21.05%,22.78%,
104/09/10,11,0,0,11,16831,975,407,18213,21.03%,22.76%,
104/09/09,7,0,0,7,16820,975,407,18202,21.02%,22.75%,
104/09/08,-5,0,0,-5,16813,975,407,18195,21.01%,22.74%,
104/09/07,-1,0,0,-1,16818,975,407,18200,21.02%,22.75%,
104/09/04,-6,0,0,-6,16819,975,407,18201,21.02%,22.75%,
104/09/03,-6,0,0,-6,16825,975,407,18207,21.03%,22.76%,
104/09/02,-20,0,0,-20,16831,975,407,18213,21.03%,22.76%,
104/09/01,8,-5,0,3,16851,975,407,18233,21.06%,22.79%,
104/08/31,6,-3,0,3,16843,980,407,18230,21.05%,22.78%,
104/08/28,20,0,-1,19,16837,983,407,18227,21.04%,22.78%,
104/08/27,-5,0,-3,-8,16817,983,408,18208,21.02%,22.76%,
104/08/26,-13,0,0,-13,16822,983,411,18216,21.02%,22.76%,
104/08/25,-24,0,1,-23,16835,983,411,18229,21.04%,22.78%,
104/08/24,-34,0,-1,-35,16859,983,410,18252,21.07%,22.81%,
104/08/21,-8,0,0,-8,16893,983,411,18287,21.11%,22.85%,
104/08/20,4,35,-2,37,16902,983,411,18296,21.12%,22.86%,
104/08/19,-11,0,0,-11,16898,948,413,18259,21.12%,22.82%,
104/08/18,-3,0,0,-3,16909,948,413,18270,21.13%,22.83%,
104/08/17,-3,-5,-2,-10,16900,948,413,18261,21.12%,22.82%,
104/08/14,-9,-20,0,-29,16903,953,415,18271,21.12%,22.83%,
104/08/13,-10,0,0,-10,16911,973,415,18299,21.13%,22.86%,
104/08/12,-2,-37,3,-36,16921,973,415,18309,21.15%,22.88%,
104/08/11,-9,-200,-4,-213,16923,1010,412,18345,21.15%,22.93%,
104/08/10,-15,-50,-1,-66,16932,1210,416,18558,21.16%,23.19%,
104/08/07,1,0,0,1,16947,1260,417,18624,21.18%,23.28%,
104/08/06,-12,0,-1,-13,16946,1260,417,18623,21.18%,23.28%,
104/08/05,16,10,-3,23,16958,1260,418,18636,21.19%,23.29%,
104/08/04,-31,0,5,-26,16942,1250,421,18613,21.17%,23.26%,
104/08/03,-11,0,-2,-13,16973,1250,416,18639,21.21%,23.29%,
104/07/31,-20,0,1,-19,16984,1250,418,18652,21.22%,23.30%,
104/07/30,25,0,0,25,17004,1250,417,18671,21.25%,23.33%,
104/07/29,37,0,-1,36,16979,1250,417,18646,21.22%,23.30%,
104/07/28,79,1,2,82,16942,1250,418,18610,21.17%,23.25%,
104/07/27,21,0,5,26,16863,1249,416,18528,21.07%,23.15%,
104/07/24,61,1,0,62,16842,1249,411,18502,21.05%,23.12%,
104/07/23,-11,0,1,-10,16781,1248,411,18440,20.97%,23.04%,
104/07/22,1,5,1,7,16792,1248,410,18450,20.98%,23.05%,
104/07/21,-18,0,0,-18,16791,1243,409,18443,20.98%,23.04%,
104/07/20,21,10,0,31,16809,1243,409,18461,21.01%,23.07%,
104/07/17,-8,-12,0,-20,16788,1233,409,18430,20.98%,23.03%,
104/07/16,-7,0,0,-7,16796,1245,409,18450,20.99%,23.06%,
104/07/15,-15,20,0,5,16803,1245,409,18457,21.00%,23.07%,
104/07/14,22,0,-2,20,16818,1225,409,18452,21.02%,23.06%,
104/07/13,109,-110,-1,-2,16796,1225,411,18432,20.99%,23.03%,
104/07/09,65,-73,2,-6,16687,1335,412,18434,20.85%,23.03%,
104/07/08,-6,-23,-39,-68,16622,1408,410,18440,20.77%,23.04%,
104/07/07,-33,-60,-29,-122,16628,1431,449,18508,20.78%,23.13%,
104/07/06,-9,-60,-1,-70,16661,1491,478,18630,20.82%,23.28%,
104/07/03,-11,0,0,-11,16670,1551,479,18700,20.83%,23.37%,
104/07/02,-9,0,0,-9,16681,1551,479,18711,20.85%,23.39%,
104/07/01,6,0,-25,-19,16690,1551,479,18720,20.86%,23.40%,
104/06/30,-23,0,-2,-25,16684,1551,504,18739,20.85%,23.42%,
104/06/29,22,20,0,42,16707,1922,506,19135,20.88%,23.91%,
104/06/26,1,0,-2,-1,16685,1902,506,19093,20.85%,23.86%,
104/06/25,53,80,12,145,16684,1902,508,19094,20.85%,23.86%,
104/06/24,10,45,0,55,16631,1822,496,18949,20.78%,23.68%,
104/06/23,49,65,0,114,16621,1777,496,18894,20.77%,23.61%,
104/06/22,-8,34,0,26,16572,1712,496,18780,20.71%,23.47%,
104/06/18,6,0,10,16,16580,1678,496,18754,20.72%,23.44%,
104/06/17,23,80,12,115,16574,1678,486,18738,20.71%,23.41%,
104/06/16,30,45,0,75,16551,1598,474,18623,20.68%,23.27%,
104/06/15,-20,0,10,-10,16521,1553,474,18548,20.65%,23.18%,
104/06/12,-11,62,0,51,16541,1553,464,18558,20.67%,23.19%,
104/06/11,-40,5,5,-30,16552,1491,464,18507,20.68%,23.12%,
104/06/10,28,153,-5,176,16592,1486,459,18537,20.73%,23.16%,
104/06/09,-5,200,8,203,16564,1333,464,18361,20.70%,22.95%,
104/06/08,-19,227,20,228,16569,1133,456,18158,20.71%,22.70%,
104/06/05,-18,513,-19,476,16588,906,436,17930,20.73%,22.41%,
104/06/04,32,0,-124,-92,16606,393,455,17454,20.75%,21.81%,
104/06/03,-14,0,0,-14,16574,393,579,17546,20.71%,21.92%,
104/06/02,-31,0,-16,-47,16588,393,579,17560,20.73%,21.94%,
104/06/01,-40,0,0,-40,16619,393,595,17607,20.77%,22.00%,
104/05/29,-43,0,1,-42,16659,393,595,17647,20.82%,22.05%,
104/05/28,10,-5,5,10,16702,393,594,17689,20.87%,22.10%,
104/05/27,9,0,0,9,16692,398,589,17679,20.86%,22.09%,
104/05/26,-14,0,0,-14,16683,398,589,17670,20.85%,22.08%,
104/05/25,11,0,10,21,16697,398,589,17684,20.87%,22.10%,
104/05/22,-12,0,65,53,16629,398,579,17606,20.78%,22.00%,
104/05/21,-12,22,16,26,16641,398,514,17553,20.80%,21.94%,
104/05/20,12,0,80,92,16653,376,498,17527,20.81%,21.90%,
104/05/19,58,32,-1,89,16641,376,418,17435,20.80%,21.79%,
104/05/18,45,0,0,45,16583,344,419,17346,20.72%,21.67%,
104/05/15,71,0,-145,-74,16538,344,419,17301,20.67%,21.62%,
104/05/14,-2,11,10,19,16467,344,564,17375,20.58%,21.71%,
104/05/13,5,0,6,11,16469,333,554,17356,20.58%,21.69%,
104/05/12,6,0,0,6,16464,333,548,17345,20.57%,21.67%,
104/05/11,5,0,3,8,16458,333,548,17339,20.57%,21.67%,
104/05/08,5,0,4,9,16453,333,545,17331,20.56%,21.66%,
104/05/07,12,-16,0,-4,16448,333,541,17322,20.55%,21.64%,
104/05/06,15,0,2,17,16436,349,541,17326,20.54%,21.65%,
104/05/05,19,0,31,50,16421,349,539,17309,20.52%,21.63%,
104/05/04,-7,0,2,-5,16402,349,508,17259,20.50%,21.57%,
104/04/30,35,0,1,36,16409,349,506,17264,20.51%,21.58%,
104/04/29,20,0,5,25,16374,349,505,17228,20.46%,21.53%,
104/04/28,18,0,10,28,16354,349,500,17203,20.44%,21.50%,
104/04/27,23,0,21,44,16336,349,490,17175,20.41%,21.46%,
104/04/24,18,0,29,47,16313,349,469,17131,20.39%,21.41%,
104/04/23,8,0,31,39,16295,349,440,17084,20.36%,21.35%,
104/04/22,-6,0,0,-6,16287,349,409,17045,20.35%,21.30%,
104/04/21,-6,0,0,-6,16293,349,409,17051,20.36%,21.31%,
104/04/20,-2,0,1,-1,16299,349,409,17057,20.37%,21.32%,
104/04/17,1,0,0,1,16301,349,408,17058,20.37%,21.32%,
104/04/16,-6,0,5,-1,16300,349,408,17057,20.37%,21.32%,
104/04/15,-9,34,0,25,16306,349,403,17058,20.38%,21.32%,
104/04/14,12,0,15,27,16315,315,403,17033,20.39%,21.29%,
104/04/13,16,0,0,16,16303,315,388,17006,20.37%,21.25%,
104/04/10,0,0,0,0,16287,315,388,16990,20.35%,21.23%,
104/04/09,0,0,0,0,16287,315,388,16990,20.35%,21.23%,
104/04/08,0,0,0,0,16287,315,388,16990,20.35%,21.23%,
104/04/07,0,0,0,0,16287,315,388,16990,20.35%,21.23%,
104/04/02,-40,0,0,-40,16287,315,388,16990,20.35%,21.23%,
104/04/01,-3,0,0,-3,16327,315,388,17030,20.40%,21.28%,
104/03/31,-1,0,0,-1,16330,315,388,17033,20.41%,21.29%,
104/03/30,-1,0,0,-1,16331,322,388,17041,20.41%,21.30%,
104/03/27,10,0,0,10,16332,322,388,17042,20.41%,21.30%,
104/03/26,3,0,1,4,16336,322,388,17046,20.41%,21.30%,
104/03/25,1,0,1,2,16333,322,387,17042,20.41%,21.30%,
104/03/24,0,0,0,0,16332,322,386,17040,20.41%,21.29%,
104/03/23,0,0,13,13,16332,322,386,17040,20.41%,21.29%,
104/03/20,2,0,12,14,16332,322,373,17027,20.41%,21.28%,
104/03/19,1,0,0,1,16330,322,361,17013,20.41%,21.26%,
104/03/18,1,-13,0,-12,16326,322,361,17009,20.40%,21.25%,
104/03/17,1,0,15,16,16325,335,361,17021,20.40%,21.27%,
104/03/16,-1,13,2,14,16324,335,346,17005,20.40%,21.25%,
104/03/13,0,0,0,0,16325,322,344,16991,20.40%,21.23%,
104/03/12,4,0,0,4,16325,322,344,16991,20.40%,21.23%,
104/03/11,-11,0,0,-11,16321,322,344,16987,20.40%,21.23%,
104/03/10,1,0,-1,0,16332,322,344,16998,20.41%,21.24%,
104/03/09,-7,-1,0,-8,16331,322,345,16998,20.41%,21.24%,
104/03/06,-3,9,-2,4,16338,323,345,17006,20.42%,21.25%,
104/03/05,-9,0,0,-9,16341,314,347,17002,20.42%,21.25%,
104/03/04,6,1,113,120,16350,314,347,17011,20.43%,21.26%,
104/03/03,3,0,0,3,16344,313,234,16891,20.42%,21.10%,
104/03/02,0,0,0,0,16340,313,234,16887,20.42%,21.10%,
104/02/26,0,0,0,0,16340,313,234,16887,20.42%,21.10%,
104/02/25,-2,0,-1,-3,16340,313,234,16887,20.42%,21.10%,
104/02/24,0,0,0,0,16342,313,235,16890,20.42%,21.10%,
104/02/13,0,0,0,0,16342,313,235,16890,20.42%,21.10%,
104/02/12,-5,0,0,-5,16342,313,235,16890,20.42%,21.10%,
104/02/11,-2,0,0,-2,16347,313,235,16895,20.43%,21.11%,
104/02/10,5,0,4,9,16349,313,235,16897,20.43%,21.11%,
104/02/09,-7,0,10,3,16344,313,231,16888,20.42%,21.10%,
104/02/06,-3,0,0,-3,16351,313,221,16885,20.43%,21.10%,
104/02/05,0,0,30,30,16354,313,221,16888,20.44%,21.11%,
104/02/04,0,0,0,0,16354,313,191,16858,20.44%,21.07%,
104/02/03,-4,0,0,-4,16354,313,191,16858,20.44%,21.07%,
104/02/02,-2,0,0,-2,16358,313,191,16862,20.44%,21.07%,
104/01/30,-5,0,0,-5,16360,313,191,16864,20.44%,21.07%,
104/01/29,1,0,0,1,16365,313,191,16869,20.45%,21.08%,
104/01/28,7,0,0,7,16364,313,191,16868,20.45%,21.08%,
104/01/27,1,0,0,1,16357,313,191,16861,20.44%,21.07%,
104/01/26,0,6,0,6,16356,313,191,16860,20.44%,21.07%,
104/01/23,2,0,0,2,16356,307,191,16854,20.44%,21.06%,
104/01/22,4,0,0,4,16354,307,191,16852,20.44%,21.06%,
104/01/21,3,0,-7,-4,16350,307,191,16848,20.43%,21.05%,
104/01/20,6,0,-5,1,16347,307,198,16852,20.43%,21.06%,
104/01/19,0,0,0,0,16341,307,203,16851,20.42%,21.06%,
104/01/16,-5,0,0,-5,16341,307,203,16851,20.42%,21.06%,
104/01/15,-11,0,-6,-17,16346,307,203,16856,20.43%,21.07%,
104/01/14,-13,0,11,-2,16357,307,209,16873,20.44%,21.08%,
104/01/13,-3,0,-12,-15,16370,307,198,16875,20.46%,21.09%,
104/01/12,-2,0,0,-2,16373,307,210,16890,20.46%,21.11%,
104/01/09,4,0,0,4,16375,307,210,16892,20.46%,21.11%,
104/01/08,-4,0,-1,-5,16371,307,210,16888,20.46%,21.11%,
104/01/07,-4,0,0,-4,16375,307,211,16893,20.46%,21.11%,
104/01/06,-2,0,-2,-4,16379,307,211,16897,20.47%,21.12%,
104/01/05,-14,0,15,1,16381,307,213,16901,20.47%,21.12%,
