日期,外資買賣超,投信買賣超,自營商買賣超,單日合計買賣超,外資估計持股,投信估計持股,自營商估計持股,單日合計估計持股,外資持股比重,三大法人持股比重,
107/03/31,0,20,1,21,19217,393,1027,20637,8.45%,9.07%,
107/03/30,9,20,-20,9,19217,373,1026,20616,8.45%,9.07%,
107/03/29,-37,20,-5,-22,19208,353,1046,20607,8.44%,9.06%,
107/03/28,-77,30,-32,-79,19224,333,1051,20608,8.45%,9.06%,
107/03/27,129,30,23,182,19301,303,1083,20687,8.48%,9.09%,
107/03/26,43,30,0,73,19172,273,1060,20505,8.43%,9.02%,
107/03/23,-117,30,-113,-200,19129,243,1060,20432,8.41%,8.98%,
107/03/22,-266,40,57,-169,19246,213,1173,20632,8.46%,9.07%,
107/03/21,-153,0,-6,-159,19512,173,1116,20801,8.58%,9.15%,
107/03/20,-45,20,-104,-129,19665,173,1122,20960,8.64%,9.21%,
107/03/19,-17,0,13,-4,19720,153,1226,21099,8.67%,9.28%,
107/03/16,-142,0,-152,-294,19737,153,1213,21103,8.67%,9.27%,
107/03/15,14,0,179,193,20379,153,1365,21897,8.96%,9.63%,
107/03/14,161,30,-51,140,20384,153,1186,21723,8.96%,9.55%,
107/03/13,149,0,13,162,20223,123,1237,21583,8.89%,9.49%,
107/03/12,123,0,-20,103,20074,123,1224,21421,8.82%,9.41%,
107/03/09,32,40,-62,10,19951,123,1244,21318,8.77%,9.37%,
107/03/08,157,40,-70,127,19919,83,1306,21308,8.75%,9.36%,
107/03/07,-9,40,-29,2,19762,43,1376,21181,8.69%,9.31%,
107/03/06,-164,0,-53,-217,19771,3,1405,21179,8.69%,9.31%,
107/03/05,24,0,14,38,19935,3,1458,21396,8.76%,9.40%,
107/03/02,-118,0,-72,-190,19911,3,1444,21358,8.75%,9.39%,
107/03/01,82,0,51,133,20030,3,1516,21549,8.80%,9.47%,
107/02/27,-205,0,-264,-469,19948,3,1465,21416,8.77%,9.42%,
107/02/26,-367,0,588,221,20153,3,1729,21885,8.86%,9.62%,
107/02/23,-120,0,1,-119,20520,3,1141,21664,9.02%,9.52%,
107/02/22,-61,0,104,43,20642,3,1140,21785,9.07%,9.57%,
107/02/21,199,0,-6,193,20701,3,1036,21740,9.10%,9.56%,
107/02/12,-338,0,-32,-370,20502,3,1042,21547,9.01%,9.47%,
107/02/09,-156,0,-158,-314,20819,3,1074,21896,9.15%,9.62%,
107/02/08,95,0,179,274,20965,3,1232,22200,9.21%,9.75%,
107/02/07,374,0,-39,335,20870,3,1053,21926,9.17%,9.63%,
107/02/06,-290,0,-240,-530,20496,3,1092,21591,9.01%,9.49%,
107/02/05,-30,0,-120,-150,20786,3,1332,22121,9.14%,9.73%,
107/02/02,-48,0,16,-32,20816,3,1452,22271,9.15%,9.79%,
107/02/01,-245,0,-13,-258,20864,3,1436,22303,9.17%,9.80%,
107/01/31,64,0,-6,58,21109,3,1449,22561,9.28%,9.92%,
107/01/30,-308,0,-125,-433,21195,3,1455,22653,9.32%,9.96%,
107/01/29,83,0,101,184,21503,3,1580,23086,9.45%,10.15%,
107/01/26,-128,0,-27,-155,21420,3,1479,22902,9.41%,10.06%,
107/01/25,-115,0,-50,-165,21548,3,1506,23057,9.47%,10.13%,
107/01/24,-81,0,-51,-132,21663,3,1556,23222,9.52%,10.21%,
107/01/23,-70,0,-29,-99,21759,3,1607,23369,9.56%,10.27%,
107/01/22,137,0,-153,-16,21829,3,1636,23468,9.59%,10.31%,
107/01/19,-499,-1050,-330,-1879,21692,3,1789,23484,9.53%,10.32%,
107/01/18,-85,0,-70,-155,22191,1053,2119,25363,9.75%,11.14%,
107/01/17,-67,0,-72,-139,22276,1053,2189,25518,9.79%,11.22%,
107/01/16,24,0,-30,-6,22343,1053,2261,25657,9.82%,11.28%,
107/01/15,-148,0,-62,-210,22319,1053,2291,25663,9.81%,11.28%,
107/01/12,66,0,51,117,22467,1053,2353,25873,9.88%,11.38%,
107/01/11,51,0,-86,-35,22386,1053,2302,25741,9.84%,11.32%,
107/01/10,-249,0,-200,-449,22335,1053,2388,25776,9.82%,11.33%,
107/01/09,127,0,-174,-47,23127,1053,2588,26768,10.17%,11.77%,
107/01/08,183,0,-434,-251,23000,1053,2762,26815,10.11%,11.79%,
107/01/05,-132,0,57,-75,23013,1053,3196,27262,10.12%,11.99%,
107/01/04,507,0,-35,472,23549,1053,3139,27741,10.35%,12.19%,
107/01/03,-84,0,585,501,23042,1053,3174,27269,10.13%,11.99%,
107/01/02,441,0,188,629,23126,1053,2589,26768,10.17%,11.77%,
106/12/29,69,0,-23,46,22685,1053,2401,26139,9.97%,11.49%,
106/12/28,49,0,15,64,22616,1050,2424,26090,9.94%,11.47%,
106/12/27,9,0,-27,-18,22894,1050,2409,26353,10.06%,11.58%,
106/12/26,-123,0,-73,-196,22885,1050,2436,26371,10.06%,11.59%,
106/12/25,-41,0,-15,-56,23008,1050,2509,26567,10.11%,11.68%,
106/12/22,226,0,70,296,23049,1050,2524,26623,10.13%,11.70%,
106/12/21,1058,0,6,1064,23115,1050,2454,26619,10.16%,11.70%,
106/12/20,466,0,-61,405,22057,1050,2448,25555,9.69%,11.23%,
106/12/19,-30,0,-112,-142,21707,1050,2509,25266,9.54%,11.11%,
106/12/18,-95,0,23,-72,21737,1050,2621,25408,9.55%,11.16%,
106/12/15,-185,0,-159,-344,22062,1050,2598,25710,9.70%,11.30%,
106/12/14,93,0,142,235,22247,1050,2757,26054,9.78%,11.45%,
106/12/13,-290,0,23,-267,22154,1050,2615,25819,9.74%,11.35%,
106/12/12,-336,0,-11,-347,22437,1050,2592,26079,9.86%,11.46%,
106/12/11,602,0,218,820,22773,1050,2603,26426,10.01%,11.62%,
106/12/08,234,0,-2,232,22171,1050,2385,25606,9.75%,11.26%,
106/12/07,255,0,-96,159,21937,1050,2387,25374,9.64%,11.15%,
106/12/06,279,0,-34,245,21682,1050,2483,25215,9.53%,11.08%,
106/12/05,-269,0,-317,-586,21703,1050,2517,25270,9.54%,11.11%,
106/12/04,435,0,-29,406,21972,1050,2834,25856,9.66%,11.37%,
106/12/01,1072,0,197,1269,21537,1050,2863,25450,9.47%,11.19%,
106/11/30,709,0,-809,-100,20465,1050,2666,24181,8.99%,10.62%,
106/11/29,4,0,251,255,19756,1050,3475,24281,8.68%,10.67%,
106/11/28,352,0,-11,341,19752,1050,3224,24026,8.68%,10.56%,
106/11/27,617,0,-173,444,19400,1050,3235,23685,8.53%,10.41%,
106/11/24,-226,0,404,178,18783,1050,3408,23241,8.26%,10.22%,
106/11/23,452,0,312,764,19009,1050,3004,23063,8.35%,10.13%,
106/11/22,-511,0,88,-423,18557,1050,2692,22299,8.16%,9.81%,
106/11/21,1281,0,189,1470,19068,1050,2604,22722,8.38%,9.99%,
106/11/20,164,0,-86,78,17787,1050,2415,21252,7.82%,9.34%,
106/11/17,-49,0,-21,-70,17623,1050,2501,21174,7.74%,9.30%,
106/11/16,661,0,-65,596,17661,1050,2522,21233,7.76%,9.33%,
106/11/15,-183,0,371,188,16999,1050,2587,20636,7.47%,9.07%,
106/11/14,275,0,-101,174,17178,1050,2216,20444,7.55%,8.99%,
106/11/13,-741,0,-191,-932,16903,1050,2317,20270,7.43%,8.91%,
106/11/10,51,0,-36,15,17631,1050,2508,21189,7.75%,9.31%,
106/11/09,-226,0,-203,-429,17453,1050,2544,21047,7.67%,9.25%,
106/11/08,-127,0,-479,-606,17623,1050,2747,21420,7.74%,9.41%,
106/11/07,-463,0,-782,-1245,17718,1050,3226,21994,7.79%,9.67%,
106/11/06,-617,0,234,-383,18055,1050,4008,23113,7.93%,10.15%,
106/11/03,178,0,1055,1233,18530,1050,3774,23354,8.14%,10.26%,
106/11/02,-644,0,-522,-1166,18186,1050,2719,21955,7.99%,9.65%,
106/11/01,88,0,769,857,18589,1050,3241,22880,8.17%,10.06%,
106/10/31,-97,0,-72,-169,18410,1050,2472,21932,8.09%,9.64%,
106/10/30,100,0,12,112,18371,1050,2544,21965,8.07%,9.65%,
106/10/27,-120,0,-250,-370,18429,1050,2532,22011,8.10%,9.68%,
106/10/26,-638,0,-510,-1148,18429,1050,2782,22261,8.10%,9.79%,
106/10/25,139,0,888,1027,18917,1050,3292,23259,8.31%,10.22%,
106/10/24,146,0,167,313,18769,1050,2404,22223,8.25%,9.77%,
106/10/23,1,0,-52,-51,18573,1050,2237,21860,8.16%,9.61%,
106/10/20,68,0,-192,-124,18522,1050,2289,21861,8.14%,9.61%,
106/10/19,-66,0,-597,-663,18452,1050,2481,21983,8.11%,9.66%,
106/10/18,-358,0,537,179,18456,1050,3078,22584,8.11%,9.93%,
106/10/17,229,0,-240,-11,18785,1050,2541,22376,8.26%,9.84%,
106/10/16,-353,0,-779,-1132,18556,1050,2781,22387,8.16%,9.84%,
106/10/13,471,350,254,1075,18909,1050,3560,23519,8.31%,10.34%,
106/10/12,1003,0,984,1987,18310,700,3306,22316,8.05%,9.81%,
106/10/11,221,0,-118,103,17307,700,2322,20329,7.61%,8.94%,
106/10/06,-356,0,-106,-462,17086,700,2440,20226,7.51%,8.89%,
106/10/05,228,0,389,617,17442,700,2546,20688,7.67%,9.10%,
106/10/03,110,0,-58,52,17366,700,2157,20223,7.63%,8.89%,
106/10/02,-94,0,-634,-728,17244,700,2215,20159,7.58%,8.86%,
106/09/30,150,0,1033,1183,17151,700,2849,20700,7.54%,9.10%,
106/09/29,-174,700,-271,255,17021,700,1816,19537,7.48%,8.59%,
106/09/28,-58,0,429,371,16815,0,2087,18902,7.39%,8.31%,
106/09/27,318,0,133,451,16873,0,1658,18531,7.42%,8.15%,
106/09/26,739,0,-381,358,16555,0,1525,18080,7.28%,7.95%,
106/09/25,-199,0,129,-70,15816,0,1906,17722,6.95%,7.79%,
106/09/22,-173,0,-764,-937,16018,0,1777,17795,7.04%,7.82%,
106/09/21,9,0,732,741,16191,0,2541,18732,7.12%,8.24%,
106/09/20,573,0,-23,550,16182,0,1809,17991,7.11%,7.91%,
106/09/19,-129,0,-846,-975,15609,0,1832,17441,6.86%,7.67%,
106/09/18,195,0,736,931,15738,0,2678,18416,6.92%,8.10%,
106/09/15,452,0,-243,209,15543,0,1942,17485,6.83%,7.68%,
106/09/14,280,0,-507,-227,15091,0,2185,17276,6.63%,7.59%,
106/09/13,1038,0,404,1442,15059,0,2692,17751,6.62%,7.80%,
106/09/12,609,0,505,1114,13947,0,2288,16235,6.13%,7.14%,
106/09/11,102,0,325,427,13317,0,1783,15100,5.85%,6.63%,
106/09/08,487,0,289,776,13209,0,1458,14667,5.80%,6.44%,
106/09/07,187,0,-13,174,12722,0,1169,13891,5.59%,6.10%,
106/09/06,232,0,-214,18,12535,0,1182,13717,5.51%,6.03%,
106/09/05,36,0,154,190,12303,0,1396,13699,5.41%,6.02%,
106/09/04,44,0,33,77,12001,0,1242,13243,5.27%,5.82%,
106/09/01,150,0,-21,129,10457,0,1209,11666,4.59%,5.12%,
106/08/31,209,0,-139,70,10307,0,1230,11537,4.53%,5.07%,
106/08/30,6,0,-594,-588,10098,0,1369,11467,4.44%,5.04%,
106/08/29,-142,0,441,299,9892,0,1963,11855,4.35%,5.21%,
106/08/28,-220,0,685,465,9984,0,1522,11506,4.39%,5.06%,
106/08/25,-10,0,8,-2,10194,0,837,11031,4.48%,4.85%,
106/08/24,27,0,-100,-73,10204,0,829,11033,4.48%,4.84%,
106/08/23,88,0,-13,75,10177,0,929,11106,4.47%,4.88%,
106/08/22,-48,0,139,91,10089,0,942,11031,4.43%,4.84%,
106/08/21,-3,0,74,71,10137,0,803,10940,4.45%,4.80%,
106/08/18,-322,0,-12,-334,10140,0,729,10869,4.45%,4.77%,
106/08/17,204,0,14,218,10462,0,741,11203,4.60%,4.93%,
106/08/16,10,0,-1,9,9758,0,727,10485,4.29%,4.61%,
106/08/15,-10,0,-33,-43,9721,0,728,10449,4.27%,4.59%,
106/08/14,33,0,-68,-35,9702,0,761,10463,4.26%,4.59%,
106/08/11,96,0,-25,71,9669,0,829,10498,4.25%,4.61%,
106/08/10,43,0,-2,41,9573,0,854,10427,4.20%,4.58%,
106/08/09,-13,0,-6,-19,9530,0,856,10386,4.19%,4.57%,
106/08/08,24,0,-17,7,9543,0,862,10405,4.19%,4.57%,
106/08/07,42,0,-1,41,9519,0,879,10398,4.18%,4.57%,
106/08/04,0,0,0,0,9477,0,880,10357,4.16%,4.55%,
106/08/03,0,0,-16,-16,9421,0,880,10301,4.14%,4.53%,
106/08/02,42,0,-71,-29,9421,0,896,10317,4.14%,4.53%,
106/08/01,5,0,114,119,9379,0,967,10346,4.12%,4.55%,
106/07/31,-50,0,44,-6,9366,0,853,10219,4.11%,4.49%,
106/07/28,-195,0,-19,-214,9266,0,809,10075,4.07%,4.43%,
106/07/27,1051,0,-92,959,9477,0,828,10305,4.16%,4.52%,
106/07/26,-601,0,44,-557,8426,0,920,9346,3.70%,4.10%,
106/07/25,-271,0,2,-269,9044,0,876,9920,3.97%,4.36%,
106/07/24,-428,0,-1,-429,9372,0,874,10246,4.12%,4.50%,
106/07/21,-27,0,-2,-29,9801,0,875,10676,4.31%,4.69%,
106/07/20,-184,0,-1,-185,9828,0,877,10705,4.32%,4.71%,
106/07/19,-22,0,5,-17,9994,0,878,10872,4.39%,4.78%,
106/07/18,150,0,-1,149,10016,0,873,10889,4.40%,4.78%,
106/07/17,128,0,0,128,9886,0,874,10760,4.34%,4.72%,
106/07/14,106,0,0,106,9758,0,874,10632,4.29%,4.67%,
106/07/13,46,0,-15,31,9652,0,874,10526,4.24%,4.62%,
106/07/12,0,0,-15,-15,9676,0,889,10565,4.25%,4.64%,
106/07/11,-13,0,-2,-15,9676,0,904,10580,4.25%,4.65%,
106/07/10,-161,0,-24,-185,9689,0,906,10595,4.26%,4.66%,
106/07/07,-75,0,-121,-196,9850,0,930,10780,4.33%,4.74%,
106/07/06,60,0,225,285,9925,0,1051,10976,4.36%,4.82%,
106/07/05,11,0,31,42,9865,0,826,10691,4.33%,4.69%,
106/07/04,7,0,-63,-56,9803,0,795,10598,4.31%,4.66%,
106/07/03,59,0,-36,23,9796,0,858,10654,4.30%,4.68%,
106/06/30,57,0,-13,44,9737,0,894,10631,4.28%,4.67%,
106/06/29,-60,0,-19,-79,9680,0,907,10587,4.25%,4.65%,
106/06/28,57,0,-4,53,9740,0,926,10666,4.28%,4.69%,
106/06/27,20,0,-13,7,9683,0,930,10613,4.25%,4.66%,
106/06/26,78,0,33,111,9663,0,943,10606,4.24%,4.65%,
106/06/23,26,0,-45,-19,9585,0,910,10495,4.21%,4.61%,
106/06/22,21,0,128,149,9559,0,955,10514,4.20%,4.62%,
106/06/21,1,0,4,5,9534,0,827,10361,4.19%,4.55%,
106/06/20,-28,0,0,-28,9532,0,823,10355,4.19%,4.55%,
106/06/19,-136,0,13,-123,9560,0,823,10383,4.20%,4.56%,
106/06/16,-85,0,-2,-87,9803,0,810,10613,4.31%,4.67%,
106/06/15,-256,0,4,-252,9893,0,812,10705,4.35%,4.71%,
106/06/14,-128,0,-66,-194,10042,0,808,10850,4.41%,4.77%,
106/06/13,-59,0,-21,-80,10170,0,874,11044,4.47%,4.85%,
106/06/12,-67,0,4,-63,10229,0,895,11124,4.49%,4.88%,
106/06/09,-56,0,-32,-88,10384,0,891,11275,4.56%,4.95%,
106/06/08,-55,0,-17,-72,10428,0,923,11351,4.58%,4.99%,
106/06/07,104,0,-27,77,10376,0,940,11316,4.56%,4.97%,
106/06/06,-36,0,-39,-75,10272,0,967,11239,4.51%,4.94%,
106/06/05,-178,0,49,-129,10380,0,1006,11386,4.56%,5.00%,
106/06/03,0,0,-79,-79,10443,0,957,11400,4.59%,5.01%,
106/06/02,120,0,168,288,10443,0,1036,11479,4.59%,5.05%,
106/06/01,36,0,-4,32,10323,0,868,11191,4.53%,4.91%,
106/05/31,72,0,-10,62,10287,0,872,11159,4.52%,4.90%,
106/05/26,-87,0,-6,-93,10215,0,882,11097,4.49%,4.88%,
106/05/25,131,-50,-3,78,10302,0,888,11190,4.53%,4.92%,
106/05/24,77,-30,0,47,10212,49,891,11152,4.49%,4.90%,
106/05/23,54,0,0,54,10156,79,891,11126,4.46%,4.89%,
106/05/22,69,0,2,71,10040,79,891,11010,4.41%,4.84%,
106/05/19,-89,0,0,-89,9943,79,889,10911,4.37%,4.80%,
106/05/18,72,0,-50,22,10032,79,889,11000,4.41%,4.84%,
106/05/17,135,-100,16,51,9960,79,939,10978,4.38%,4.83%,
106/05/16,-28,-300,28,-300,9825,179,923,10927,4.32%,4.80%,
106/05/15,-90,0,-6,-96,9853,479,895,11227,4.33%,4.93%,
106/05/12,-219,0,24,-195,9943,479,901,11323,4.37%,4.98%,
106/05/11,-94,0,-8,-102,10162,479,877,11518,4.46%,5.06%,
106/05/10,275,0,4,279,10256,479,885,11620,4.51%,5.11%,
106/05/09,121,0,-69,52,9981,479,881,11341,4.38%,4.98%,
106/05/08,94,0,-8,86,9860,479,950,11289,4.33%,4.96%,
106/05/05,187,0,-66,121,9766,479,958,11203,4.29%,4.92%,
106/05/04,239,0,28,267,9579,479,1024,11082,4.21%,4.87%,
106/05/03,162,0,-15,147,9340,479,996,10815,4.10%,4.75%,
106/05/02,99,0,-45,54,9178,479,1011,10668,4.03%,4.69%,
106/04/28,105,0,23,128,9079,479,1056,10614,3.99%,4.67%,
106/04/27,60,0,-32,28,8964,479,1033,10476,3.94%,4.60%,
106/04/26,211,-50,144,305,8904,479,1065,10448,3.91%,4.59%,
106/04/25,52,-54,-15,-17,8693,529,921,10143,3.82%,4.46%,
106/04/24,-37,-36,-16,-89,8641,583,936,10160,3.80%,4.47%,
106/04/21,-68,-50,-28,-146,8678,619,952,10249,3.81%,4.50%,
106/04/20,-121,-50,72,-99,8746,669,980,10395,3.84%,4.57%,
106/04/19,11,0,-17,-6,8867,719,908,10494,3.89%,4.61%,
106/04/18,90,0,-24,66,8857,719,925,10501,3.89%,4.61%,
106/04/17,-72,0,-80,-152,8770,719,949,10438,3.85%,4.58%,
106/04/14,-392,0,-67,-459,8842,719,1029,10590,3.88%,4.65%,
106/04/13,-187,0,23,-164,9234,719,1096,11049,4.06%,4.86%,
106/04/12,-268,0,-101,-369,9421,719,1073,11213,4.14%,4.93%,
106/04/11,-381,0,-78,-459,9689,719,1174,11582,4.26%,5.09%,
106/04/10,-308,0,-1,-309,10069,719,1252,12040,4.42%,5.29%,
106/04/07,-134,0,-298,-432,10378,719,1253,12350,4.56%,5.43%,
106/04/06,-258,0,-5,-263,10512,719,1551,12782,4.62%,5.62%,
106/04/05,505,0,-41,464,10770,719,1556,13045,4.73%,5.73%,
106/03/31,-124,0,-525,-649,10265,719,1597,12581,4.51%,5.53%,
106/03/30,35,0,373,408,10389,0,2122,12511,4.56%,5.49%,
106/03/29,7,0,211,218,10354,0,1749,12103,4.55%,5.32%,
106/03/28,-166,0,-70,-236,10347,0,1538,11885,4.55%,5.23%,
106/03/27,-23,0,-138,-161,10513,0,1608,12121,4.62%,5.33%,
106/03/24,-3,0,-65,-68,10536,0,1746,12282,4.63%,5.40%,
106/03/23,67,0,-18,49,10539,0,1811,12350,4.63%,5.43%,
106/03/22,60,0,169,229,10472,0,1829,12301,4.60%,5.40%,
106/03/21,104,0,-49,55,10411,0,1660,12071,4.57%,5.30%,
106/03/20,-159,0,-76,-235,10307,0,1709,12016,4.53%,5.28%,
106/03/17,132,0,82,214,10466,0,1785,12251,4.60%,5.38%,
106/03/16,-106,0,11,-95,10334,0,1703,12037,4.54%,5.29%,
106/03/15,-173,0,-96,-269,10440,0,1692,12132,4.59%,5.33%,
106/03/14,259,0,-7,252,10603,0,1788,12391,4.66%,5.45%,
106/03/13,176,0,252,428,10344,0,1795,12139,4.54%,5.33%,
106/03/10,-5,0,-96,-101,10168,0,1543,11711,4.47%,5.15%,
106/03/09,-40,0,-42,-82,10173,0,1639,11812,4.47%,5.19%,
106/03/08,-43,0,7,-36,10213,0,1681,11894,4.49%,5.23%,
106/03/07,-221,0,-180,-401,10636,0,1674,12310,4.67%,5.41%,
106/03/06,-202,0,11,-191,10857,0,1854,12711,4.77%,5.59%,
106/03/03,-184,0,9,-175,11059,0,1843,12902,4.86%,5.67%,
106/03/02,-121,0,-720,-841,11244,0,1834,13078,4.94%,5.75%,
106/03/01,-116,-137,791,538,11365,0,2554,13919,4.99%,6.11%,
106/02/24,114,0,2,116,11481,0,1763,13244,5.04%,5.82%,
106/02/23,126,0,-273,-147,11367,0,1761,13128,4.99%,5.76%,
106/02/22,89,0,90,179,11241,0,2034,13275,4.94%,5.83%,
106/02/21,139,0,-117,22,11152,0,1944,13096,4.90%,5.75%,
106/02/20,193,0,-279,-86,11013,0,2061,13074,4.84%,5.75%,
106/02/18,10,0,-329,-319,10820,0,2340,13160,4.75%,5.78%,
106/02/17,46,0,-956,-910,10810,0,2669,13479,4.75%,5.92%,
106/02/16,265,0,2270,2535,10764,0,3625,14389,4.73%,6.32%,
106/02/15,297,0,12,309,10499,0,1355,11854,4.61%,5.21%,
106/02/14,69,0,-141,-72,10202,0,1343,11545,4.48%,5.07%,
106/02/13,201,-150,34,85,10133,0,1484,11617,4.45%,5.10%,
106/02/10,129,-365,99,-137,9932,0,1450,11382,4.36%,5.00%,
106/02/09,233,0,-44,189,9947,7,1351,11305,4.37%,4.97%,
106/02/08,61,-110,7,-42,9806,7,1395,11208,4.31%,4.93%,
106/02/07,12,-200,-122,-310,9744,117,1388,11249,4.28%,4.94%,
106/02/06,122,0,125,247,9732,317,1510,11559,4.27%,5.07%,
106/02/03,186,-330,-12,-156,9613,317,1385,11315,4.22%,4.97%,
106/02/02,45,-398,-6,-359,9412,647,1397,11456,4.13%,5.03%,
106/01/24,-24,0,-33,-57,9367,1045,1403,11815,4.11%,5.19%,
106/01/23,-25,0,-56,-81,9007,1045,1436,11488,3.96%,5.05%,
106/01/20,-110,0,127,17,9014,1045,1492,11551,3.96%,5.08%,
106/01/19,-179,-76,48,-207,9109,1045,1365,11519,4.00%,5.06%,
106/01/18,-284,0,-38,-322,9288,1121,1317,11726,4.08%,5.15%,
106/01/17,-208,-64,-52,-324,9572,1121,1355,12048,4.20%,5.29%,
106/01/16,-116,-109,22,-203,9781,1185,1407,12373,4.30%,5.44%,
106/01/13,-154,-65,-66,-285,9897,1294,1385,12576,4.35%,5.53%,
106/01/12,-1197,-380,-38,-1615,10051,1359,1451,12861,4.41%,5.65%,
106/01/11,-138,0,-153,-291,11247,1739,1489,14475,4.94%,6.36%,
106/01/10,-13,0,-167,-180,11351,1739,1642,14732,4.99%,6.48%,
106/01/09,-136,0,-49,-185,11364,1739,1809,14912,4.99%,6.55%,
106/01/06,-229,0,-179,-408,11501,1739,1858,15098,5.05%,6.63%,
106/01/05,-391,0,659,268,11729,1739,2037,15505,5.15%,6.81%,
106/01/04,-487,0,-417,-904,12110,1739,1378,15227,5.32%,6.69%,
106/01/03,320,0,561,881,12596,1739,1795,16130,5.53%,7.08%,
105/12/30,17,0,-32,-15,12276,1739,1234,15249,5.39%,6.70%,
105/12/29,0,0,-218,-218,12259,1739,1266,15264,5.39%,6.71%,
105/12/28,24,0,302,326,12259,1739,1484,15482,5.39%,6.81%,
105/12/27,-41,0,-71,-112,12235,1739,1182,15156,5.38%,6.66%,
105/12/26,-267,0,90,-177,12276,1739,1253,15268,5.39%,6.71%,
105/12/23,-69,0,-36,-105,12543,1739,1163,15445,5.51%,6.79%,
105/12/22,-24,0,13,-11,12612,1739,1199,15550,5.54%,6.83%,
105/12/21,-135,0,17,-118,12636,1739,1186,15561,5.55%,6.84%,
105/12/20,-41,0,-58,-99,12805,1739,1169,15713,5.63%,6.91%,
105/12/19,-152,0,11,-141,12846,1739,1227,15812,5.64%,6.94%,
105/12/16,-35,0,-12,-47,12998,1739,1216,15953,5.71%,7.01%,
105/12/15,-187,0,-166,-353,13033,1739,1228,16000,5.73%,7.03%,
105/12/14,-321,0,230,-91,13220,1739,1394,16353,5.81%,7.19%,
105/12/13,-63,0,-14,-77,13541,1739,1164,16444,5.95%,7.23%,
105/12/12,59,0,-11,48,13604,1739,1178,16521,5.98%,7.26%,
105/12/09,49,0,-67,-18,13545,1739,1189,16473,5.95%,7.24%,
105/12/08,5,0,32,37,13496,1739,1256,16491,5.93%,7.25%,
105/12/07,5,0,1,6,13491,1739,1224,16454,5.93%,7.23%,
105/12/06,-34,0,0,-34,13486,1739,1223,16448,5.93%,7.23%,
105/12/05,-39,0,-16,-55,13520,1739,1223,16482,5.94%,7.24%,
105/12/02,-76,0,-17,-93,13559,1739,1239,16537,5.96%,7.27%,
105/12/01,192,0,42,234,13635,1739,1256,16630,5.99%,7.31%,
105/11/30,-140,0,-133,-273,13443,1739,1214,16396,5.91%,7.21%,
105/11/29,-224,0,212,-12,13583,1739,1347,16669,5.97%,7.33%,
105/11/28,-146,0,-44,-190,13807,1739,1135,16681,6.07%,7.33%,
105/11/25,-32,0,150,118,13919,1739,1179,16837,6.12%,7.40%,
105/11/24,29,0,-23,6,13951,1739,1029,16719,6.13%,7.35%,
105/11/23,-397,0,-75,-472,13922,1739,1052,16713,6.12%,7.35%,
105/11/22,-516,0,13,-503,14319,1739,1127,17185,6.29%,7.55%,
105/11/21,-195,0,73,-122,14835,1739,1114,17688,6.52%,7.77%,
105/11/18,-313,0,-30,-343,15030,1739,1041,17810,6.60%,7.82%,
105/11/17,-26,-175,-114,-315,15343,1739,1071,18153,6.74%,7.98%,
105/11/16,-268,0,138,-130,15369,1914,1185,18468,6.75%,8.11%,
105/11/15,-15,-500,7,-508,15637,1914,1047,18598,6.87%,8.17%,
105/11/14,-221,-645,112,-754,15652,2414,1040,19106,6.88%,8.40%,
105/11/11,-876,-1338,-46,-2260,15873,3059,928,19860,6.98%,8.73%,
105/11/10,261,-460,51,-148,16749,4397,974,22120,7.36%,9.72%,
105/11/09,-398,-954,-129,-1481,16489,4857,923,22269,7.25%,9.79%,
105/11/08,421,-250,-47,124,16887,5811,1052,23750,7.42%,10.44%,
105/11/07,196,-179,6,23,16466,6061,1099,23626,7.24%,10.39%,
105/11/04,-205,-81,25,-261,16270,6240,1093,23603,7.15%,10.37%,
105/11/03,99,0,-33,66,16438,6321,1068,23827,7.22%,10.47%,
105/11/02,188,-50,-406,-268,16339,6321,1101,23761,7.18%,10.44%,
105/11/01,-323,0,-48,-371,16151,6371,1507,24029,7.10%,10.56%,
105/10/31,206,0,-57,149,16574,6371,1555,24500,7.28%,10.77%,
105/10/28,425,0,-25,400,16368,6371,1612,24351,7.19%,10.70%,
105/10/27,66,-204,-98,-236,15943,6371,1637,23951,7.01%,10.53%,
105/10/26,53,-408,106,-249,15877,6575,1735,24187,6.98%,10.63%,
105/10/25,-140,0,-154,-294,15824,6983,1629,24436,6.95%,10.74%,
105/10/24,-437,0,311,-126,15964,6983,1783,24730,7.02%,10.88%,
105/10/21,-127,0,-24,-151,16401,6983,1472,24856,7.21%,10.93%,
105/10/20,-229,0,53,-176,16528,6983,1496,25007,7.26%,10.99%,
105/10/19,-92,-73,42,-123,16757,6983,1443,25183,7.36%,11.07%,
105/10/18,-981,-70,0,-1051,16849,7056,1401,25306,7.40%,11.12%,
105/10/17,-121,0,-34,-155,17830,7126,1401,26357,7.84%,11.59%,
105/10/14,-475,-367,-83,-925,17951,7126,1435,26512,7.89%,11.65%,
105/10/13,-143,-113,-111,-367,18426,7493,1518,27437,8.10%,12.06%,
105/10/12,-254,0,51,-203,18569,7606,1629,27804,8.16%,12.22%,
105/10/11,845,268,-241,872,18823,7606,1578,28007,8.27%,12.31%,
105/10/07,500,0,-117,383,17978,7338,1819,27135,7.90%,11.93%,
105/10/06,697,0,-136,561,17478,7338,1936,26752,7.68%,11.76%,
105/10/05,-149,30,-306,-425,16781,7338,2072,26191,7.37%,11.51%,
105/10/04,7,50,-799,-742,16930,7308,2378,26616,7.44%,11.70%,
105/10/03,-35,675,535,1175,16923,7258,3177,27358,7.44%,12.03%,
105/09/30,23,150,-713,-540,17150,6583,2642,26375,7.54%,11.60%,
105/09/29,-103,140,1018,1055,16972,6317,3355,26644,7.46%,11.71%,
105/09/26,-916,141,593,-182,17235,6177,2337,25749,7.57%,11.31%,
105/09/23,-361,254,-110,-217,18151,6036,1744,25931,7.98%,11.40%,
105/09/22,-202,684,-280,202,18541,5782,1854,26177,8.15%,11.51%,
105/09/21,743,0,634,1377,18742,5098,2134,25974,8.24%,11.42%,
105/09/20,-173,0,95,-78,17999,5098,1500,24597,7.91%,10.81%,
105/09/19,245,0,26,271,18173,5098,1405,24676,7.99%,10.85%,
105/09/14,-57,0,15,-42,17928,5098,1379,24405,7.88%,10.73%,
105/09/13,-76,0,-56,-132,17985,5098,1364,24447,7.90%,10.74%,
105/09/12,-379,0,-130,-509,18061,5098,1420,24579,7.94%,10.81%,
105/09/10,5,-118,-43,-156,18440,5098,1550,25088,8.10%,11.02%,
105/09/09,180,-307,-337,-464,18435,5216,1593,25244,8.10%,11.09%,
105/09/08,50,0,297,347,18255,5523,1930,25708,8.02%,11.30%,
105/09/07,-370,-250,186,-434,18205,5523,1633,25361,8.00%,11.15%,
105/09/06,209,-708,-124,-623,18575,5773,1447,25795,8.16%,11.34%,
105/09/05,-223,-926,166,-983,18365,6481,1571,26417,8.07%,11.61%,
105/09/02,-521,9,-273,-785,18472,7407,1405,27284,8.12%,12.00%,
105/09/01,-461,274,242,55,18993,7398,1678,28069,8.35%,12.34%,
105/08/31,-236,300,-201,-137,19325,7124,1436,27885,8.49%,12.25%,
105/08/30,-277,362,130,215,19561,6824,1637,28022,8.60%,12.32%,
105/08/29,-459,-20,46,-433,19838,6462,1507,27807,8.72%,12.22%,
105/08/26,101,0,-268,-167,20297,6482,1461,28240,8.92%,12.41%,
105/08/25,-606,0,393,-213,20196,6482,1729,28407,8.88%,12.49%,
105/08/24,-86,0,84,-2,20803,6482,1336,28621,9.14%,12.58%,
105/08/23,-147,-18,65,-100,20889,6482,1252,28623,9.18%,12.58%,
105/08/22,-730,-22,-200,-952,21036,6500,1187,28723,9.25%,12.63%,
105/08/19,-764,-15,203,-576,21766,6522,1387,29675,9.57%,13.05%,
105/08/18,-527,-15,-49,-591,22530,6537,1184,30251,9.90%,13.30%,
105/08/17,-633,0,-57,-690,23057,6552,1233,30842,10.13%,13.55%,
105/08/16,-324,0,-66,-390,23690,6552,1290,31532,10.41%,13.86%,
105/08/15,76,4,-98,-18,24014,6552,1356,31922,10.56%,14.04%,
105/08/12,-533,-100,52,-581,23939,6548,1454,31941,10.52%,14.04%,
105/08/11,-147,0,90,-57,24472,6648,1402,32522,10.76%,14.30%,
105/08/10,-652,0,53,-599,24619,6648,1312,32579,10.82%,14.32%,
105/08/09,-925,0,-127,-1052,25271,6648,1259,33178,11.11%,14.59%,
105/08/08,-278,0,-192,-470,26196,6648,1386,34230,11.52%,15.05%,
105/08/05,-50,0,-27,-77,26474,6648,1578,34700,11.64%,15.26%,
105/08/04,-99,0,21,-78,26524,6648,1605,34777,11.66%,15.29%,
105/08/03,-549,100,-42,-491,26623,6648,1584,34855,11.70%,15.32%,
105/08/02,-326,100,-155,-381,27089,6548,1626,35263,11.91%,15.50%,
105/08/01,176,171,136,483,27415,6448,1781,35644,12.05%,15.67%,
105/07/29,917,100,313,1330,27239,6277,1645,35161,11.97%,15.45%,
105/07/28,105,400,63,568,26309,6177,1332,33818,11.56%,14.86%,
105/07/27,-235,200,-963,-998,26148,5777,1269,33194,11.49%,14.59%,
105/07/26,1988,98,622,2708,26447,5577,2232,34256,11.63%,15.06%,
105/07/25,115,0,-45,70,24459,5479,1610,31548,10.75%,13.87%,
105/07/22,608,0,-124,484,24237,5479,1655,31371,10.65%,13.79%,
105/07/21,-479,0,-266,-745,23629,5479,1779,30887,10.39%,13.58%,
105/07/20,2174,0,-1732,442,24108,5479,2045,31632,10.60%,13.91%,
105/07/19,-3023,0,327,-2696,21934,5479,3777,31190,9.64%,13.71%,
105/07/18,-779,0,1429,650,24957,5479,3450,33886,10.97%,14.90%,
105/07/15,-670,0,-224,-894,25736,5479,2021,33236,11.31%,14.61%,
105/07/14,88,170,-115,143,26406,5479,2245,34130,11.61%,15.01%,
105/07/13,-56,100,15,59,26318,5309,2360,33987,11.57%,14.94%,
105/07/12,-150,200,-71,-21,26374,5209,2345,33928,11.59%,14.91%,
105/07/11,-62,130,595,663,26524,5009,2416,33949,11.66%,14.93%,
105/07/07,76,0,-202,-126,26586,4879,1821,33286,11.69%,14.64%,
105/07/06,118,-600,-158,-640,26510,4879,2023,33412,11.65%,14.69%,
105/07/05,-2058,0,-651,-2709,26392,5479,2181,34052,11.60%,14.97%,
105/07/04,-90,127,849,886,28450,5479,2832,36761,12.51%,16.16%,
105/07/01,-240,0,-272,-512,28540,5352,1983,35875,12.55%,15.78%,
105/06/30,-566,212,-176,-530,28780,5352,2255,36387,12.65%,16.00%,
105/06/29,-113,624,110,621,29346,6616,2431,38393,12.90%,16.88%,
105/06/28,-490,260,-867,-1097,29504,5992,2321,37817,12.97%,16.63%,
105/06/27,481,1300,1041,2822,29994,5732,3188,38914,13.19%,17.11%,
105/06/24,504,253,-661,96,29521,4432,2147,36100,12.98%,15.87%,
105/06/23,834,1008,72,1914,29017,4179,2808,36004,12.76%,15.83%,
105/06/22,1735,110,391,2236,28173,3171,2736,34080,12.38%,14.98%,
105/06/21,1198,0,182,1380,26438,3061,2345,31844,11.62%,14.00%,
105/06/20,1696,444,273,2413,25229,3061,2163,30453,11.09%,13.39%,
105/06/17,1470,402,263,2135,23533,2617,1890,28040,10.34%,12.32%,
105/06/16,491,380,-139,732,22053,2215,1627,25895,9.69%,11.38%,
105/06/15,829,409,-108,1130,21562,1835,1766,25163,9.48%,11.06%,
105/06/14,537,215,136,888,20733,1426,1874,24033,9.11%,10.56%,
105/06/13,947,0,197,1144,20204,1211,1738,23153,8.88%,10.18%,
105/06/08,426,0,240,666,19257,1211,1541,22009,8.46%,9.67%,
105/06/07,-94,0,-9,-103,18809,1211,1301,21321,8.27%,9.37%,
105/06/06,-83,0,-37,-120,18903,1211,1310,21424,8.31%,9.42%,
105/06/04,0,0,-6,-6,18986,1211,1347,21544,8.34%,9.46%,
105/06/03,-195,0,2,-193,18986,1211,1353,21550,8.34%,9.47%,
105/06/02,-485,0,-66,-551,19210,1211,1351,21772,8.44%,9.57%,
105/06/01,-96,0,-11,-107,19695,1211,1417,22323,8.66%,9.82%,
105/05/31,-37,0,-24,-61,19791,1211,1428,22430,8.70%,9.86%,
105/05/30,-36,0,8,-28,19828,1211,1452,22491,8.71%,9.88%,
105/05/27,-85,0,81,-4,19864,1211,1444,22519,8.73%,9.90%,
105/05/26,4,0,43,47,19949,1211,1363,22523,8.77%,9.90%,
105/05/25,307,0,100,407,19945,1211,1320,22476,8.77%,9.88%,
105/05/24,-386,0,83,-303,19638,1211,1220,22069,8.63%,9.70%,
105/05/23,108,0,217,325,20016,1211,1137,22364,8.80%,9.83%,
105/05/20,-213,0,-71,-284,19908,1211,920,22039,8.75%,9.69%,
105/05/19,-189,0,-28,-217,20121,1211,991,22323,8.84%,9.81%,
105/05/18,-571,0,-11,-582,20310,1211,1019,22540,8.93%,9.91%,
105/05/17,18,0,-64,-46,20881,1211,1030,23122,9.18%,10.17%,
105/05/16,-227,0,-38,-265,20863,1211,1094,23168,9.17%,10.18%,
105/05/13,222,0,40,262,21090,1211,1132,23433,9.27%,10.30%,
105/05/12,392,0,-9,383,20868,1211,1092,23171,9.17%,10.18%,
105/05/11,-314,0,-17,-331,20476,1211,1101,22788,9.00%,10.02%,
105/05/10,311,0,-43,268,20790,1211,1118,23119,9.14%,10.16%,
105/05/09,79,0,-225,-146,20479,1211,1161,22851,9.00%,10.04%,
105/05/06,-634,250,11,-373,20400,1211,1386,22997,8.97%,10.11%,
105/05/05,420,0,54,474,21034,961,1375,23370,9.25%,10.28%,
105/05/04,52,0,-102,-50,20585,961,1321,22867,9.05%,10.05%,
105/05/03,-173,200,109,136,20533,961,1423,22917,9.02%,10.07%,
105/04/29,782,0,72,854,20706,761,1314,22781,9.10%,10.01%,
105/04/28,582,0,-93,489,19924,761,1242,21927,8.76%,9.64%,
105/04/27,5,0,-78,-73,19342,761,1335,21438,8.50%,9.42%,
105/04/26,20,50,47,117,19337,761,1413,21511,8.50%,9.46%,
105/04/25,273,20,-44,249,19317,711,1366,21394,8.49%,9.40%,
105/04/22,148,0,-22,126,19044,691,1410,21145,8.37%,9.29%,
105/04/21,396,80,-158,318,18896,691,1432,21019,8.30%,9.23%,
105/04/20,704,100,-197,607,18500,611,1590,20701,8.13%,9.10%,
105/04/19,472,511,429,1412,17796,511,1787,20094,7.82%,8.83%,
105/04/18,1015,0,191,1206,17324,0,1358,18682,7.61%,8.21%,
105/04/15,311,0,-26,285,16309,0,1167,17476,7.17%,7.68%,
105/04/14,322,0,23,345,15998,0,1193,17191,7.03%,7.55%,
105/04/13,562,0,20,582,15676,0,1170,16846,6.89%,7.40%,
105/04/12,-418,0,-225,-643,15114,0,1150,16264,6.64%,7.15%,
105/04/11,310,0,254,564,15532,0,1375,16907,6.83%,7.43%,
105/04/08,359,0,-122,237,15222,0,1121,16343,6.69%,7.18%,
105/04/07,-119,0,-208,-327,14886,0,1243,16129,6.54%,7.09%,
105/04/06,344,0,425,769,15005,0,1451,16456,6.59%,7.23%,
105/04/01,916,0,-9,907,14661,0,1026,15687,6.44%,6.89%,
105/03/31,-91,0,-26,-117,13745,0,1035,14780,6.04%,6.50%,
105/03/30,-64,0,-111,-175,13836,0,1061,14897,6.08%,6.55%,
105/03/29,-217,0,-62,-279,13900,0,1172,15072,6.11%,6.63%,
105/03/28,-135,0,83,-52,14117,0,1234,15351,6.20%,6.74%,
105/03/25,-441,0,-78,-519,14252,0,1151,15403,6.26%,6.77%,
105/03/24,-114,0,37,-77,14670,0,1229,15899,6.45%,6.99%,
105/03/23,-220,0,43,-177,14784,0,1192,15976,6.50%,7.02%,
105/03/22,-136,0,-37,-173,15004,0,1149,16153,6.59%,7.10%,
105/03/21,-127,0,-41,-168,15140,0,1186,16326,6.65%,7.17%,
105/03/18,223,0,47,270,15267,0,1227,16494,6.71%,7.25%,
105/03/17,-277,0,-28,-305,15044,0,1180,16224,6.61%,7.13%,
105/03/16,90,0,-42,48,15321,0,1208,16529,6.73%,7.26%,
105/03/15,-302,0,-11,-313,15231,0,1250,16481,6.69%,7.24%,
105/03/14,38,0,-38,0,15533,0,1261,16794,6.83%,7.38%,
105/03/11,145,0,4,149,15495,0,1299,16794,6.81%,7.38%,
105/03/10,-315,0,2,-313,15350,0,1295,16645,6.75%,7.32%,
105/03/09,75,0,-89,-14,15665,0,1293,16958,6.88%,7.45%,
105/03/08,156,0,0,156,15590,0,1382,16972,6.85%,7.46%,
105/03/07,107,0,88,195,15434,0,1382,16816,6.78%,7.39%,
105/03/04,600,0,-264,336,15327,0,1294,16621,6.74%,7.31%,
105/03/03,703,0,546,1249,14737,0,1558,16295,6.48%,7.17%,
105/03/02,390,0,-9,381,14034,0,1012,15046,6.17%,6.62%,
105/03/01,-108,0,-49,-157,13644,0,1021,14665,6.00%,6.45%,
105/02/26,249,0,27,276,13752,0,1070,14822,6.04%,6.51%,
105/02/25,306,0,-102,204,13503,0,1043,14546,5.93%,6.39%,
105/02/24,-190,0,127,-63,13197,0,1145,14342,5.80%,6.30%,
105/02/23,228,0,-80,148,13387,0,1018,14405,5.88%,6.33%,
105/02/22,267,0,152,419,13159,0,1098,14257,5.78%,6.26%,
105/02/19,343,0,-217,126,12892,0,946,13838,5.66%,6.08%,
105/02/18,-49,0,-126,-175,12575,0,1163,13738,5.53%,6.04%,
105/02/17,439,0,209,648,12624,0,1289,13913,5.55%,6.12%,
105/02/16,57,0,-41,16,12185,0,1080,13265,5.35%,5.82%,
105/02/15,5,0,105,110,12128,0,1121,13249,5.33%,5.82%,
105/02/03,386,0,-60,326,12123,0,1016,13139,5.33%,5.78%,
105/02/02,-105,0,-15,-120,11737,0,1076,12813,5.16%,5.63%,
105/02/01,-54,0,73,19,11842,0,1091,12933,5.20%,5.68%,
105/01/30,-220,0,-74,-294,11896,0,1018,12914,5.23%,5.68%,
105/01/29,362,0,55,417,12116,0,1092,13208,5.32%,5.80%,
105/01/28,0,0,-31,-31,11754,0,1037,12791,5.16%,5.62%,
105/01/27,28,0,23,51,11754,0,1068,12822,5.16%,5.63%,
105/01/26,-74,0,-36,-110,11726,0,1045,12771,5.15%,5.61%,
105/01/25,-77,0,105,28,11800,0,1081,12881,5.18%,5.66%,
105/01/22,19,0,-30,-11,11877,0,976,12853,5.22%,5.65%,
105/01/21,73,0,17,90,11948,0,1006,12954,5.25%,5.69%,
105/01/20,207,0,-34,173,11875,0,989,12864,5.22%,5.65%,
105/01/19,-45,0,-26,-71,11668,0,1023,12691,5.13%,5.58%,
105/01/18,349,0,40,389,11713,0,1049,12762,5.15%,5.61%,
105/01/15,-49,0,-37,-86,11364,0,1009,12373,4.99%,5.43%,
105/01/14,-264,0,15,-249,11413,0,1046,12459,5.01%,5.47%,
105/01/13,340,0,15,355,11611,0,1031,12642,5.10%,5.55%,
105/01/12,-222,0,-20,-242,11360,0,1016,12376,4.99%,5.44%,
105/01/11,45,0,-147,-102,11469,0,1036,12505,5.04%,5.50%,
105/01/08,-112,0,91,-21,11424,0,1183,12607,5.02%,5.54%,
105/01/07,442,0,-80,362,11536,0,1092,12628,5.07%,5.55%,
105/01/06,-70,0,-19,-89,11094,0,1172,12266,4.87%,5.39%,
105/01/05,72,0,-39,33,11164,0,1191,12355,4.90%,5.42%,
105/01/04,472,0,101,573,11092,0,1230,12322,4.87%,5.41%,
104/12/31,-38,0,-67,-105,10620,0,1129,11749,4.67%,5.17%,
104/12/30,-430,0,-130,-560,10658,0,1196,11854,4.68%,5.21%,
104/12/29,-178,0,-110,-288,11088,0,1326,12414,4.87%,5.45%,
104/12/28,463,0,241,704,11266,0,1436,12702,4.95%,5.58%,
104/12/25,306,0,-9,297,10803,0,1195,11998,4.75%,5.28%,
104/12/24,37,0,-40,-3,10497,0,1204,11701,4.61%,5.14%,
104/12/23,71,0,-303,-232,10460,0,1244,11704,4.59%,5.14%,
104/12/22,-159,0,-107,-266,10389,0,1547,11936,4.56%,5.24%,
104/12/21,91,0,156,247,10548,0,1654,12202,4.63%,5.36%,
104/12/18,-223,0,136,-87,10457,0,1498,11955,4.59%,5.25%,
104/12/17,445,0,139,584,10680,0,1362,12042,4.69%,5.29%,
104/12/16,-215,0,-15,-230,10235,0,1223,11458,4.50%,5.04%,
104/12/15,-8,0,-136,-144,10450,0,1238,11688,4.59%,5.13%,
104/12/14,-46,0,-184,-230,10458,0,1374,11832,4.59%,5.19%,
104/12/11,-147,0,-347,-494,10504,0,1558,12062,4.61%,5.30%,
104/12/10,-125,0,438,313,10651,0,1905,12556,4.68%,5.52%,
104/12/09,1343,0,156,1499,10776,0,1467,12243,4.73%,5.38%,
104/12/08,766,0,-24,742,9433,0,1311,10744,4.14%,4.72%,
104/12/07,-39,0,-20,-59,8667,0,1335,10002,3.81%,4.40%,
104/12/04,80,0,-40,40,8706,0,1355,10061,3.82%,4.42%,
104/12/03,-330,0,-515,-845,8626,0,1395,10021,3.79%,4.40%,
104/12/02,271,0,425,696,8956,0,1910,10866,3.93%,4.77%,
104/12/01,151,0,-26,125,8685,0,1485,10170,3.81%,4.46%,
104/11/30,-16,0,179,163,8534,0,1511,10045,3.75%,4.41%,
104/11/27,-14,0,-70,-84,8550,0,1332,9882,3.75%,4.34%,
104/11/26,38,0,67,105,8564,0,1402,9966,3.76%,4.38%,
104/11/25,-1,0,-20,-21,8734,0,1335,10069,3.84%,4.43%,
104/11/24,-43,0,178,135,8735,0,1355,10090,3.84%,4.44%,
104/11/23,14,0,33,47,8778,0,1177,9955,3.86%,4.38%,
104/11/20,44,0,-13,31,8764,0,1144,9908,3.85%,4.35%,
104/11/19,29,0,-399,-370,8720,0,1157,9877,3.83%,4.34%,
104/11/18,123,0,376,499,8691,0,1556,10247,3.82%,4.50%,
104/11/17,16,0,-646,-630,8568,0,1180,9748,3.76%,4.28%,
104/11/16,8,0,355,363,8552,0,1826,10378,3.76%,4.56%,
104/11/13,45,0,697,742,8336,0,1471,9807,3.66%,4.31%,
104/11/12,-81,0,18,-63,8291,0,774,9065,3.64%,3.98%,
104/11/11,-231,0,-37,-268,8372,0,756,9128,3.68%,4.01%,
104/11/10,-30,0,25,-5,8603,0,793,9396,3.78%,4.13%,
104/11/09,-136,0,-42,-178,8623,0,768,9391,3.79%,4.13%,
104/11/06,-45,0,-47,-92,8759,0,810,9569,3.85%,4.21%,
104/11/05,5,0,80,85,8804,0,857,9661,3.87%,4.25%,
104/11/04,-13,0,10,-3,8799,0,777,9576,3.86%,4.20%,
104/11/03,34,-369,52,-283,8812,0,767,9579,3.87%,4.21%,
104/11/02,272,-531,-79,-338,8778,363,715,9856,3.86%,4.33%,
104/10/30,-5,0,128,123,8506,894,794,10194,3.74%,4.48%,
104/10/29,27,0,-69,-42,8511,894,666,10071,3.74%,4.43%,
104/10/28,88,0,15,103,8484,894,735,10113,3.73%,4.45%,
104/10/27,-3,0,5,2,8396,894,720,10010,3.69%,4.40%,
104/10/26,50,0,-50,0,8399,894,715,10008,3.69%,4.40%,
104/10/23,-89,126,-30,7,8349,894,765,10008,3.67%,4.40%,
104/10/22,0,151,-40,111,8438,768,795,10001,3.71%,4.40%,
104/10/21,-28,125,11,108,8438,617,835,9890,3.71%,4.35%,
104/10/20,-23,0,-83,-106,8466,492,824,9782,3.72%,4.30%,
104/10/19,51,0,31,82,8489,492,907,9888,3.73%,4.35%,
104/10/16,13,0,74,87,8438,492,876,9806,3.71%,4.31%,
104/10/15,31,0,-1,30,8425,492,802,9719,3.70%,4.27%,
104/10/14,39,0,-7,32,8394,492,803,9689,3.69%,4.26%,
104/10/13,193,0,124,317,8355,492,810,9657,3.67%,4.24%,
104/10/12,-74,0,41,-33,8162,492,686,9340,3.58%,4.10%,
104/10/08,-160,0,-356,-516,8236,492,645,9373,3.62%,4.12%,
104/10/07,175,0,323,498,8370,492,1001,9863,3.68%,4.34%,
104/10/06,-7,0,8,1,8195,492,678,9365,3.60%,4.11%,
104/10/05,42,0,-28,14,8202,492,670,9364,3.60%,4.11%,
104/10/02,21,0,-16,5,8160,492,698,9350,3.58%,4.10%,
104/10/01,35,0,32,67,8139,492,714,9345,3.57%,4.10%,
104/09/30,97,0,-18,79,8104,492,682,9278,3.56%,4.08%,
104/09/25,86,0,3,89,8007,492,700,9199,3.52%,4.04%,
104/09/24,-68,0,-129,-197,7921,492,697,9110,3.48%,4.00%,
104/09/23,-186,0,5,-181,7989,492,826,9307,3.51%,4.09%,
104/09/22,-11,78,111,178,8175,492,821,9488,3.59%,4.17%,
104/09/21,-102,276,44,218,8186,414,710,9310,3.59%,4.08%,
104/09/18,10,138,-14,134,8288,138,666,9092,3.64%,3.99%,
104/09/17,-60,0,-2,-62,8278,0,680,8958,3.64%,3.94%,
104/09/16,-11,0,25,14,8338,0,682,9020,3.66%,3.96%,
104/09/15,-19,0,7,-12,8349,0,657,9006,3.67%,3.96%,
104/09/14,-2,0,-10,-12,8368,0,650,9018,3.67%,3.96%,
104/09/11,-5,0,68,63,8370,0,660,9030,3.68%,3.97%,
104/09/10,-2,0,4,2,8375,0,592,8967,3.68%,3.94%,
104/09/09,33,0,-2,31,8377,0,588,8965,3.68%,3.94%,
104/09/08,-27,0,9,-18,8344,0,590,8934,3.66%,3.92%,
104/09/07,17,0,-20,-3,8371,0,581,8952,3.68%,3.94%,
104/09/04,8,0,0,8,8354,0,601,8955,3.67%,3.93%,
104/09/03,78,0,23,101,8346,0,601,8947,3.67%,3.93%,
104/09/02,43,0,0,43,8268,0,578,8846,3.63%,3.88%,
104/09/01,53,0,0,53,8225,0,578,8803,3.61%,3.86%,
104/08/31,83,0,0,83,8172,0,578,8750,3.59%,3.84%,
104/08/28,-8,0,0,-8,8089,0,578,8667,3.55%,3.80%,
104/08/27,14,0,0,14,8097,0,578,8675,3.56%,3.81%,
104/08/26,28,0,-1,27,8083,0,578,8661,3.55%,3.80%,
104/08/25,98,0,1,99,8055,0,579,8634,3.54%,3.79%,
104/08/24,41,0,-1,40,7957,0,578,8535,3.49%,3.74%,
104/08/21,-41,0,-19,-60,7916,0,579,8495,3.48%,3.73%,
104/08/20,11,0,0,11,7957,0,598,8555,3.49%,3.75%,
104/08/19,-24,0,3,-21,7946,0,598,8544,3.49%,3.75%,
104/08/18,-12,0,-1,-13,7970,0,595,8565,3.50%,3.76%,
104/08/17,6,0,0,6,7982,0,596,8578,3.51%,3.77%,
104/08/14,-23,0,0,-23,7976,0,596,8572,3.50%,3.76%,
104/08/13,-48,0,-7,-55,7999,0,596,8595,3.51%,3.77%,
104/08/12,1,0,5,6,8047,0,603,8650,3.53%,3.80%,
104/08/11,36,0,-1,35,8046,0,598,8644,3.53%,3.79%,
104/08/10,35,0,0,35,8010,0,599,8609,3.52%,3.78%,
104/08/07,130,0,18,148,7975,0,599,8574,3.50%,3.76%,
104/08/06,-83,0,0,-83,7845,0,581,8426,3.44%,3.70%,
104/08/05,113,0,-1,112,7928,0,581,8509,3.48%,3.74%,
104/08/04,-3,0,-5,-8,7815,0,582,8397,3.43%,3.69%,
104/08/03,-5,0,-9,-14,7818,0,587,8405,3.43%,3.69%,
104/07/31,-65,0,-1,-66,7823,0,596,8419,3.44%,3.70%,
104/07/30,-22,0,-1,-23,7888,0,597,8485,3.46%,3.72%,
104/07/29,-126,0,-3,-129,7910,0,598,8508,3.47%,3.73%,
104/07/28,-31,0,-19,-50,8036,0,601,8637,3.53%,3.79%,
104/07/27,-206,0,-48,-254,8067,0,620,8687,3.54%,3.81%,
104/07/24,-149,0,-247,-396,8273,0,668,8941,3.63%,3.92%,
104/07/23,-70,0,234,164,8422,0,915,9337,3.70%,4.10%,
104/07/22,-4,0,9,5,8492,0,681,9173,3.73%,4.03%,
104/07/21,4,0,-32,-28,8496,0,672,9168,3.73%,4.03%,
104/07/20,-211,0,-59,-270,8492,0,704,9196,3.73%,4.04%,
104/07/17,83,0,-44,39,8703,0,763,9466,3.82%,4.16%,
104/07/16,-126,0,15,-111,8620,0,807,9427,3.79%,4.14%,
104/07/15,-28,0,-1,-29,8746,0,792,9538,3.84%,4.19%,
104/07/14,-65,0,-16,-81,8774,0,793,9567,3.85%,4.20%,
104/07/13,-153,0,-63,-216,8849,0,809,9658,3.89%,4.25%,
104/07/09,76,0,0,76,9002,0,872,9874,3.95%,4.33%,
104/07/08,-216,0,-77,-293,8916,0,872,9788,3.92%,4.30%,
104/07/07,-5,0,-42,-47,9132,0,949,10081,4.01%,4.43%,
104/07/06,-183,0,-299,-482,9137,0,991,10128,4.01%,4.45%,
104/07/03,-13,0,6,-7,9320,0,1290,10610,4.09%,4.66%,
104/07/02,-145,0,-49,-194,9333,0,1284,10617,4.10%,4.66%,
104/07/01,50,0,-3,47,9478,0,1333,10811,4.16%,4.75%,
104/06/30,49,0,-32,17,9428,0,1336,10764,4.14%,4.73%,
104/06/29,99,0,-250,-151,9379,0,1368,10747,4.12%,4.72%,
104/06/26,-95,0,-1208,-1303,9281,0,1618,10899,4.08%,4.79%,
104/06/25,-327,0,425,98,9376,0,2826,12202,4.12%,5.36%,
104/06/24,3,0,-368,-365,9703,0,2401,12104,4.26%,5.32%,
104/06/23,125,0,112,237,9700,0,2769,12469,4.26%,5.48%,
104/06/22,-243,0,143,-100,9575,0,2657,12232,4.21%,5.38%,
104/06/18,-43,0,423,380,9818,0,2514,12332,4.31%,5.42%,
104/06/17,-107,0,-1,-108,9860,0,2091,11951,4.33%,5.25%,
104/06/16,4,0,-89,-85,9967,0,2092,12059,4.38%,5.30%,
104/06/15,-114,0,15,-99,9963,0,2181,12144,4.38%,5.34%,
104/06/12,-16,0,23,7,10077,0,2166,12243,4.43%,5.38%,
104/06/11,-183,0,365,182,10093,0,2143,12236,4.43%,5.37%,
104/06/10,327,0,-230,97,10276,0,1778,12054,4.51%,5.29%,
104/06/09,-98,0,-691,-789,9949,0,2008,11957,4.37%,5.25%,
104/06/08,57,0,-173,-116,10047,0,2699,12746,4.41%,5.60%,
104/06/05,74,0,-112,-38,9990,0,2872,12862,4.39%,5.65%,
104/06/04,-128,0,-381,-509,9916,0,2984,12900,4.36%,5.67%,
104/06/03,11,0,79,90,10044,0,3365,13409,4.41%,5.89%,
104/06/02,255,0,24,279,10033,0,3286,13319,4.41%,5.86%,
104/06/01,60,0,-138,-78,9778,0,3262,13040,4.30%,5.73%,
104/05/29,49,0,59,108,9718,0,3400,13118,4.27%,5.77%,
104/05/28,154,0,-111,43,9669,0,3341,13010,4.25%,5.72%,
104/05/27,-105,0,-47,-152,9515,0,3452,12967,4.18%,5.70%,
104/05/26,-212,0,224,12,9620,0,3499,13119,4.23%,5.77%,
104/05/25,-66,0,448,382,9832,0,3275,13107,4.32%,5.76%,
104/05/22,-79,0,311,232,9898,0,2827,12725,4.35%,5.59%,
104/05/21,132,0,-395,-263,9977,0,2516,12493,4.38%,5.49%,
104/05/20,-82,0,616,534,9845,0,2910,12755,4.32%,5.60%,
104/05/19,25,0,-84,-59,9927,0,2294,12221,4.36%,5.37%,
104/05/18,-95,0,150,55,9902,0,2378,12280,4.35%,5.40%,
104/05/15,21,0,318,339,9997,0,2228,12225,4.39%,5.37%,
104/05/14,58,0,189,247,9976,0,1910,11886,4.38%,5.22%,
104/05/13,68,0,-120,-52,9918,0,1721,11639,4.36%,5.12%,
104/05/12,325,0,-89,236,9850,0,1841,11691,4.33%,5.14%,
104/05/11,-59,0,-278,-337,9525,0,1930,11455,4.18%,5.03%,
104/05/08,-2,0,-179,-181,9584,0,2208,11792,4.21%,5.18%,
104/05/07,-321,0,455,134,9586,0,2387,11973,4.21%,5.26%,
104/05/06,-47,0,159,112,9907,0,1932,11839,4.35%,5.20%,
104/05/05,32,0,217,249,9954,0,1773,11727,4.37%,5.15%,
104/05/04,-90,0,61,-29,9922,0,1556,11478,4.36%,5.04%,
104/04/30,202,0,-47,155,10012,0,1495,11507,4.40%,5.06%,
104/04/29,130,0,-906,-776,9810,0,1542,11352,4.31%,4.99%,
104/04/28,184,0,-819,-635,9680,0,2448,12128,4.25%,5.33%,
104/04/27,96,0,123,219,9496,0,3267,12763,4.17%,5.61%,
104/04/24,161,0,-119,42,9400,0,3144,12544,4.13%,5.51%,
104/04/23,-221,0,-169,-390,9239,0,3263,12502,4.06%,5.49%,
104/04/22,344,0,-10,334,9460,0,3432,12892,4.16%,5.67%,
104/04/21,-107,0,265,158,9116,0,3442,12558,4.00%,5.51%,
104/04/20,474,0,160,634,9223,0,3177,12400,4.05%,5.45%,
104/04/17,156,0,-369,-213,8749,0,3017,11766,3.84%,5.17%,
104/04/16,246,0,-60,186,8593,0,3386,11979,3.77%,5.26%,
104/04/15,-328,0,-426,-754,8357,0,3446,11803,3.67%,5.19%,
104/04/14,-12,0,622,610,8685,0,3872,12557,3.81%,5.51%,
104/04/13,-19,0,-30,-49,8697,0,3250,11947,3.82%,5.25%,
104/04/10,289,0,-94,195,8716,0,3280,11996,3.83%,5.27%,
104/04/09,-235,0,-498,-733,8427,0,3374,11801,3.70%,5.18%,
104/04/08,52,0,280,332,8662,0,3872,12534,3.80%,5.50%,
104/04/07,126,0,342,468,8610,0,3592,12202,3.78%,5.36%,
104/04/02,49,0,-38,11,8484,0,3250,11734,3.73%,5.16%,
104/04/01,48,0,87,135,8435,0,3288,11723,3.70%,5.15%,
104/03/31,868,0,1,869,8387,0,3201,11588,3.68%,5.09%,
104/03/30,344,0,16,360,7519,0,3200,10719,3.30%,4.71%,
104/03/27,-290,0,-68,-358,7175,0,3184,10359,3.15%,4.55%,
104/03/26,281,0,200,481,7465,0,3252,10717,3.28%,4.71%,
104/03/25,104,0,-423,-319,7184,0,3052,10236,3.15%,4.49%,
104/03/24,-304,0,418,114,7090,0,3475,10565,3.11%,4.64%,
104/03/23,-23,0,335,312,7394,0,3057,10451,3.25%,4.59%,
104/03/20,55,0,-332,-277,7417,0,2722,10139,3.26%,4.46%,
104/03/19,-229,0,1309,1080,7362,0,3054,10416,3.23%,4.57%,
104/03/18,100,0,285,385,7591,0,1745,9336,3.33%,4.10%,
104/03/17,256,0,-178,78,7491,0,1460,8951,3.29%,3.93%,
104/03/16,74,0,-747,-673,7235,0,1638,8873,3.18%,3.90%,
104/03/13,50,0,91,141,7161,0,2385,9546,3.14%,4.19%,
104/03/12,-42,0,306,264,7111,0,2294,9405,3.12%,4.13%,
104/03/11,-1,0,171,170,7153,0,1988,9141,3.14%,4.01%,
104/03/10,-61,0,380,319,7154,0,1817,8971,3.14%,3.94%,
104/03/09,57,0,-36,21,7215,0,1437,8652,3.17%,3.80%,
104/03/06,-2,0,-34,-36,7158,0,1473,8631,3.14%,3.79%,
104/03/05,-5,0,49,44,7160,0,1507,8667,3.14%,3.80%,
104/03/04,-314,0,43,-271,7165,0,1458,8623,3.15%,3.79%,
104/03/03,-119,0,-259,-378,7479,0,1415,8894,3.28%,3.90%,
104/03/02,-57,0,575,518,7598,0,1674,9272,3.34%,4.08%,
104/02/26,-45,0,-60,-105,7655,0,1099,8754,3.36%,3.84%,
104/02/25,-38,0,-123,-161,7700,0,1159,8859,3.38%,3.89%,
104/02/24,47,0,236,283,7738,0,1282,9020,3.40%,3.96%,
104/02/13,-4,0,-39,-43,7691,0,1046,8737,3.38%,3.84%,
104/02/12,29,0,-67,-38,7695,0,1085,8780,3.38%,3.86%,
104/02/11,19,0,-167,-148,7666,0,1152,8818,3.37%,3.88%,
104/02/10,51,0,73,124,7647,0,1319,8966,3.36%,3.94%,
104/02/09,116,0,-208,-92,7596,0,1246,8842,3.34%,3.89%,
104/02/06,-115,0,102,-13,7480,0,1454,8934,3.28%,3.92%,
104/02/05,7,0,273,280,7595,0,1352,8947,3.33%,3.92%,
104/02/04,-81,0,-4,-85,7588,0,1079,8667,3.33%,3.80%,
104/02/03,-29,0,-7,-36,7739,0,1083,8822,3.40%,3.88%,
104/02/02,-91,0,-74,-165,7768,0,1090,8858,3.41%,3.89%,
104/01/30,-107,0,-159,-266,7859,0,1164,9023,3.45%,3.96%,
104/01/29,82,0,-59,23,7966,0,1323,9289,3.50%,4.08%,
104/01/28,99,0,-1,98,7884,0,1382,9266,3.46%,4.07%,
104/01/27,-141,0,-148,-289,7785,0,1383,9168,3.42%,4.03%,
104/01/26,-34,0,383,349,7926,0,1531,9457,3.48%,4.15%,
104/01/23,-6,0,-10,-16,7960,0,1148,9108,3.50%,4.00%,
104/01/22,36,0,213,249,7966,0,1158,9124,3.50%,4.01%,
104/01/21,17,0,-244,-227,8179,0,945,9124,3.59%,4.01%,
104/01/20,339,0,83,422,8162,0,1189,9351,3.58%,4.10%,
104/01/19,364,0,-123,241,7823,0,1106,8929,3.44%,3.93%,
104/01/16,-155,0,94,-61,7459,0,1229,8688,3.28%,3.82%,
104/01/15,72,0,-269,-197,7365,0,1135,8500,3.23%,3.73%,
104/01/14,33,0,-497,-464,7293,0,1404,8697,3.20%,3.82%,
104/01/13,467,0,675,1142,7260,0,1901,9161,3.19%,4.03%,
104/01/12,-17,0,254,237,6793,0,1226,8019,2.98%,3.52%,
104/01/09,0,0,-602,-602,6810,0,972,7782,2.99%,3.42%,
104/01/08,31,0,295,326,6810,0,1574,8384,2.99%,3.68%,
104/01/07,29,0,-136,-107,6779,0,1279,8058,2.98%,3.54%,
104/01/06,-62,0,-427,-489,6750,0,1415,8165,2.96%,3.58%,
104/01/05,13,0,378,391,6812,0,1842,8654,2.99%,3.80%,
