日期,外資買賣超,投信買賣超,自營商買賣超,單日合計買賣超,外資估計持股,投信估計持股,自營商估計持股,單日合計估計持股,外資持股比重,三大法人持股比重,
107/03/31,0,-2,-12,-14,35830,287,27,36144,25.22%,25.44%,
107/03/30,1,-2,-2,-3,35830,289,39,36158,25.22%,25.45%,
107/03/29,42,-2,0,40,35829,291,41,36161,25.22%,25.45%,
107/03/28,89,0,10,99,35787,293,41,36121,25.19%,25.43%,
107/03/27,54,3,0,57,35698,293,31,36022,25.12%,25.35%,
107/03/26,9,-2,-1,6,35634,290,31,35955,25.08%,25.31%,
107/03/23,116,-3,-25,88,35625,292,32,35949,25.07%,25.30%,
107/03/22,43,-3,-20,20,35509,295,57,35861,24.99%,25.24%,
107/03/21,43,-3,-11,29,35466,298,77,35841,24.96%,25.22%,
107/03/20,4,0,-1,3,35423,301,88,35812,24.93%,25.20%,
107/03/19,13,0,0,13,35786,301,89,36176,25.19%,25.46%,
107/03/16,7,0,0,7,35773,301,89,36163,25.18%,25.45%,
107/03/15,47,0,-1,46,35771,301,89,36161,25.18%,25.45%,
107/03/14,13,0,2,15,35724,301,90,36115,25.14%,25.42%,
107/03/13,61,0,-5,56,35731,301,88,36120,25.15%,25.42%,
107/03/12,63,0,0,63,35670,301,93,36064,25.10%,25.38%,
107/03/09,66,0,0,66,35607,301,93,36001,25.06%,25.34%,
107/03/08,51,0,2,53,35542,301,93,35936,25.01%,25.29%,
107/03/07,67,1,8,76,35506,301,91,35898,24.99%,25.27%,
107/03/06,40,0,8,48,35439,300,83,35822,24.94%,25.21%,
107/03/05,89,0,0,89,35400,300,75,35775,24.91%,25.17%,
107/03/02,52,0,15,67,35311,300,75,35686,24.85%,25.11%,
107/03/01,74,0,1,75,35259,300,60,35619,24.82%,25.07%,
107/02/27,140,0,0,140,35185,300,59,35544,24.76%,25.01%,
107/02/26,119,0,6,125,35045,300,59,35404,24.66%,24.91%,
107/02/23,146,0,-4,142,34927,300,53,35280,24.58%,24.83%,
107/02/22,92,0,3,95,34781,300,57,35138,24.48%,24.73%,
107/02/21,116,7,7,130,34689,300,54,35043,24.41%,24.66%,
107/02/12,-36,-6,15,-27,34572,293,47,34912,24.33%,24.57%,
107/02/09,84,-8,0,76,34570,299,32,34901,24.33%,24.56%,
107/02/08,102,-2,-1,99,34486,307,32,34825,24.27%,24.51%,
107/02/07,113,-3,-13,97,34384,309,33,34726,24.20%,24.44%,
107/02/06,111,0,3,114,34312,312,46,34670,24.15%,24.40%,
107/02/05,61,0,23,84,34201,312,43,34556,24.07%,24.32%,
107/02/02,148,5,11,164,34141,312,20,34473,24.03%,24.26%,
107/02/01,60,0,2,62,33979,307,9,34295,23.91%,24.13%,
107/01/31,77,1,7,85,33910,307,7,34224,23.87%,24.09%,
107/01/30,324,6,-8,322,33824,306,0,34130,23.80%,24.02%,
107/01/29,47,20,-14,53,33500,300,0,33800,23.58%,23.79%,
107/01/26,13,0,-4,9,33453,280,13,33746,23.54%,23.75%,
107/01/25,1,3,-1,3,33440,280,17,33737,23.53%,23.74%,
107/01/24,37,0,18,55,33439,277,18,33734,23.53%,23.74%,
107/01/23,40,2,-7,35,33382,277,0,33659,23.49%,23.68%,
107/01/22,14,0,0,14,33342,275,7,33624,23.47%,23.67%,
107/01/19,24,2,1,27,33328,275,7,33610,23.46%,23.66%,
107/01/18,44,5,6,55,33294,273,6,33573,23.43%,23.63%,
107/01/17,103,0,0,103,33250,268,0,33518,23.40%,23.59%,
107/01/16,81,0,0,81,33147,268,0,33415,23.33%,23.52%,
107/01/15,60,0,0,60,33066,268,0,33334,23.27%,23.46%,
107/01/12,2,0,0,2,33006,268,0,33274,23.23%,23.42%,
107/01/11,1,0,0,1,33004,268,0,33272,23.23%,23.42%,
107/01/10,58,0,-9,49,33003,268,0,33271,23.23%,23.42%,
107/01/09,30,0,0,30,32945,268,6,33219,23.19%,23.38%,
107/01/08,91,0,0,91,32915,268,6,33189,23.17%,23.36%,
107/01/05,54,0,-14,40,32824,268,6,33098,23.10%,23.29%,
107/01/04,60,-27,-16,17,32770,268,20,33058,23.06%,23.26%,
107/01/03,50,0,0,50,32710,295,36,33041,23.02%,23.25%,
107/01/02,46,0,0,46,32660,295,36,32991,22.99%,23.22%,
106/12/29,124,0,9,133,32614,295,36,32945,22.95%,23.18%,
106/12/28,103,-4,4,103,32490,323,27,32840,22.87%,23.12%,
106/12/27,23,-4,2,21,32387,327,23,32737,22.79%,23.04%,
106/12/26,30,-5,0,25,32364,331,21,32716,22.78%,23.03%,
106/12/25,2,-4,0,-2,32334,336,21,32691,22.76%,23.01%,
106/12/22,23,0,0,23,32332,340,21,32693,22.75%,23.00%,
106/12/21,25,0,0,25,32309,340,21,32670,22.74%,22.99%,
106/12/20,56,0,0,56,32284,340,21,32645,22.72%,22.97%,
106/12/19,0,0,0,0,32228,340,21,32589,22.68%,22.93%,
106/12/18,-4,0,0,-4,32228,340,21,32589,22.68%,22.93%,
106/12/15,30,0,0,30,32232,340,21,32593,22.68%,22.93%,
106/12/14,34,0,0,34,32202,340,21,32563,22.66%,22.91%,
106/12/13,22,0,0,22,32158,340,21,32519,22.63%,22.88%,
106/12/12,51,0,0,51,32136,340,21,32497,22.62%,22.87%,
106/12/11,176,0,-4,172,32085,340,21,32446,22.58%,22.83%,
106/12/08,19,0,-6,13,31909,340,25,32274,22.46%,22.72%,
106/12/07,2,0,0,2,31890,340,31,32261,22.44%,22.70%,
106/12/06,4,-1,5,8,31888,340,31,32259,22.44%,22.70%,
106/12/05,8,-10,0,-2,31884,341,26,32251,22.44%,22.70%,
106/12/04,6,0,0,6,31876,351,26,32253,22.43%,22.70%,
106/12/01,9,-1,-5,3,31870,351,26,32247,22.43%,22.70%,
106/11/30,27,-1,-3,23,31861,352,31,32244,22.42%,22.69%,
106/11/29,2,0,0,2,31834,353,34,32221,22.40%,22.67%,
106/11/28,-1,0,0,-1,31831,353,34,32218,22.40%,22.67%,
106/11/27,9,0,0,9,31831,353,34,32218,22.40%,22.67%,
106/11/24,1,0,-5,-4,31822,353,34,32209,22.40%,22.67%,
106/11/23,17,-3,0,14,31821,353,39,32213,22.39%,22.67%,
106/11/22,-13,0,-1,-14,31804,356,39,32199,22.38%,22.66%,
106/11/21,5,0,4,9,31817,356,40,32213,22.39%,22.67%,
106/11/20,-13,0,1,-12,31812,356,36,32204,22.39%,22.67%,
106/11/17,-4,0,0,-4,31825,356,35,32216,22.40%,22.68%,
106/11/16,-1,0,0,-1,31829,356,35,32220,22.40%,22.68%,
106/11/15,1,0,0,1,31830,356,35,32221,22.40%,22.68%,
106/11/14,-5,0,0,-5,31829,356,35,32220,22.40%,22.68%,
106/11/13,-18,3,0,-15,31834,356,35,32225,22.40%,22.68%,
106/11/10,-39,14,0,-25,31852,353,35,32240,22.42%,22.69%,
106/11/09,-10,1,0,-9,31891,339,35,32265,22.44%,22.70%,
106/11/08,6,15,0,21,31902,338,35,32275,22.45%,22.71%,
106/11/07,-16,0,0,-16,31896,323,35,32254,22.45%,22.70%,
106/11/06,5,-4,0,1,31912,323,35,32270,22.46%,22.71%,
106/11/03,56,0,-4,52,31907,327,35,32269,22.46%,22.71%,
106/11/02,36,-3,-1,32,31849,327,39,32215,22.41%,22.67%,
106/11/01,12,-1,-4,7,31813,330,40,32183,22.39%,22.65%,
106/10/31,-32,0,13,-19,31801,331,44,32176,22.38%,22.64%,
106/10/30,49,0,6,55,31833,331,31,32195,22.40%,22.65%,
106/10/27,29,-1,0,28,31784,331,25,32140,22.37%,22.62%,
106/10/26,7,0,0,7,31755,331,25,32111,22.35%,22.60%,
106/10/25,10,0,0,10,31748,331,25,32104,22.34%,22.59%,
106/10/24,1,0,0,1,31738,331,25,32094,22.34%,22.59%,
106/10/23,18,0,0,18,31748,331,25,32104,22.34%,22.59%,
106/10/20,-29,0,0,-29,31730,331,25,32086,22.33%,22.58%,
106/10/19,-8,0,1,-7,31758,331,25,32114,22.35%,22.60%,
106/10/18,15,0,-1,14,31766,331,24,32121,22.36%,22.61%,
106/10/17,4,0,-2,2,31752,331,25,32108,22.35%,22.60%,
106/10/16,1,5,3,9,31748,331,27,32106,22.34%,22.59%,
106/10/13,-7,0,-3,-10,31747,326,24,32097,22.34%,22.59%,
106/10/12,-13,0,-1,-14,31754,326,27,32107,22.35%,22.60%,
106/10/11,-9,0,-1,-10,31767,326,28,32121,22.36%,22.61%,
106/10/06,-3,0,9,6,31776,326,29,32131,22.36%,22.61%,
106/10/05,-2,0,0,-2,31779,326,20,32125,22.37%,22.61%,
106/10/03,0,-2,0,-2,31761,326,20,32107,22.35%,22.59%,
106/10/02,-6,-2,-1,-9,31761,328,20,32109,22.35%,22.59%,
106/09/30,0,-3,0,-3,31762,330,21,32113,22.35%,22.60%,
106/09/29,18,0,0,18,31762,271,21,32054,22.35%,22.56%,
106/09/28,42,5,-1,46,31744,271,21,32036,22.34%,22.55%,
106/09/27,0,0,5,5,31702,266,22,31990,22.31%,22.51%,
106/09/26,29,0,0,29,31702,266,17,31985,22.31%,22.51%,
106/09/25,20,0,0,20,31674,266,17,31957,22.29%,22.49%,
106/09/22,20,5,0,25,31654,266,17,31937,22.28%,22.48%,
106/09/21,-6,0,1,-5,31634,261,17,31912,22.26%,22.46%,
106/09/20,-12,0,0,-12,31640,261,16,31917,22.27%,22.46%,
106/09/19,28,5,0,33,31652,261,16,31929,22.28%,22.47%,
106/09/18,8,0,0,8,31624,257,16,31897,22.26%,22.45%,
106/09/15,24,7,-1,30,31616,257,16,31889,22.25%,22.44%,
106/09/14,-12,6,0,-6,31592,250,17,31859,22.23%,22.42%,
106/09/13,26,0,0,26,31604,244,17,31865,22.24%,22.42%,
106/09/12,10,0,-5,5,31578,244,17,31839,22.22%,22.40%,
106/09/11,39,6,0,45,31568,244,22,31834,22.22%,22.41%,
106/09/08,9,0,4,13,31529,238,22,31789,22.19%,22.37%,
106/09/07,45,0,0,45,31520,238,18,31776,22.18%,22.36%,
106/09/06,16,0,-2,14,31475,238,18,31731,22.15%,22.33%,
106/09/05,82,8,0,90,31459,238,20,31717,22.14%,22.32%,
106/09/04,31,10,0,41,31377,230,20,31627,22.08%,22.26%,
106/09/01,22,8,0,30,31346,220,20,31586,22.06%,22.23%,
106/08/31,38,-1,0,37,31324,212,20,31556,22.04%,22.20%,
106/08/30,31,0,-3,28,31286,212,20,31518,22.02%,22.18%,
106/08/29,13,0,0,13,31255,212,23,31490,22.00%,22.17%,
106/08/28,16,0,0,16,31237,212,23,31472,21.98%,22.15%,
106/08/25,43,0,-24,19,31219,212,23,31454,21.97%,22.14%,
106/08/24,57,0,-22,35,31176,212,47,31435,21.94%,22.12%,
106/08/23,10,0,-10,0,31119,212,69,31400,21.90%,22.10%,
106/08/22,2,0,0,2,31109,212,79,31400,21.89%,22.09%,
106/08/21,22,0,-1,21,31107,212,79,31398,21.89%,22.09%,
106/08/18,6,0,-5,1,31085,212,80,31377,21.88%,22.09%,
106/08/17,-13,0,0,-13,31079,212,85,31376,21.87%,22.08%,
106/08/16,7,10,0,17,31092,212,85,31389,21.88%,22.09%,
106/08/15,43,0,0,43,31075,202,85,31362,21.87%,22.07%,
106/08/14,26,0,-5,21,31032,202,85,31319,21.84%,22.04%,
106/08/11,23,0,0,23,31008,202,90,31300,21.82%,22.03%,
106/08/10,56,0,0,56,30985,202,90,31277,21.81%,22.02%,
106/08/09,79,0,-83,-4,30929,202,90,31221,21.77%,21.98%,
106/08/08,101,0,9,110,30850,202,173,31225,21.71%,21.97%,
106/08/07,13,36,0,49,30749,202,164,31115,21.64%,21.90%,
106/08/04,25,34,-2,57,30736,166,164,31066,21.63%,21.86%,
106/08/03,12,0,-6,6,30711,132,166,31009,21.61%,21.82%,
106/08/02,15,0,-49,-34,30699,132,172,31003,21.60%,21.81%,
106/08/01,48,0,10,58,30684,132,221,31037,21.59%,21.84%,
106/07/31,44,5,0,49,30636,132,211,30979,21.56%,21.80%,
106/07/28,42,-10,-2,30,30592,127,211,30930,21.53%,21.77%,
106/07/27,30,-10,-1,19,30550,137,213,30900,21.50%,21.75%,
106/07/26,16,-10,-5,1,30520,147,214,30881,21.48%,21.73%,
106/07/25,7,-7,0,0,30551,157,219,30927,21.50%,21.76%,
106/07/24,14,-10,0,4,30544,164,219,30927,21.50%,21.77%,
106/07/21,15,0,0,15,30530,174,219,30923,21.49%,21.77%,
106/07/20,13,0,0,13,30515,174,219,30908,21.48%,21.76%,
106/07/19,1,0,0,1,30502,174,219,30895,21.47%,21.75%,
106/07/18,2,15,-1,16,30501,174,219,30894,21.47%,21.75%,
106/07/17,10,0,-2,8,30499,159,220,30878,21.46%,21.73%,
106/07/14,40,-17,-2,21,30489,159,222,30870,21.46%,21.73%,
106/07/13,4,-10,-1,-7,30449,176,224,30849,21.43%,21.71%,
106/07/12,0,-10,-3,-13,30445,186,225,30856,21.43%,21.72%,
106/07/11,3,-6,4,1,30447,196,228,30871,21.43%,21.73%,
106/07/10,-6,0,0,-6,30444,202,224,30870,21.43%,21.73%,
106/07/07,0,0,0,0,30450,202,224,30876,21.43%,21.73%,
106/07/06,1,0,0,1,30450,202,224,30876,21.43%,21.73%,
106/07/05,7,0,9,16,30449,202,224,30875,21.43%,21.73%,
106/07/04,12,-2,8,18,30445,202,215,30862,21.43%,21.72%,
106/07/03,34,0,-5,29,30433,204,207,30844,21.42%,21.71%,
106/06/30,18,-13,0,5,30399,204,212,30815,21.39%,21.68%,
106/06/29,2,-16,0,-14,30381,282,212,30875,21.38%,21.73%,
106/06/28,-3,-12,3,-12,30392,298,212,30902,21.39%,21.75%,
106/06/27,2,0,3,5,30395,310,209,30914,21.39%,21.76%,
106/06/26,86,0,9,95,30393,310,206,30909,21.39%,21.75%,
106/06/23,38,0,0,38,30307,310,197,30814,21.33%,21.69%,
106/06/22,-6,-1,0,-7,30269,310,197,30776,21.30%,21.66%,
106/06/21,79,0,1,80,30275,311,197,30783,21.31%,21.67%,
106/06/20,36,0,1,37,30196,311,196,30703,21.25%,21.61%,
106/06/19,31,0,0,31,30160,311,195,30666,21.23%,21.59%,
106/06/16,31,0,4,35,30129,311,195,30635,21.20%,21.56%,
106/06/15,46,0,0,46,30098,311,191,30600,21.18%,21.53%,
106/06/14,36,0,-10,26,30052,311,191,30554,21.15%,21.50%,
106/06/13,-5,0,1,-4,30016,311,201,30528,21.12%,21.48%,
106/06/12,-7,0,0,-7,30021,311,200,30532,21.13%,21.49%,
106/06/09,19,0,0,19,30027,311,200,30538,21.13%,21.49%,
106/06/08,60,-14,0,46,29994,311,200,30505,21.11%,21.47%,
106/06/07,108,0,-14,94,29933,325,200,30458,21.07%,21.44%,
106/06/06,126,0,-39,87,29827,325,214,30366,20.99%,21.37%,
106/06/05,6,0,-24,-18,29725,325,253,30303,20.92%,21.33%,
106/06/03,0,0,65,65,29731,325,277,30333,20.92%,21.34%,
106/06/02,11,0,21,32,29731,325,212,30268,20.92%,21.30%,
106/06/01,2,0,0,2,29720,325,191,30236,20.92%,21.28%,
106/05/31,1,0,0,1,29719,325,191,30235,20.91%,21.27%,
106/05/26,11,0,0,11,29718,325,191,30234,20.91%,21.27%,
106/05/25,15,0,0,15,29709,325,191,30225,20.91%,21.27%,
106/05/24,9,0,0,9,29694,325,191,30210,20.90%,21.26%,
106/05/23,-14,0,1,-13,29685,325,191,30201,20.89%,21.25%,
106/05/22,-1,0,5,4,29702,325,190,30217,20.90%,21.26%,
106/05/19,24,0,-1,23,29692,325,185,30202,20.90%,21.26%,
106/05/18,23,0,1,24,29668,325,186,30179,20.88%,21.24%,
106/05/17,49,0,0,49,29645,325,185,30155,20.86%,21.22%,
106/05/16,15,0,0,15,29596,325,185,30106,20.83%,21.19%,
106/05/15,1,0,2,3,29760,325,185,30270,20.94%,21.30%,
106/05/12,13,0,0,13,29759,325,183,30267,20.94%,21.30%,
106/05/11,38,0,0,38,29746,325,183,30254,20.93%,21.29%,
106/05/10,38,0,0,38,29708,325,183,30216,20.91%,21.27%,
106/05/09,65,0,-4,61,29670,325,183,30178,20.88%,21.24%,
106/05/08,33,0,0,33,29605,325,187,30117,20.83%,21.19%,
106/05/05,61,-1,-1,59,29572,325,187,30084,20.81%,21.17%,
106/05/04,24,0,0,24,29490,326,188,30004,20.75%,21.11%,
106/05/03,20,-7,-3,10,29466,326,188,29980,20.74%,21.10%,
106/05/02,11,-2,-5,4,29446,333,191,29970,20.72%,21.09%,
106/04/28,31,0,-3,28,29435,335,196,29966,20.72%,21.09%,
106/04/27,16,0,-1,15,29404,335,199,29938,20.69%,21.07%,
106/04/26,10,0,-1,9,29386,335,200,29921,20.68%,21.06%,
106/04/25,75,-0,2,77,29376,335,201,29912,20.67%,21.05%,
106/04/24,51,-18,5,38,29301,335,199,29835,20.62%,21.00%,
106/04/21,87,0,-4,83,29250,353,194,29797,20.59%,20.98%,
106/04/20,34,0,-1,33,29163,353,198,29714,20.52%,20.91%,
106/04/19,62,0,2,64,29129,353,199,29681,20.50%,20.89%,
106/04/18,24,0,0,24,29067,353,197,29617,20.46%,20.85%,
106/04/17,27,0,22,49,29043,353,197,29593,20.44%,20.83%,
106/04/14,178,-2,0,176,29016,353,175,29544,20.42%,20.79%,
106/04/13,10,0,0,10,28838,355,175,29368,20.30%,20.67%,
106/04/12,36,0,0,36,28828,355,175,29358,20.29%,20.66%,
106/04/11,42,-2,0,40,28792,355,175,29322,20.26%,20.63%,
106/04/10,9,0,0,9,28750,357,175,29282,20.23%,20.60%,
106/04/07,49,-10,-1,38,28738,357,175,29270,20.22%,20.59%,
106/04/06,23,-2,0,21,28729,367,176,29272,20.22%,20.60%,
106/04/05,23,-1,0,22,28706,369,176,29251,20.20%,20.58%,
106/03/31,-14,-1,0,-15,28683,370,176,29229,20.19%,20.57%,
106/03/30,21,-10,0,11,28697,368,176,29241,20.20%,20.58%,
106/03/29,56,0,0,56,28676,378,176,29230,20.18%,20.57%,
106/03/28,94,0,0,94,28620,378,176,29174,20.14%,20.53%,
106/03/27,172,0,0,172,28526,378,176,29080,20.08%,20.47%,
106/03/24,130,0,0,130,28354,378,176,28908,19.95%,20.34%,
106/03/23,23,0,0,23,28224,378,176,28778,19.86%,20.25%,
106/03/22,15,0,0,15,28201,378,176,28755,19.85%,20.24%,
106/03/21,85,-12,0,73,28186,378,176,28740,19.84%,20.23%,
106/03/20,57,0,0,57,28101,390,176,28667,19.78%,20.18%,
106/03/17,61,-1,0,60,28044,390,176,28610,19.74%,20.14%,
106/03/16,117,0,-19,98,27983,391,176,28550,19.69%,20.09%,
106/03/15,42,-1,-20,21,27866,391,195,28452,19.61%,20.02%,
106/03/14,20,0,0,20,27824,392,215,28431,19.58%,20.01%,
106/03/13,18,0,0,18,27804,392,215,28411,19.57%,20.00%,
106/03/10,104,0,0,104,27786,392,215,28393,19.55%,19.98%,
106/03/09,75,0,0,75,27682,392,215,28289,19.48%,19.91%,
106/03/08,29,0,4,33,27607,392,215,28214,19.43%,19.86%,
106/03/07,60,-5,0,55,27583,392,211,28186,19.41%,19.83%,
106/03/06,5,0,5,10,27523,397,211,28131,19.37%,19.80%,
106/03/03,21,-3,0,18,27518,397,206,28121,19.37%,19.79%,
106/03/02,43,0,-16,27,27497,400,206,28103,19.35%,19.78%,
106/03/01,26,-10,0,16,27454,400,222,28076,19.32%,19.76%,
106/02/24,32,-29,0,3,27428,410,222,28060,19.30%,19.74%,
106/02/23,5,-30,0,-25,27396,439,222,28057,19.28%,19.75%,
106/02/22,14,-30,65,49,27406,469,222,28097,19.29%,19.78%,
106/02/21,24,-20,0,4,27392,499,157,28048,19.28%,19.74%,
106/02/20,15,-13,0,2,27368,519,157,28044,19.26%,19.74%,
106/02/18,0,-18,30,12,27353,532,157,28042,19.25%,19.74%,
106/02/17,14,0,40,54,27353,550,127,28030,19.25%,19.73%,
106/02/16,13,-20,-30,-37,27339,550,87,27976,19.24%,19.69%,
106/02/15,22,-27,0,-5,27339,570,117,28026,19.24%,19.72%,
106/02/14,11,-26,31,16,27317,597,117,28031,19.22%,19.72%,
106/02/13,15,-20,-5,-10,27306,623,86,28015,19.22%,19.72%,
106/02/10,9,-20,5,-6,27291,643,91,28025,19.21%,19.73%,
106/02/09,-14,-22,19,-17,27282,663,86,28031,19.20%,19.73%,
106/02/08,16,-6,31,41,27306,685,67,28058,19.22%,19.75%,
106/02/07,-2,-20,0,-22,27283,691,36,28010,19.20%,19.71%,
106/02/06,12,-33,25,4,27282,711,36,28029,19.20%,19.73%,
106/02/03,5,-17,0,-12,27270,744,11,28025,19.19%,19.72%,
106/02/02,14,-18,11,7,27265,761,11,28037,19.19%,19.73%,
106/01/24,-17,-10,-1,-28,27251,779,0,28030,19.18%,19.73%,
106/01/23,6,-11,0,-5,27258,789,0,28047,19.18%,19.74%,
106/01/20,4,-10,0,-6,27252,800,0,28052,19.18%,19.74%,
106/01/19,7,-15,0,-8,27248,810,0,28058,19.18%,19.75%,
106/01/18,5,-9,0,-4,27248,825,0,28073,19.18%,19.76%,
106/01/17,-1,-5,0,-6,27243,834,0,28077,19.17%,19.76%,
106/01/16,-12,0,0,-12,27244,839,0,28083,19.17%,19.76%,
106/01/13,-1,-6,0,-7,27256,839,0,28095,19.18%,19.77%,
106/01/12,-4,0,0,-4,27257,845,0,28102,19.18%,19.77%,
106/01/11,-5,-10,0,-15,27246,845,0,28091,19.17%,19.76%,
106/01/10,-4,0,0,-4,27251,855,0,28106,19.18%,19.78%,
106/01/09,6,-10,-1,-5,27255,855,0,28110,19.18%,19.78%,
106/01/06,6,-5,0,1,27249,865,1,28115,19.18%,19.79%,
106/01/05,-1,-2,0,-3,27243,870,1,28114,19.17%,19.78%,
106/01/04,1,-1,0,0,27244,872,1,28117,19.17%,19.78%,
106/01/03,1,-3,0,-2,27254,873,1,28128,19.18%,19.80%,
105/12/30,9,-2,0,7,27253,876,1,28130,19.18%,19.80%,
105/12/29,3,0,0,3,27244,878,1,28123,19.17%,19.79%,
105/12/28,-1,-5,0,-6,27241,878,1,28120,19.17%,19.79%,
105/12/27,5,-5,0,0,27242,883,1,28126,19.17%,19.79%,
105/12/26,5,-5,0,0,27237,888,1,28126,19.17%,19.80%,
105/12/23,-3,-10,0,-13,27232,893,1,28126,19.16%,19.79%,
105/12/22,-10,0,0,-10,27235,903,1,28139,19.17%,19.81%,
105/12/21,4,0,1,5,27245,903,1,28149,19.17%,19.81%,
105/12/20,8,-15,0,-7,27241,903,0,28144,19.17%,19.81%,
105/12/19,3,-5,0,-2,27233,918,0,28151,19.17%,19.82%,
105/12/16,14,0,-0,14,27230,923,0,28153,19.16%,19.81%,
105/12/15,-17,0,0,-17,27216,923,0,28139,19.15%,19.80%,
105/12/14,32,0,0,32,27233,923,0,28156,19.17%,19.82%,
105/12/13,3,0,0,3,27201,923,0,28124,19.14%,19.79%,
105/12/12,9,-10,0,-1,27198,923,0,28121,19.14%,19.79%,
105/12/09,-1,0,0,-1,27189,933,0,28122,19.13%,19.79%,
105/12/08,-1,0,0,-1,27190,933,0,28123,19.13%,19.79%,
105/12/07,-2,-10,0,-12,27191,933,0,28124,19.14%,19.80%,
105/12/06,-6,-10,0,-16,27193,943,0,28136,19.14%,19.80%,
105/12/05,-2,0,0,-2,27199,953,0,28152,19.14%,19.81%,
105/12/02,-2,0,0,-2,27201,953,0,28154,19.14%,19.81%,
105/12/01,-4,0,0,-4,27203,953,0,28156,19.14%,19.81%,
105/11/30,10,-5,0,5,27207,953,0,28160,19.15%,19.82%,
105/11/29,0,1,0,1,27197,958,0,28155,19.14%,19.81%,
105/11/28,-2,0,0,-2,27197,957,0,28154,19.14%,19.81%,
105/11/25,5,0,0,5,27199,957,0,28156,19.14%,19.81%,
105/11/24,-1,0,0,-1,27194,957,0,28151,19.14%,19.81%,
105/11/23,-9,0,0,-9,27195,957,0,28152,19.14%,19.81%,
105/11/22,-19,0,0,-19,27164,957,0,28121,19.12%,19.79%,
105/11/21,-8,0,0,-8,27183,957,0,28140,19.13%,19.80%,
105/11/18,10,0,0,10,27182,957,0,28139,19.13%,19.80%,
105/11/17,4,0,-4,0,27172,957,0,28129,19.12%,19.79%,
105/11/16,-8,0,-2,-10,27168,957,0,28125,19.12%,19.79%,
105/11/15,-2,0,0,-2,27176,957,2,28135,19.12%,19.80%,
105/11/14,-46,-5,0,-51,27178,957,2,28137,19.13%,19.81%,
105/11/11,16,-17,0,-1,27224,962,2,28188,19.16%,19.84%,
105/11/10,0,0,2,2,27208,979,2,28189,19.15%,19.84%,
105/11/09,-11,0,0,-11,27198,979,0,28177,19.14%,19.83%,
105/11/08,31,0,0,31,27209,979,0,28188,19.15%,19.84%,
105/11/07,11,-25,0,-14,27178,979,0,28157,19.13%,19.82%,
105/11/04,-1,0,0,-1,27167,1004,0,28171,19.12%,19.83%,
105/11/03,57,10,-80,-13,27168,1004,0,28172,19.12%,19.83%,
105/11/02,3,20,-31,-8,27111,994,60,28165,19.08%,19.82%,
105/11/01,-24,0,0,-24,27108,974,91,28173,19.08%,19.83%,
105/10/31,-15,0,0,-15,27097,974,91,28162,19.07%,19.82%,
105/10/28,19,0,0,19,27112,974,91,28177,19.08%,19.83%,
105/10/27,5,0,1,6,27093,974,91,28158,19.07%,19.82%,
105/10/26,-4,-10,0,-14,27088,974,90,28152,19.06%,19.81%,
105/10/25,-33,-18,7,-44,27092,984,90,28166,19.07%,19.83%,
105/10/24,-6,4,1,-1,27128,1002,83,28213,19.09%,19.85%,
105/10/21,44,-8,0,36,27118,998,82,28198,19.08%,19.84%,
105/10/20,-6,0,3,-3,27071,1006,82,28159,19.05%,19.82%,
105/10/19,-4,0,23,19,27067,1006,79,28152,19.05%,19.81%,
105/10/18,-6,0,0,-6,27071,1006,56,28133,19.05%,19.80%,
105/10/17,5,25,0,30,27077,1006,56,28139,19.06%,19.81%,
105/10/14,3,10,0,13,27072,981,56,28109,19.05%,19.78%,
105/10/13,36,-14,-3,19,27069,971,56,28096,19.05%,19.77%,
105/10/12,63,10,-8,65,27033,985,59,28077,19.02%,19.75%,
105/10/11,62,-10,-21,31,26970,975,67,28012,18.98%,19.71%,
105/10/07,22,-22,-8,-8,26908,985,88,27981,18.94%,19.70%,
105/10/06,8,-20,-1,-13,26886,1007,96,27989,18.92%,19.70%,
105/10/05,-28,-26,0,-54,26878,1027,97,28002,18.92%,19.71%,
105/10/04,-38,-34,0,-72,26906,1053,97,28056,18.94%,19.75%,
105/10/03,-46,-23,0,-69,26944,1087,97,28128,18.96%,19.79%,
105/09/30,-41,-14,0,-55,26990,1110,97,28197,18.99%,19.84%,
105/09/29,-52,3,0,-49,27031,889,97,28017,19.02%,19.71%,
105/09/26,12,-31,0,-19,27083,886,97,28066,19.06%,19.75%,
105/09/23,11,-19,0,-8,27071,917,97,28085,19.05%,19.76%,
105/09/22,-24,-6,0,-30,27060,936,97,28093,19.04%,19.77%,
105/09/21,24,-43,0,-19,27084,942,97,28123,19.06%,19.79%,
105/09/20,-35,-3,0,-38,27047,985,97,28129,19.03%,19.79%,
105/09/19,54,-68,0,-14,27082,988,97,28167,19.06%,19.82%,
105/09/14,-4,-20,-1,-25,27028,1056,97,28181,19.02%,19.83%,
105/09/13,-20,-4,-2,-26,27032,1076,98,28206,19.02%,19.85%,
105/09/12,-78,-15,-12,-105,27052,1080,100,28232,19.04%,19.87%,
105/09/10,-23,-12,0,-35,27130,1095,112,28337,19.09%,19.94%,
105/09/09,-28,-18,-2,-48,27153,1107,112,28372,19.11%,19.97%,
105/09/08,-50,-3,0,-53,27181,1125,114,28420,19.13%,20.00%,
105/09/07,-13,-10,6,-17,27231,1128,114,28473,19.16%,20.03%,
105/09/06,-22,0,4,-18,27244,1138,108,28490,19.17%,20.05%,
105/09/05,-16,1,4,-11,27266,1138,104,28508,19.19%,20.06%,
105/09/02,8,0,5,13,27282,1137,100,28519,19.20%,20.07%,
105/09/01,-17,0,0,-17,27274,1137,95,28506,19.19%,20.06%,
105/08/31,14,-10,-5,-1,27291,1137,95,28523,19.21%,20.08%,
105/08/30,-8,12,0,4,27277,1147,100,28524,19.20%,20.08%,
105/08/29,-15,28,0,13,27285,1135,100,28520,19.20%,20.07%,
105/08/26,53,25,2,80,27300,1107,100,28507,19.21%,20.06%,
105/08/25,36,20,0,56,27247,1082,98,28427,19.18%,20.01%,
105/08/24,-10,0,0,-10,27191,1062,98,28351,19.14%,19.96%,
105/08/23,-10,0,-1,-11,27198,1062,98,28358,19.14%,19.96%,
105/08/22,-21,0,0,-21,27208,1062,99,28369,19.15%,19.97%,
105/08/19,67,0,-2,65,27229,1062,99,28390,19.16%,19.98%,
105/08/18,-45,0,0,-45,27165,1062,101,28328,19.12%,19.94%,
105/08/17,-50,20,0,-30,27200,1062,101,28363,19.14%,19.96%,
105/08/16,-4,10,0,6,27250,1042,101,28393,19.18%,19.98%,
105/08/15,38,-25,0,13,27254,1032,101,28387,19.18%,19.98%,
105/08/12,14,-16,1,-1,27216,1057,101,28374,19.15%,19.97%,
105/08/11,-11,0,4,-7,27202,1073,100,28375,19.14%,19.97%,
105/08/10,-12,30,0,18,27213,1073,96,28382,19.15%,19.97%,
105/08/09,-22,13,0,-9,27225,1043,96,28364,19.16%,19.96%,
105/08/08,-36,12,8,-16,27247,1030,96,28373,19.18%,19.97%,
105/08/05,8,15,-1,22,27283,1018,88,28389,19.20%,19.98%,
105/08/04,0,0,0,0,27275,1003,89,28367,19.19%,19.96%,
105/08/03,-8,10,-1,1,27275,1003,89,28367,19.19%,19.96%,
105/08/02,-8,40,0,32,27283,993,90,28366,19.20%,19.96%,
105/08/01,-3,6,0,3,27291,953,90,28334,19.21%,19.94%,
105/07/29,-57,43,0,-14,27294,947,90,28331,19.21%,19.94%,
105/07/28,-39,0,0,-39,27351,904,90,28345,19.25%,19.95%,
105/07/27,-34,10,0,-24,27390,904,90,28384,19.28%,19.98%,
105/07/26,-73,10,0,-63,27424,894,90,28408,19.30%,19.99%,
105/07/25,-33,10,0,-23,27497,884,90,28471,19.35%,20.04%,
105/07/22,4,-23,0,-19,27530,874,90,28494,19.37%,20.05%,
105/07/21,-4,-22,2,-24,27526,897,90,28513,19.37%,20.06%,
105/07/20,-16,0,1,-15,27530,919,88,28537,19.37%,20.08%,
105/07/19,-7,0,1,-6,27546,919,87,28552,19.39%,20.10%,
105/07/18,-6,-20,-1,-27,27553,919,86,28558,19.39%,20.10%,
105/07/15,-40,3,0,-37,27559,939,87,28585,19.39%,20.11%,
105/07/14,-20,0,0,-20,27599,936,87,28622,19.42%,20.14%,
105/07/13,-30,-13,0,-43,27619,936,87,28642,19.44%,20.16%,
105/07/12,-10,1,-4,-13,27649,949,87,28685,19.46%,20.19%,
105/07/11,-2,2,-1,-1,27659,948,91,28698,19.47%,20.20%,
105/07/07,-4,10,-2,4,27661,946,92,28699,19.47%,20.20%,
105/07/06,-9,0,4,-5,27665,936,94,28695,19.47%,20.20%,
105/07/05,-2,0,0,-2,27675,936,90,28701,19.48%,20.20%,
105/07/04,-2,1,0,-1,27677,936,90,28703,19.48%,20.20%,
105/07/01,-15,0,0,-15,27674,935,90,28699,19.48%,20.20%,
105/06/30,-2,0,0,-2,27689,935,90,28714,19.49%,20.21%,
105/06/29,-7,0,0,-7,27691,1141,90,28922,19.49%,20.36%,
105/06/28,-4,-6,0,-10,27698,1141,90,28929,19.49%,20.36%,
105/06/27,6,12,2,20,27702,1147,90,28939,19.50%,20.37%,
105/06/24,-41,0,4,-37,27696,1135,88,28919,19.49%,20.35%,
105/06/23,-2,-10,0,-12,27737,1135,84,28956,19.52%,20.38%,
105/06/22,-11,3,0,-8,27739,1145,84,28968,19.52%,20.39%,
105/06/21,-7,3,2,-2,27750,1142,84,28976,19.53%,20.39%,
105/06/20,-13,26,1,14,27757,1139,82,28978,19.53%,20.39%,
105/06/17,-3,5,-11,-9,27770,1113,81,28964,19.54%,20.38%,
105/06/16,-24,0,-5,-29,27773,1108,92,28973,19.55%,20.39%,
105/06/15,-11,25,0,14,27797,1108,97,29002,19.56%,20.41%,
105/06/14,-22,0,2,-20,27808,1083,97,28988,19.57%,20.40%,
105/06/13,-5,0,0,-5,27830,1083,95,29008,19.59%,20.42%,
105/06/08,-8,1,0,-7,27835,1083,95,29013,19.59%,20.42%,
105/06/07,-10,0,0,-10,27843,1082,95,29020,19.59%,20.42%,
105/06/06,-12,0,2,-10,27853,1082,95,29030,19.60%,20.43%,
105/06/04,0,0,0,0,27865,1082,93,29040,19.61%,20.44%,
105/06/03,-9,4,0,-5,27865,1082,93,29040,19.61%,20.44%,
105/06/02,-3,6,-7,-4,27874,1078,93,29045,19.62%,20.44%,
105/06/01,6,0,2,8,27878,1072,100,29050,19.62%,20.45%,
105/05/31,-17,0,0,-17,27872,1072,98,29042,19.61%,20.43%,
105/05/30,-2,3,8,9,27895,1072,98,29065,19.63%,20.45%,
105/05/27,7,-7,0,0,27897,1069,90,29056,19.63%,20.45%,
105/05/26,4,0,-11,-7,27890,1076,90,29056,19.63%,20.45%,
105/05/25,30,0,-1,29,27886,1076,101,29063,19.62%,20.45%,
105/05/24,28,8,-22,14,27856,1076,102,29034,19.60%,20.43%,
105/05/23,13,0,-5,8,27828,1068,124,29020,19.58%,20.42%,
105/05/20,2,15,-41,-24,27815,1068,129,29012,19.57%,20.41%,
105/05/19,-25,41,41,57,27813,1053,170,29036,19.57%,20.43%,
105/05/18,49,97,-29,117,27838,1012,129,28979,19.59%,20.39%,
105/05/17,-24,42,14,32,27789,915,158,28862,19.56%,20.32%,
105/05/16,-37,51,3,17,27813,873,144,28830,19.57%,20.29%,
105/05/13,-27,30,3,6,27850,822,141,28813,19.60%,20.28%,
105/05/12,-13,63,-2,48,27877,792,138,28807,19.62%,20.27%,
105/05/11,-36,123,11,98,27883,729,140,28752,19.62%,20.23%,
105/05/10,69,92,33,194,27919,606,129,28654,19.65%,20.17%,
105/05/09,36,150,-12,174,27850,514,96,28460,19.60%,20.03%,
105/05/06,9,0,9,18,27814,364,108,28286,19.57%,19.90%,
105/05/05,10,14,13,37,27804,364,99,28267,19.57%,19.90%,
105/05/04,39,0,12,51,27795,350,86,28231,19.56%,19.87%,
105/05/03,-32,0,31,-1,27756,350,74,28180,19.53%,19.83%,
105/04/29,-19,11,-8,-16,27788,350,43,28181,19.56%,19.84%,
105/04/28,14,0,-13,1,27817,339,51,28207,19.58%,19.85%,
105/04/27,2,16,-13,5,27803,339,64,28206,19.57%,19.85%,
105/04/26,0,0,4,4,27801,323,77,28201,19.56%,19.84%,
105/04/25,38,13,0,51,27801,323,73,28197,19.56%,19.84%,
105/04/22,-33,18,1,-14,27763,310,73,28146,19.54%,19.81%,
105/04/21,22,85,22,129,27796,292,72,28160,19.56%,19.82%,
105/04/20,-7,27,-1,19,27774,207,50,28031,19.55%,19.73%,
105/04/19,-4,12,0,8,27781,180,51,28012,19.55%,19.71%,
105/04/18,-2,6,1,5,27785,168,51,28004,19.55%,19.70%,
105/04/15,-117,30,2,-85,27787,162,50,27999,19.55%,19.70%,
105/04/14,-153,29,1,-123,27904,132,48,28084,19.64%,19.77%,
105/04/13,-56,0,-10,-66,28057,103,47,28207,19.74%,19.85%,
105/04/12,-37,0,-1,-38,28113,103,57,28273,19.78%,19.89%,
105/04/11,-18,0,0,-18,28150,103,58,28311,19.81%,19.92%,
105/04/08,-40,0,3,-37,28158,103,58,28319,19.82%,19.93%,
105/04/07,0,0,0,0,28198,103,55,28356,19.84%,19.95%,
105/04/06,7,0,-1,6,28198,103,55,28356,19.84%,19.95%,
105/04/01,-4,0,0,-4,28191,103,56,28350,19.84%,19.95%,
105/03/31,6,0,6,12,28195,103,56,28354,19.84%,19.95%,
105/03/30,3,20,6,29,28189,94,50,28333,19.84%,19.94%,
105/03/29,10,0,-3,7,28186,74,44,28304,19.84%,19.92%,
105/03/28,-7,0,1,-6,28176,74,47,28297,19.83%,19.92%,
105/03/25,5,4,0,9,28183,74,46,28303,19.83%,19.91%,
105/03/24,-1,0,-2,-3,28178,70,46,28294,19.83%,19.91%,
105/03/23,17,40,-23,34,28179,70,48,28297,19.83%,19.91%,
105/03/22,12,30,-6,36,28162,30,71,28263,19.82%,19.89%,
105/03/21,18,0,-6,12,28150,0,77,28227,19.81%,19.86%,
105/03/18,57,0,-3,54,28132,0,83,28215,19.80%,19.86%,
105/03/17,57,0,0,57,28075,0,86,28161,19.76%,19.82%,
105/03/16,8,0,2,10,28017,0,86,28103,19.72%,19.78%,
105/03/15,14,0,2,16,28010,0,84,28094,19.71%,19.77%,
105/03/14,9,0,2,11,27996,0,82,28078,19.70%,19.76%,
105/03/11,10,0,4,14,27987,0,80,28067,19.70%,19.76%,
105/03/10,3,0,3,6,27977,0,76,28053,19.69%,19.74%,
105/03/09,8,0,3,11,27974,0,73,28047,19.69%,19.74%,
105/03/08,-15,0,0,-15,27966,0,70,28036,19.68%,19.73%,
105/03/07,-12,0,0,-12,27981,0,70,28051,19.69%,19.74%,
105/03/04,7,0,4,11,27993,0,70,28063,19.70%,19.75%,
105/03/03,-3,0,2,-1,27986,0,66,28052,19.69%,19.74%,
105/03/02,-14,0,-3,-17,27989,0,64,28053,19.70%,19.75%,
105/03/01,1,0,0,1,28003,0,67,28070,19.71%,19.76%,
105/02/26,39,0,1,40,28002,0,67,28069,19.71%,19.76%,
105/02/25,15,0,0,15,27963,0,66,28029,19.68%,19.73%,
105/02/24,8,0,0,8,27948,0,66,28014,19.67%,19.72%,
105/02/23,9,0,-1,8,27940,0,66,28006,19.66%,19.71%,
105/02/22,22,0,0,22,28473,0,67,28540,20.04%,20.09%,
105/02/19,1,0,-2,-1,28451,0,67,28518,20.02%,20.07%,
105/02/18,0,0,0,0,28450,0,69,28519,20.02%,20.07%,
105/02/17,-7,0,17,10,28450,0,69,28519,20.02%,20.07%,
105/02/16,-12,0,-19,-31,28457,0,52,28509,20.03%,20.07%,
105/02/15,-2,0,2,0,28469,0,71,28540,20.04%,20.09%,
105/02/03,-17,0,-10,-27,28471,0,69,28540,20.04%,20.09%,
105/02/02,-4,0,3,-1,28498,0,79,28577,20.06%,20.12%,
105/02/01,4,0,2,6,28512,0,76,28588,20.07%,20.12%,
105/01/30,0,0,4,4,28508,0,74,28582,20.06%,20.11%,
105/01/29,18,0,0,18,28508,0,70,28578,20.06%,20.11%,
105/01/28,15,0,0,15,28494,0,70,28564,20.05%,20.10%,
105/01/27,-5,0,6,1,28479,0,70,28549,20.04%,20.09%,
105/01/26,-14,0,0,-14,28490,0,64,28554,20.05%,20.10%,
105/01/25,-4,0,4,0,28504,0,64,28568,20.06%,20.11%,
105/01/22,-2,0,-1,-3,28508,0,60,28568,20.06%,20.10%,
105/01/21,-12,0,0,-12,28510,0,61,28571,20.06%,20.10%,
105/01/20,-43,0,-1,-44,28522,0,61,28583,20.07%,20.11%,
105/01/19,11,0,6,17,28565,0,62,28627,20.10%,20.14%,
105/01/18,4,0,0,4,28554,0,56,28610,20.10%,20.14%,
105/01/15,22,-29,0,-7,28550,0,56,28606,20.09%,20.13%,
105/01/14,58,-30,0,28,28528,0,56,28584,20.08%,20.12%,
105/01/13,21,0,0,21,28470,0,56,28526,20.04%,20.08%,
105/01/12,12,-31,-1,-20,28449,0,56,28505,20.02%,20.06%,
105/01/11,7,-30,0,-23,28437,0,57,28494,20.01%,20.05%,
105/01/08,14,-28,0,-14,28430,0,57,28487,20.01%,20.05%,
105/01/07,17,-30,-9,-22,28416,0,57,28473,20.00%,20.04%,
105/01/06,-12,0,-1,-13,28399,5,66,28470,19.99%,20.04%,
105/01/05,13,0,-3,10,28411,5,67,28483,19.99%,20.04%,
105/01/04,-17,-4,-20,-41,28398,5,70,28473,19.99%,20.04%,
104/12/31,0,0,-24,-24,28415,9,90,28514,20.00%,20.07%,
104/12/30,9,-25,-3,-19,28415,221,114,28750,20.00%,20.24%,
104/12/29,23,-47,-34,-58,28406,246,117,28769,19.99%,20.25%,
104/12/28,5,-20,-16,-31,28383,293,151,28827,19.97%,20.28%,
104/12/25,5,-17,-10,-22,28378,313,167,28858,19.97%,20.31%,
104/12/24,23,-1,-18,4,28373,330,177,28880,19.97%,20.33%,
104/12/23,18,0,-1,17,28350,331,195,28876,19.95%,20.32%,
104/12/22,-10,0,1,-9,28332,331,196,28859,19.94%,20.31%,
104/12/21,2,0,-14,-12,28342,331,195,28868,19.95%,20.32%,
104/12/18,2,0,2,4,28340,331,209,28880,19.94%,20.32%,
104/12/17,-12,10,1,-1,28338,331,207,28876,19.94%,20.32%,
104/12/16,11,0,-7,4,28350,321,206,28877,19.95%,20.32%,
104/12/15,-17,0,-26,-43,28339,321,213,28873,19.94%,20.32%,
104/12/14,9,-0,-7,2,28356,321,239,28916,19.96%,20.35%,
104/12/11,26,150,8,184,28363,321,246,28930,19.96%,20.36%,
104/12/10,-2,61,-20,39,28337,171,238,28746,19.94%,20.23%,
104/12/09,-13,0,-10,-23,28357,110,258,28725,19.96%,20.22%,
104/12/08,-10,0,-18,-28,28370,110,268,28748,19.97%,20.24%,
104/12/07,12,0,-9,3,28380,110,286,28776,19.97%,20.25%,
104/12/04,3,0,-1,2,28368,110,295,28773,19.96%,20.25%,
104/12/03,-4,0,-7,-11,28365,110,296,28771,19.96%,20.25%,
104/12/02,-20,0,0,-20,28369,110,303,28782,19.96%,20.25%,
104/12/01,3,0,3,6,28389,110,303,28802,19.98%,20.27%,
104/11/30,-26,10,-14,-30,28386,110,300,28796,19.98%,20.27%,
104/11/27,1,0,10,11,28412,100,314,28826,19.99%,20.28%,
104/11/26,28,0,6,34,28411,100,304,28815,19.99%,20.27%,
104/11/25,-10,0,-10,-20,28383,100,298,28781,19.97%,20.25%,
104/11/24,4,0,-31,-27,28393,100,308,28801,19.98%,20.27%,
104/11/23,-1,12,-17,-6,28389,100,339,28828,19.98%,20.29%,
104/11/20,2,10,-75,-63,28397,88,356,28841,19.98%,20.29%,
104/11/19,-35,59,-87,-63,28395,78,431,28904,19.98%,20.34%,
104/11/18,43,10,-27,26,28418,19,518,28955,20.00%,20.38%,
104/11/17,46,0,74,120,28375,9,545,28929,19.97%,20.36%,
104/11/16,-14,0,46,32,28329,9,471,28809,19.94%,20.28%,
104/11/13,-15,0,12,-3,28343,9,425,28777,19.95%,20.26%,
104/11/12,3,0,30,33,28358,9,413,28780,19.96%,20.26%,
104/11/11,-115,0,-18,-133,28355,9,383,28747,19.95%,20.23%,
104/11/10,-64,0,-10,-74,28470,9,401,28880,20.04%,20.33%,
104/11/09,-109,0,24,-85,28534,9,411,28954,20.08%,20.38%,
104/11/06,-122,0,45,-77,28643,9,387,29039,20.16%,20.44%,
104/11/05,-23,0,37,14,28765,9,342,29116,20.24%,20.49%,
104/11/04,-272,0,54,-218,28788,9,305,29102,20.26%,20.48%,
104/11/03,-122,-89,18,-193,29042,9,251,29302,20.44%,20.62%,
104/11/02,-218,0,82,-136,29154,98,233,29485,20.52%,20.75%,
104/10/30,-289,0,-16,-305,29365,98,151,29614,20.67%,20.85%,
104/10/29,-268,0,17,-251,29654,98,167,29919,20.87%,21.06%,
104/10/28,-115,0,0,-115,29912,98,150,30160,21.05%,21.22%,
104/10/27,-205,89,30,-86,30027,98,150,30275,21.13%,21.30%,
104/10/26,-130,0,59,-71,30232,9,120,30361,21.28%,21.37%,
104/10/23,-120,0,38,-82,30362,9,61,30432,21.37%,21.42%,
104/10/22,-125,0,15,-110,30482,9,23,30514,21.45%,21.47%,
104/10/21,-27,0,0,-27,30607,9,8,30624,21.54%,21.55%,
104/10/20,-144,0,8,-136,30634,9,8,30651,21.56%,21.57%,
104/10/19,-225,0,0,-225,30778,9,0,30787,21.66%,21.67%,
104/10/16,-167,0,0,-167,31003,9,0,31012,21.82%,21.83%,
104/10/15,-22,0,0,-22,31170,9,0,31179,21.94%,21.95%,
104/10/14,-163,0,-89,-252,31192,9,0,31201,21.95%,21.96%,
104/10/13,-178,0,0,-178,31355,9,2,31366,22.07%,22.08%,
104/10/12,-184,0,1,-183,31533,9,2,31544,22.19%,22.20%,
104/10/08,-346,0,-1,-347,31703,9,1,31713,22.31%,22.32%,
104/10/07,-25,0,1,-24,32049,9,2,32060,22.56%,22.57%,
104/10/06,-170,0,0,-170,32074,9,1,32084,22.57%,22.58%,
104/10/05,-149,0,1,-148,32244,9,1,32254,22.69%,22.70%,
104/10/02,-162,0,0,-162,32393,9,0,32402,22.80%,22.81%,
104/10/01,-139,0,0,-139,32555,9,0,32564,22.91%,22.92%,
104/09/30,-20,0,0,-20,32694,9,0,32703,23.01%,23.02%,
104/09/25,-49,0,0,-49,32714,0,0,32714,23.02%,23.02%,
104/09/24,-80,0,-1,-81,32763,0,0,32763,23.06%,23.06%,
104/09/23,-98,0,-3,-101,32843,0,0,32843,23.11%,23.11%,
104/09/22,-72,0,0,-72,32941,0,0,32941,23.18%,23.18%,
104/09/21,-100,0,-2,-102,33013,0,0,33013,23.23%,23.23%,
104/09/18,-145,0,-4,-149,33113,0,0,33113,23.30%,23.30%,
104/09/17,-50,0,1,-49,33257,0,1,33258,23.41%,23.41%,
104/09/16,-63,0,-6,-69,33307,0,0,33307,23.44%,23.44%,
104/09/15,-97,0,-51,-148,33370,0,0,33370,23.49%,23.49%,
104/09/14,26,0,-26,0,33467,0,0,33467,23.55%,23.55%,
104/09/11,-244,0,-12,-256,33441,0,0,33441,23.54%,23.54%,
104/09/10,-81,0,-9,-90,33685,0,0,33685,23.71%,23.71%,
104/09/09,-122,0,-15,-137,33766,0,0,33766,23.76%,23.76%,
104/09/08,-19,0,0,-19,33888,0,0,33888,23.85%,23.85%,
104/09/07,18,0,0,18,33907,0,0,33907,23.86%,23.86%,
104/09/04,-17,0,0,-17,33889,0,0,33889,23.85%,23.85%,
104/09/03,-108,0,-37,-145,33906,0,0,33906,23.86%,23.86%,
104/09/02,-19,0,0,-19,34014,0,0,34014,23.94%,23.94%,
104/09/01,-46,0,-3,-49,34038,0,0,34038,23.96%,23.96%,
104/08/31,23,0,0,23,34084,0,0,34084,23.99%,23.99%,
104/08/28,-15,0,-3,-18,34061,0,0,34061,23.97%,23.97%,
104/08/27,-106,-33,-3,-142,34076,0,0,34076,23.98%,23.98%,
104/08/26,-33,-45,0,-78,34182,0,0,34182,24.06%,24.06%,
104/08/25,-54,-60,0,-114,34215,39,0,34254,24.08%,24.11%,
104/08/24,-185,0,-46,-231,34269,99,0,34368,24.12%,24.19%,
104/08/21,-85,0,4,-81,34454,99,17,34570,24.25%,24.33%,
104/08/20,-25,0,-4,-29,34539,99,13,34651,24.31%,24.39%,
104/08/19,-19,-16,-11,-46,34564,99,17,34680,24.33%,24.41%,
104/08/18,31,0,-4,27,34583,115,28,34726,24.34%,24.44%,
104/08/17,17,0,-1,16,34552,115,32,34699,24.32%,24.42%,
104/08/14,26,0,-2,24,34535,115,33,34683,24.31%,24.41%,
104/08/13,4,0,1,5,34509,115,35,34659,24.29%,24.40%,
104/08/12,-1,0,5,4,34556,115,34,34705,24.32%,24.42%,
104/08/11,72,-21,-11,40,34557,115,29,34701,24.32%,24.42%,
104/08/10,15,0,-1,14,34490,136,40,34666,24.27%,24.39%,
104/08/07,-23,-6,0,-29,34470,136,41,34647,24.26%,24.38%,
104/08/06,-41,-30,0,-71,34493,142,41,34676,24.28%,24.41%,
104/08/05,-18,-90,1,-107,34534,172,41,34747,24.30%,24.45%,
104/08/04,-9,-2,9,-2,34537,262,40,34839,24.31%,24.52%,
104/08/03,-68,-20,-5,-93,34546,264,31,34841,24.31%,24.52%,
104/07/31,-15,-80,-4,-99,34620,284,36,34940,24.37%,24.60%,
104/07/30,6,-50,-7,-51,34635,364,40,35039,24.38%,24.66%,
104/07/29,-122,0,0,-122,34583,414,47,35044,24.34%,24.66%,
104/07/28,-11,-18,-38,-67,34705,414,47,35166,24.43%,24.75%,
104/07/27,-22,-2,-53,-77,34716,432,85,35233,24.43%,24.79%,
104/07/24,11,-28,-18,-35,34738,434,138,35310,24.45%,24.85%,
104/07/23,-47,-12,-33,-92,34729,462,156,35347,24.44%,24.88%,
104/07/22,-60,-8,0,-68,34776,474,189,35439,24.48%,24.95%,
104/07/21,-191,-4,-2,-197,34836,482,189,35507,24.52%,24.99%,
104/07/20,-32,-10,-5,-47,35027,486,191,35704,24.65%,25.13%,
104/07/17,-3,-10,-19,-32,35059,496,196,35751,24.67%,25.16%,
104/07/16,-77,0,0,-77,35062,506,215,35783,24.68%,25.19%,
104/07/15,-82,0,-5,-87,35140,506,215,35861,24.73%,25.24%,
104/07/14,-29,-61,-2,-92,35222,506,220,35948,24.79%,25.30%,
104/07/13,-14,0,-5,-19,35251,567,222,36040,24.81%,25.37%,
104/07/09,-17,0,-10,-27,35265,567,227,36059,24.82%,25.38%,
104/07/08,-49,0,-10,-59,35279,567,237,36083,24.83%,25.40%,
104/07/07,-12,0,2,-10,35328,567,247,36142,24.86%,25.43%,
104/07/06,-3,0,-4,-7,35340,567,245,36152,24.87%,25.44%,
104/07/03,-23,-14,4,-33,35343,567,249,36159,24.87%,25.44%,
104/07/02,-12,10,0,-2,35366,581,245,36192,24.89%,25.47%,
104/07/01,2,-14,1,-11,35378,571,245,36194,24.90%,25.47%,
104/06/30,-8,0,-2,-10,35376,585,244,36205,24.90%,25.48%,
104/06/29,-25,0,0,-25,35384,534,246,36164,24.90%,25.45%,
104/06/26,-26,-4,-21,-51,35409,534,246,36189,24.92%,25.47%,
104/06/25,-39,-12,64,13,35435,538,267,36240,24.94%,25.51%,
104/06/24,-66,-28,6,-88,35474,550,203,36227,24.97%,25.50%,
104/06/23,-65,-17,1,-81,35540,578,197,36315,25.01%,25.56%,
104/06/22,-110,-38,24,-124,35605,595,196,36396,25.06%,25.62%,
104/06/18,-52,-57,-2,-111,35715,633,172,36520,25.14%,25.71%,
104/06/17,-75,-4,15,-64,35767,690,174,36631,25.17%,25.78%,
104/06/16,-43,0,-2,-45,35842,694,159,36695,25.23%,25.83%,
104/06/15,-5,0,-4,-9,35885,694,161,36740,25.26%,25.86%,
104/06/12,28,0,21,49,35890,694,165,36749,25.26%,25.86%,
104/06/11,30,0,-6,24,35862,694,144,36700,25.24%,25.83%,
104/06/10,28,0,25,53,35832,694,150,36676,25.22%,25.81%,
104/06/09,4,0,-6,-2,35804,694,125,36623,25.20%,25.78%,
104/06/08,-17,0,-5,-22,35800,694,131,36625,25.20%,25.78%,
104/06/05,-34,0,50,16,35817,694,136,36647,25.21%,25.79%,
104/06/04,-44,0,-20,-64,35851,694,86,36631,25.23%,25.78%,
104/06/03,68,10,-73,5,35895,694,106,36695,25.26%,25.82%,
104/06/02,-20,15,-48,-53,35827,684,179,36690,25.21%,25.82%,
104/06/01,20,-1,-33,-14,35847,669,227,36743,25.23%,25.86%,
104/05/29,17,-73,28,-28,35827,670,260,36757,25.21%,25.86%,
104/05/28,-98,0,80,-18,35810,743,232,36785,25.20%,25.89%,
104/05/27,100,33,75,208,35908,743,152,36803,25.27%,25.90%,
104/05/26,100,-7,29,122,35809,710,77,36596,25.20%,25.75%,
104/05/25,-44,-8,14,-38,35709,717,48,36474,25.13%,25.67%,
104/05/22,-211,-25,-22,-258,35753,725,34,36512,25.16%,25.69%,
104/05/21,-15,0,-7,-22,35964,750,56,36770,25.31%,25.88%,
104/05/20,-59,0,27,-32,35979,750,63,36792,25.32%,25.89%,
104/05/19,-13,0,0,-13,36038,750,36,36824,25.36%,25.91%,
104/05/18,8,0,1,9,36051,750,36,36837,25.37%,25.92%,
104/05/15,9,0,-22,-13,36043,750,35,36828,25.37%,25.92%,
104/05/14,-5,0,-44,-49,36034,750,57,36841,25.36%,25.93%,
104/05/13,9,4,67,80,36039,750,101,36890,25.36%,25.96%,
104/05/12,19,0,4,23,36030,746,34,36810,25.36%,25.91%,
104/05/11,126,0,2,128,36011,746,30,36787,25.34%,25.89%,
104/05/08,-11,0,-2,-13,35885,746,28,36659,25.26%,25.80%,
104/05/07,12,0,2,14,35896,746,30,36672,25.26%,25.81%,
104/05/06,13,0,0,13,35884,746,28,36658,25.25%,25.79%,
104/05/05,32,0,0,32,35871,746,28,36645,25.25%,25.79%,
104/05/04,52,0,-2,50,35839,746,28,36613,25.22%,25.76%,
104/04/30,204,30,1,235,35787,746,30,36563,25.19%,25.74%,
104/04/29,23,0,13,36,35583,716,29,36328,25.04%,25.56%,
104/04/28,143,5,0,148,35560,716,16,36292,25.03%,25.55%,
104/04/27,178,84,0,262,35416,711,16,36143,24.93%,25.44%,
104/04/24,271,13,0,284,35238,627,16,35881,24.80%,25.25%,
104/04/23,258,-53,1,206,34967,614,16,35597,24.61%,25.05%,
104/04/22,66,-44,0,22,34710,667,15,35392,24.43%,24.91%,
104/04/21,78,-55,5,28,34644,711,15,35370,24.38%,24.89%,
104/04/20,15,-126,4,-107,34566,766,10,35342,24.33%,24.88%,
104/04/17,14,-88,0,-74,34551,892,6,35449,24.32%,24.95%,
104/04/16,66,-37,-4,25,34537,980,6,35523,24.31%,25.00%,
104/04/15,13,-110,10,-87,34471,1017,10,35498,24.26%,24.98%,
104/04/14,-22,-60,0,-82,34458,1127,0,35585,24.25%,25.04%,
104/04/13,-40,-41,-2,-83,34480,1187,0,35667,24.27%,25.11%,
104/04/10,167,5,-10,162,34520,1228,0,35748,24.29%,25.15%,
104/04/09,43,8,-5,46,34353,1223,4,35580,24.18%,25.04%,
104/04/08,118,-75,8,51,34310,1215,9,35534,24.15%,25.01%,
104/04/07,55,11,1,67,34192,1290,1,35483,24.06%,24.97%,
104/04/02,149,38,-106,81,32117,1279,0,33396,22.60%,23.50%,
104/04/01,508,-130,-13,365,31968,1241,62,33271,22.50%,23.42%,
104/03/31,-55,-11,-86,-152,31460,1371,75,32906,22.14%,23.16%,
104/03/30,46,-25,2,23,31515,1501,161,33177,22.18%,23.35%,
104/03/27,17,-20,-20,-23,31469,1526,159,33154,22.15%,23.34%,
104/03/26,28,-58,0,-30,31452,1546,179,33177,22.14%,23.35%,
104/03/25,31,-50,8,-11,31424,1604,179,33207,22.12%,23.38%,
104/03/24,-85,-50,-82,-217,31393,1654,171,33218,22.09%,23.37%,
104/03/23,77,-100,-46,-69,31478,1704,253,33435,22.15%,23.53%,
104/03/20,130,-101,-18,11,31401,1804,299,33504,22.10%,23.58%,
104/03/19,42,-144,-4,-106,31271,1905,317,33493,22.01%,23.57%,
104/03/18,-106,0,2,-104,31229,2049,321,33599,21.98%,23.65%,
104/03/17,-3,0,-2,-5,31335,2049,319,33703,22.05%,23.72%,
104/03/16,78,0,-4,74,31338,2049,321,33708,22.06%,23.73%,
104/03/13,-57,-48,17,-88,31260,2049,325,33634,22.00%,23.67%,
104/03/12,9,12,-6,15,31317,2097,308,33722,22.04%,23.73%,
104/03/11,62,-101,-46,-85,31308,2085,314,33707,22.03%,23.72%,
104/03/10,142,-267,-133,-258,31246,2186,360,33792,21.99%,23.78%,
104/03/09,20,-156,-16,-152,31104,2453,493,34050,21.89%,23.96%,
104/03/06,29,0,83,112,31084,2609,509,34202,21.88%,24.07%,
104/03/05,552,27,92,671,31055,2609,426,34090,21.86%,24.00%,
104/03/04,161,60,2,223,30503,2582,334,33419,21.47%,23.52%,
104/03/03,-4,-86,41,-49,30342,2522,332,33196,21.35%,23.36%,
104/03/02,22,25,1,48,30346,2608,291,33245,21.36%,23.40%,
104/02/26,69,60,6,135,30324,2583,290,33197,21.34%,23.36%,
104/02/25,274,34,12,320,30255,2523,284,33062,21.29%,23.27%,
104/02/24,74,-20,-5,49,29981,2489,272,32742,21.10%,23.04%,
104/02/13,41,-20,6,27,29907,2509,277,32693,21.05%,23.01%,
104/02/12,13,40,6,59,29866,2529,271,32666,21.02%,22.99%,
104/02/11,-26,79,3,56,29853,2489,265,32607,21.01%,22.95%,
104/02/10,239,-24,-32,183,29879,2410,262,32551,21.03%,22.91%,
104/02/09,83,-83,-10,-10,29640,2434,294,32368,20.86%,22.78%,
104/02/06,52,0,-13,39,29557,2517,304,32378,20.80%,22.79%,
104/02/05,-47,35,-37,-49,29505,2517,317,32339,20.76%,22.75%,
104/02/04,104,0,-61,43,29552,2482,354,32388,20.80%,22.80%,
104/02/03,190,7,-4,193,29448,2482,415,32345,20.72%,22.76%,
104/02/02,209,-179,-14,16,29258,2475,419,32152,20.59%,22.63%,
104/01/30,92,0,3,95,29049,2654,433,32136,20.44%,22.61%,
104/01/29,6,-30,0,-24,28957,2654,430,32041,20.38%,22.55%,
104/01/28,67,16,-2,81,28951,2684,430,32065,20.37%,22.56%,
104/01/27,122,30,65,217,28884,2668,432,31984,20.33%,22.51%,
104/01/26,179,-3,-113,63,28762,2638,367,31767,20.24%,22.36%,
104/01/23,-138,-20,10,-148,28582,2641,480,31703,20.12%,22.32%,
104/01/22,-50,0,34,-16,28720,2661,470,31851,20.21%,22.41%,
104/01/21,3,-5,23,21,28770,2661,436,31867,20.25%,22.43%,
104/01/20,-5,0,0,-5,28767,2666,413,31846,20.25%,22.42%,
104/01/19,132,0,-28,104,28772,2666,413,31851,20.25%,22.42%,
104/01/16,-1,30,-110,-81,28640,2666,441,31747,20.16%,22.35%,
104/01/15,16,14,-39,-9,28641,2636,551,31828,20.16%,22.40%,
104/01/14,-35,6,-43,-72,28625,2622,590,31837,20.15%,22.41%,
104/01/13,53,0,-27,26,28660,2616,633,31909,20.17%,22.46%,
104/01/12,173,30,13,216,28607,2616,660,31883,20.13%,22.44%,
104/01/09,63,3,-2,64,28434,2586,647,31667,20.01%,22.29%,
104/01/08,52,8,52,112,28371,2583,649,31603,19.97%,22.25%,
104/01/07,106,103,31,240,28320,2575,597,31492,19.93%,22.16%,
104/01/06,89,75,-11,153,28214,2472,566,31252,19.86%,22.00%,
104/01/05,73,102,-50,125,28125,2397,577,31099,19.79%,21.88%,
