日期,外資買賣超,投信買賣超,自營商買賣超,單日合計買賣超,外資估計持股,投信估計持股,自營商估計持股,單日合計估計持股,外資持股比重,三大法人持股比重,
107/03/31,0,-2,-6,-8,127208,58,3383,130649,28.91%,29.69%,
107/03/30,42,0,5,47,127208,60,3389,130657,28.91%,29.69%,
107/03/29,-85,0,-18,-103,127166,60,3384,130610,28.90%,29.68%,
107/03/28,-58,0,-1,-59,127251,60,3402,130713,28.92%,29.71%,
107/03/27,-61,0,-4,-65,127400,60,3403,130863,28.95%,29.74%,
107/03/26,55,0,-8,47,127461,60,3407,130928,28.97%,29.76%,
107/03/23,-513,0,-136,-649,127406,60,3415,130881,28.95%,29.74%,
107/03/22,-362,0,-53,-415,127919,60,3551,131530,29.07%,29.89%,
107/03/21,56,0,-149,-93,128281,60,3604,131945,29.15%,29.98%,
107/03/20,58,0,30,88,128333,60,3753,132146,29.17%,30.04%,
107/03/19,72,0,-8,64,128450,60,3723,132233,29.19%,30.05%,
107/03/16,-719,0,-68,-787,128398,60,3731,132189,29.18%,30.04%,
107/03/15,-24,0,-18,-42,129107,60,3799,132966,29.34%,30.22%,
107/03/14,-17,0,28,11,129108,60,3817,132985,29.34%,30.22%,
107/03/13,99,0,-13,86,129362,60,3789,133211,29.40%,30.27%,
107/03/12,-91,0,-7,-98,129100,60,3802,132962,29.34%,30.22%,
107/03/09,126,0,-75,51,129094,60,3809,132963,29.34%,30.22%,
107/03/08,107,0,51,158,129007,60,3884,132951,29.32%,30.22%,
107/03/07,189,0,-14,175,129460,60,3833,133353,29.42%,30.30%,
107/03/06,59,0,-86,-27,129271,60,3847,133178,29.38%,30.27%,
107/03/05,-199,0,-44,-243,129223,60,3933,133216,29.37%,30.28%,
107/03/02,68,0,49,117,129704,60,3977,133741,29.48%,30.40%,
107/03/01,870,0,432,1302,129647,60,3928,133635,29.46%,30.37%,
107/02/27,361,0,93,454,128787,60,3496,132343,29.27%,30.08%,
107/02/26,304,0,-67,237,128416,60,3403,131879,29.18%,29.97%,
107/02/23,-383,0,49,-334,128149,60,3470,131679,29.12%,29.92%,
107/02/22,549,0,-26,523,128493,60,3421,131974,29.20%,29.99%,
107/02/21,363,0,91,454,127944,60,3447,131451,29.08%,29.88%,
107/02/12,-135,0,35,-100,127482,60,3356,130898,28.97%,29.75%,
107/02/09,-340,0,-53,-393,127530,60,3321,130911,28.98%,29.75%,
107/02/08,352,0,-40,312,127753,60,3374,131187,29.03%,29.81%,
107/02/07,-399,0,-23,-422,127448,60,3414,130922,28.96%,29.75%,
107/02/06,673,0,-135,538,127522,60,3437,131019,28.98%,29.77%,
107/02/05,340,0,-44,296,126691,60,3572,130323,28.79%,29.61%,
107/02/02,592,0,-2,590,126241,60,3616,129917,28.69%,29.52%,
107/02/01,402,0,-30,372,125589,60,3618,129267,28.54%,29.38%,
107/01/31,223,0,239,462,125552,60,3648,129260,28.53%,29.37%,
107/01/30,240,0,21,261,126514,60,3409,129983,28.75%,29.54%,
107/01/29,132,0,-6,126,125868,60,3388,129316,28.61%,29.39%,
107/01/26,175,0,5,180,125730,60,3394,129184,28.57%,29.35%,
107/01/25,167,0,-9,158,125515,60,3389,128964,28.52%,29.30%,
107/01/24,-95,0,7,-88,125304,60,3398,128762,28.48%,29.27%,
107/01/23,-377,0,-38,-415,125224,60,3391,128675,28.46%,29.24%,
107/01/22,230,-50,84,264,125604,60,3429,129093,28.55%,29.34%,
107/01/19,-35,0,-73,-108,125374,110,3345,128829,28.49%,29.27%,
107/01/18,585,-64,74,595,125310,110,3418,128838,28.48%,29.28%,
107/01/17,320,0,-12,308,124762,174,3344,128280,28.35%,29.15%,
107/01/16,207,0,-51,156,124964,174,3356,128494,28.40%,29.20%,
107/01/15,280,-1,62,341,124639,174,3407,128220,28.33%,29.14%,
107/01/12,-715,0,17,-698,124273,175,3345,127793,28.24%,29.04%,
107/01/11,-53,0,-5,-58,124920,175,3328,128423,28.39%,29.19%,
107/01/10,171,0,-37,134,124878,175,3333,128386,28.38%,29.18%,
107/01/09,294,0,-2,292,125820,175,3370,129365,28.59%,29.39%,
107/01/08,531,-1,7,537,126522,175,3372,130069,28.75%,29.56%,
107/01/05,431,-1,-69,361,126025,176,3365,129566,28.64%,29.44%,
107/01/04,435,0,88,523,125650,177,3434,129261,28.56%,29.38%,
107/01/03,407,0,-60,347,125169,177,3346,128692,28.45%,29.25%,
107/01/02,148,0,47,195,124762,177,3406,128345,28.35%,29.16%,
106/12/29,480,-2,28,506,124568,177,3359,128104,28.31%,29.11%,
106/12/28,281,0,1,282,124238,174,3331,127743,28.23%,29.03%,
106/12/27,165,-2,-11,152,123957,174,3330,127461,28.17%,28.97%,
106/12/26,-2,-3,-49,-54,123792,176,3341,127309,28.13%,28.93%,
106/12/25,109,0,27,136,123783,179,3390,127352,28.13%,28.94%,
106/12/22,42,0,-5,37,123674,179,3363,127216,28.11%,28.92%,
106/12/21,313,0,-13,300,123632,179,3368,127179,28.10%,28.91%,
106/12/20,-7,0,-34,-41,123499,179,3381,127059,28.07%,28.88%,
106/12/19,87,0,21,108,123632,179,3415,127226,28.10%,28.92%,
106/12/18,475,0,-38,437,123535,179,3394,127108,28.07%,28.88%,
106/12/15,-19,0,-132,-151,123035,179,3432,126646,27.96%,28.78%,
106/12/14,-365,0,-16,-381,123085,179,3564,126828,27.97%,28.82%,
106/12/13,152,0,-9,143,123788,179,3580,127547,28.13%,28.98%,
106/12/12,190,0,27,217,123667,179,3589,127435,28.10%,28.96%,
106/12/11,436,-220,25,241,123464,179,3562,127205,28.06%,28.91%,
106/12/08,74,0,-33,41,123028,399,3537,126964,27.96%,28.85%,
106/12/07,242,0,-11,231,122972,399,3570,126941,27.95%,28.85%,
106/12/06,1678,0,-36,1642,122700,399,3581,126680,27.89%,28.79%,
106/12/05,390,0,-57,333,121004,399,3617,125020,27.50%,28.41%,
106/12/04,201,0,34,235,120542,399,3674,124615,27.39%,28.32%,
106/12/01,238,0,-119,119,120573,399,3640,124612,27.40%,28.32%,
106/11/30,673,0,4,677,119740,399,3759,123898,27.21%,28.16%,
106/11/29,-566,0,-7,-573,119026,399,3755,123180,27.05%,27.99%,
106/11/28,63,0,-11,52,119511,399,3762,123672,27.16%,28.11%,
106/11/27,-71,-180,-149,-400,119404,399,3773,123576,27.14%,28.09%,
106/11/24,-981,0,-61,-1042,119474,579,3922,123975,27.15%,28.17%,
106/11/23,-69,-4,40,-33,120381,579,3983,124943,27.36%,28.40%,
106/11/22,827,0,-266,561,120451,583,3943,124977,27.37%,28.40%,
106/11/21,-702,0,461,-241,119613,583,4209,124405,27.18%,28.27%,
106/11/20,-561,0,-25,-586,120301,583,3748,124632,27.34%,28.32%,
106/11/17,-853,0,25,-828,120767,583,3773,125123,27.45%,28.44%,
106/11/16,-1067,0,-28,-1095,121308,583,3748,125639,27.57%,28.55%,
106/11/15,-610,0,-105,-715,121866,583,3776,126225,27.70%,28.69%,
106/11/14,-1472,0,-119,-1591,122008,583,3881,126472,27.73%,28.74%,
106/11/13,-828,0,-166,-994,123282,583,4000,127865,28.02%,29.06%,
106/11/10,-125,0,-201,-326,124105,583,4166,128854,28.20%,29.28%,
106/11/09,1285,0,-91,1194,124229,583,4367,129179,28.23%,29.36%,
106/11/08,-769,0,-457,-1226,122784,583,4458,127825,27.90%,29.05%,
106/11/07,725,0,501,1226,123553,583,4915,129051,28.08%,29.33%,
106/11/06,-519,0,672,153,122746,583,4414,127743,27.90%,29.04%,
106/11/03,-17,0,17,0,123196,583,3742,127521,28.00%,28.98%,
106/11/02,43,0,-13,30,123213,583,3725,127521,28.00%,28.98%,
106/11/01,-84,0,41,-43,123338,583,3738,127659,28.03%,29.01%,
106/10/31,-285,0,2,-283,123422,583,3697,127702,28.05%,29.02%,
106/10/30,651,0,-48,603,123646,583,3695,127924,28.10%,29.07%,
106/10/27,-548,46,-217,-719,123592,583,3743,127918,28.09%,29.07%,
106/10/26,-387,0,-33,-420,123905,537,3960,128402,28.16%,29.18%,
106/10/25,-963,12,120,-831,124170,537,3993,128700,28.22%,29.25%,
106/10/24,-546,0,175,-371,124113,525,3873,128511,28.21%,29.21%,
106/10/23,210,114,95,419,123928,525,3698,128151,28.16%,29.12%,
106/10/20,299,0,-91,208,123718,411,3603,127732,28.12%,29.03%,
106/10/19,72,0,30,102,123304,411,3694,127409,28.02%,28.95%,
106/10/18,-119,0,22,-97,123231,411,3664,127306,28.01%,28.94%,
106/10/17,64,0,4,68,123349,411,3642,127402,28.03%,28.95%,
106/10/16,311,0,-69,242,123422,411,3638,127471,28.05%,28.97%,
106/10/13,16,0,0,16,123072,411,3707,127190,27.97%,28.91%,
106/10/12,441,0,-480,-39,122944,411,3707,127062,27.94%,28.88%,
106/10/11,221,0,-11,210,122403,411,4187,127001,27.82%,28.87%,
106/10/06,-321,0,-103,-424,122182,411,4198,126791,27.77%,28.82%,
106/10/05,10,0,-61,-51,122531,411,4301,127243,27.85%,28.92%,
106/10/03,16,1,-93,-76,122461,411,4362,127234,27.83%,28.91%,
106/10/02,-412,0,-3,-415,122370,410,4455,127235,27.81%,28.91%,
106/09/30,0,0,40,40,122492,410,4458,127360,27.84%,28.94%,
106/09/29,373,0,-37,336,122492,364,4418,127274,27.84%,28.92%,
106/09/28,168,0,168,336,122216,364,4455,127035,27.77%,28.86%,
106/09/27,270,0,75,345,122113,364,4287,126764,27.75%,28.80%,
106/09/26,40,0,-380,-340,121843,364,4212,126419,27.69%,28.73%,
106/09/25,610,0,-146,464,121672,364,4592,126628,27.65%,28.77%,
106/09/22,464,0,-105,359,121062,364,4738,126164,27.51%,28.67%,
106/09/21,761,0,-13,748,120681,364,4843,125888,27.43%,28.61%,
106/09/20,351,0,366,717,120026,364,4856,125246,27.28%,28.46%,
106/09/19,1114,0,-67,1047,119959,364,4490,124813,27.26%,28.36%,
106/09/18,329,0,57,386,118825,364,4557,123746,27.00%,28.12%,
106/09/15,1000,0,393,1393,118472,364,4500,123336,26.92%,28.02%,
106/09/14,-335,0,75,-260,117520,364,4107,121991,26.71%,27.72%,
106/09/13,-168,0,-28,-196,117813,364,4032,122209,26.77%,27.77%,
106/09/12,-338,0,-39,-377,117971,364,4060,122395,26.81%,27.81%,
106/09/11,10,0,56,66,118180,364,4099,122643,26.86%,27.87%,
106/09/08,-271,0,-56,-327,118170,364,4043,122577,26.86%,27.86%,
106/09/07,-318,0,167,-151,118387,364,4099,122850,26.90%,27.91%,
106/09/06,-151,0,-5,-156,118650,364,3932,122946,26.89%,27.86%,
106/09/05,-164,0,16,-148,118794,364,3937,123095,26.93%,27.91%,
106/09/04,-342,0,-167,-509,118948,364,3921,123233,26.96%,27.93%,
106/09/01,-217,0,-35,-252,119238,364,4088,123690,27.03%,28.04%,
106/08/31,-59,0,-12,-71,119261,364,4123,123748,27.03%,28.05%,
106/08/30,-284,0,-42,-326,119235,364,4135,123734,27.03%,28.05%,
106/08/29,-870,0,-113,-983,119277,364,4177,123818,27.04%,28.07%,
106/08/28,-1108,0,-185,-1293,119916,364,4290,124570,27.18%,28.24%,
106/08/25,-260,0,650,390,120951,364,4475,125790,27.42%,28.52%,
106/08/24,-237,0,30,-207,121211,364,3825,125400,27.48%,28.43%,
106/08/23,-75,0,-21,-96,121448,364,3795,125607,27.53%,28.47%,
106/08/22,-100,0,19,-81,121523,364,3816,125703,27.55%,28.50%,
106/08/21,-340,0,51,-289,121589,364,3797,125750,27.56%,28.50%,
106/08/18,-164,0,-102,-266,121878,364,3746,125988,27.63%,28.56%,
106/08/17,-285,0,60,-225,121995,364,3848,126207,27.65%,28.60%,
106/08/16,-12,0,-116,-128,122130,364,3788,126282,27.68%,28.62%,
106/08/15,105,0,-63,42,122132,364,3904,126400,27.68%,28.65%,
106/08/14,75,0,12,87,122027,364,3967,126358,27.66%,28.64%,
106/08/11,427,0,-13,414,121952,364,3955,126271,27.64%,28.62%,
106/08/10,159,0,-113,46,121525,364,3968,125857,27.55%,28.53%,
106/08/09,468,0,18,486,121366,364,4081,125811,27.51%,28.52%,
106/08/08,268,0,-33,235,120898,364,4063,125325,27.40%,28.40%,
106/08/07,314,0,78,392,120630,364,4096,125090,27.34%,28.35%,
106/08/04,527,0,57,584,120316,364,4018,124698,27.27%,28.26%,
106/08/03,-258,0,-7,-265,119789,364,3961,124114,27.15%,28.13%,
106/08/02,-206,0,-90,-296,120047,364,3968,124379,27.21%,28.19%,
106/08/01,288,0,110,398,119997,364,4058,124419,27.20%,28.20%,
106/07/31,-301,0,34,-267,119709,364,3948,124021,27.13%,28.11%,
106/07/28,-205,-535,-147,-887,119710,364,3914,123988,27.13%,28.10%,
106/07/27,1085,-410,-409,266,121027,899,4061,125987,27.43%,28.55%,
106/07/26,-390,140,676,426,119961,1309,4470,125740,27.19%,28.50%,
106/07/25,-638,0,-69,-707,120351,1169,3794,125314,27.28%,28.41%,
106/07/24,70,0,-16,54,120989,1169,3863,126021,27.42%,28.56%,
106/07/21,124,0,-7,117,121005,1169,3879,126053,27.43%,28.57%,
106/07/20,392,-115,22,299,121486,1169,3886,126541,27.54%,28.69%,
106/07/19,9,0,-62,-53,121094,1284,3864,126242,27.45%,28.62%,
106/07/18,219,0,2,221,121084,1284,3926,126294,27.45%,28.63%,
106/07/17,554,0,77,631,120865,1284,3924,126073,27.40%,28.58%,
106/07/14,340,0,102,442,120311,1284,3847,125442,27.27%,28.43%,
106/07/13,264,0,70,334,119971,1284,3745,125000,27.19%,28.33%,
106/07/12,493,115,225,833,119732,1284,3675,124691,27.14%,28.26%,
106/07/11,892,0,85,977,119243,1169,3450,123862,27.03%,28.08%,
106/07/10,362,-200,10,172,118351,1169,3365,122885,26.83%,27.86%,
106/07/07,173,0,-25,148,117989,1369,3355,122713,26.74%,27.81%,
106/07/06,138,-200,-44,-106,117816,1369,3380,122565,26.71%,27.79%,
106/07/05,137,0,23,160,117678,1569,3424,122671,26.67%,27.80%,
106/07/04,4,-200,-1,-197,117541,1569,3401,122511,26.64%,27.77%,
106/07/03,-259,0,22,-237,117539,1769,3402,122710,26.64%,27.81%,
106/06/30,36,3,-43,-4,117798,1769,3380,122947,26.70%,27.87%,
106/06/29,-59,-150,56,-153,117748,1562,3423,122733,26.69%,27.82%,
106/06/28,154,0,9,163,117794,1712,3367,122873,26.70%,27.85%,
106/06/27,121,0,-16,105,117719,1712,3358,122789,26.68%,27.83%,
106/06/26,-8,0,32,24,117588,1712,3374,122674,26.65%,27.80%,
106/06/23,-47,0,-15,-62,117596,1712,3342,122650,26.66%,27.81%,
106/06/22,-470,0,42,-428,117643,1712,3357,122712,26.67%,27.82%,
106/06/21,468,-200,-20,248,118113,1712,3315,123140,26.77%,27.91%,
106/06/20,-195,0,37,-158,117545,1912,3335,122792,26.64%,27.83%,
106/06/19,177,0,-40,137,117740,1912,3298,122950,26.69%,27.87%,
106/06/16,355,0,-4,351,117532,1912,3338,122782,26.64%,27.83%,
106/06/15,-617,-217,0,-834,117432,1912,3342,122686,26.62%,27.81%,
106/06/14,243,0,-28,215,118049,2129,3342,123520,26.76%,28.00%,
106/06/13,76,130,2,208,117813,2129,3370,123312,26.70%,27.95%,
106/06/12,-302,78,-24,-248,117737,1999,3368,123104,26.69%,27.91%,
106/06/09,-109,157,-117,-69,117959,1921,3392,123272,26.74%,27.95%,
106/06/08,-158,0,-7,-165,118067,1764,3509,123340,26.76%,27.96%,
106/06/07,109,0,-66,43,118225,1764,3516,123505,26.80%,28.00%,
106/06/06,111,70,36,217,118150,1764,3582,123496,26.78%,27.99%,
106/06/05,-312,0,23,-289,118024,1694,3546,123264,26.75%,27.94%,
106/06/03,-20,0,-7,-27,118236,1694,3523,123453,26.80%,27.98%,
106/06/02,34,60,-97,-3,118256,1694,3530,123480,26.81%,28.00%,
106/06/01,-208,0,132,-76,118207,1634,3627,123468,26.78%,27.97%,
106/05/31,-516,0,5,-511,118390,1634,3495,123519,26.82%,27.98%,
106/05/26,94,0,-16,78,118963,1634,3490,124087,26.95%,28.11%,
106/05/25,156,0,24,180,118869,1634,3506,124009,26.93%,28.10%,
106/05/24,285,0,-10,275,118713,1634,3482,123829,26.89%,28.05%,
106/05/23,88,0,-25,63,118418,1634,3492,123544,26.83%,27.99%,
106/05/22,-84,0,-7,-91,118330,1634,3517,123481,26.81%,27.98%,
106/05/19,-194,0,-58,-252,118414,1634,3524,123572,26.83%,28.00%,
106/05/18,-270,0,-12,-282,118468,1634,3582,123684,26.84%,28.02%,
106/05/17,991,0,172,1163,118889,1634,3594,124117,26.93%,28.12%,
106/05/16,659,-30,-129,500,117887,1634,3422,122943,26.71%,27.86%,
106/05/15,-401,0,-42,-443,117223,1664,3551,122438,26.56%,27.74%,
106/05/12,1227,0,274,1501,117410,1664,3593,122667,26.60%,27.79%,
106/05/11,196,0,-36,160,116277,1664,3319,121260,26.34%,27.47%,
106/05/10,708,0,-23,685,116071,1664,3355,121090,26.30%,27.44%,
106/05/09,477,30,-46,461,115163,1664,3378,120205,26.09%,27.23%,
106/05/08,1484,0,76,1560,114755,1634,3424,119813,26.00%,27.15%,
106/05/05,125,0,-8,117,113254,1634,3348,118236,25.70%,26.83%,
106/05/04,-26,0,-26,-52,113871,1634,3356,118861,25.84%,26.97%,
106/05/03,98,0,4,102,113866,1634,3382,118882,25.84%,26.98%,
106/05/02,-278,0,-10,-288,113758,1634,3378,118770,25.82%,26.96%,
106/04/28,-265,0,-126,-391,114157,1634,3388,119179,25.91%,27.05%,
106/04/27,203,0,41,244,114412,1634,3514,119560,25.96%,27.13%,
106/04/26,-48,0,65,17,114209,1634,3473,119316,25.92%,27.08%,
106/04/25,182,0,-15,167,114247,1634,3408,119289,25.93%,27.08%,
106/04/24,-108,-53,13,-148,114055,1634,3422,119111,25.88%,27.03%,
106/04/21,-507,0,-42,-549,114163,1687,3409,119259,25.91%,27.07%,
106/04/20,-301,0,30,-271,114670,1687,3451,119808,26.02%,27.19%,
106/04/19,-571,0,-63,-634,114871,1687,3421,119979,26.07%,27.23%,
106/04/18,-387,0,26,-361,103341,1687,3484,108512,23.47%,24.64%,
106/04/17,-219,0,-10,-229,103728,1687,3458,108873,23.56%,24.73%,
106/04/14,-138,0,-31,-169,103947,1687,3468,109102,23.60%,24.77%,
106/04/13,-439,0,10,-429,104085,1687,3499,109271,23.64%,24.82%,
106/04/12,-1006,0,0,-1006,104524,1687,3489,109700,23.74%,24.92%,
106/04/11,-436,0,-25,-461,105530,1687,3489,110706,23.96%,25.14%,
106/04/10,-776,0,8,-768,105966,1687,3514,111167,24.06%,25.24%,
106/04/07,-1309,0,-5,-1314,106758,1687,3506,111951,24.24%,25.42%,
106/04/06,-1704,0,-264,-1968,108067,1687,3511,113265,24.54%,25.72%,
106/04/05,-1981,0,150,-1831,109771,1687,3775,115233,24.93%,26.17%,
106/03/31,-432,-50,38,-444,111752,1687,3625,117064,25.38%,26.59%,
106/03/30,-11,0,4,-7,112184,687,3587,116458,25.48%,26.45%,
106/03/29,-19,0,-15,-34,112215,687,3583,116485,25.48%,26.45%,
106/03/28,-45,300,15,270,112234,687,3598,116519,25.49%,26.46%,
106/03/27,-37,0,-106,-143,112279,387,3583,116249,25.50%,26.40%,
106/03/24,-780,0,165,-615,112317,387,3689,116393,25.51%,26.44%,
106/03/23,108,0,39,147,113507,387,3524,117418,25.78%,26.67%,
106/03/22,127,300,-203,224,112699,387,3485,116571,25.59%,26.47%,
106/03/21,116,87,319,522,112572,87,3688,116347,25.56%,26.42%,
106/03/20,-38,-21,-4,-63,112436,0,3369,115805,25.53%,26.30%,
106/03/17,138,0,-47,91,112474,0,3373,115847,25.54%,26.31%,
106/03/16,403,0,38,441,112036,0,3419,115455,25.44%,26.22%,
106/03/15,-191,0,-86,-277,111623,0,3381,115004,25.35%,26.12%,
106/03/14,168,0,31,199,111814,0,3467,115281,25.39%,26.18%,
106/03/13,41,0,-7,34,111635,0,3436,115071,25.35%,26.13%,
106/03/10,-198,0,-12,-210,110994,0,3443,114437,25.21%,25.99%,
106/03/09,-437,-13,-45,-495,111208,0,3455,114663,25.25%,26.03%,
106/03/08,-379,0,73,-306,111634,0,3500,115134,25.35%,26.14%,
106/03/07,-101,-29,5,-125,112013,0,3427,115440,25.44%,26.22%,
106/03/06,-188,-50,-75,-313,112114,0,3422,115536,25.46%,26.24%,
106/03/03,-355,-27,17,-365,114143,0,3497,117640,25.92%,26.71%,
106/03/02,-241,0,-29,-270,114471,0,3480,117951,26.00%,26.79%,
106/03/01,-512,0,21,-491,114712,0,3509,118221,26.05%,26.85%,
106/02/24,-81,-130,-61,-272,115224,0,3488,118712,26.17%,26.96%,
106/02/23,40,-199,-203,-362,115305,0,3548,118853,26.18%,26.99%,
106/02/22,-475,0,-208,-683,115265,115,3751,119131,26.18%,27.06%,
106/02/21,273,0,122,395,115789,115,3959,119863,26.29%,27.22%,
106/02/20,-239,115,-30,-154,115766,115,3837,119718,26.29%,27.19%,
106/02/18,42,0,-405,-363,115995,0,3867,119862,26.34%,27.22%,
106/02/17,-60,0,845,785,115953,0,4272,120225,26.33%,27.30%,
106/02/16,-342,-80,-3,-425,116009,0,3427,119436,26.34%,27.12%,
106/02/15,84,0,-14,70,116351,0,3430,119781,26.42%,27.20%,
106/02/14,-289,0,-211,-500,116267,0,3444,119711,26.40%,27.18%,
106/02/13,-139,0,309,170,116576,0,3655,120231,26.47%,27.30%,
106/02/10,88,0,-5,83,116738,0,3346,120084,26.51%,27.27%,
106/02/09,-301,-220,-40,-561,116650,0,3351,120001,26.49%,27.25%,
106/02/08,46,0,45,91,116938,136,3391,120465,26.56%,27.36%,
106/02/07,-126,0,-39,-165,117131,136,3346,120613,26.60%,27.39%,
106/02/06,313,0,54,367,117257,136,3385,120778,26.63%,27.43%,
106/02/03,471,3,-23,451,116991,136,3331,120458,26.57%,27.36%,
106/02/02,-240,0,2,-238,116504,133,3354,119991,26.46%,27.25%,
106/01/24,656,0,-98,558,116744,133,3352,120229,26.51%,27.30%,
106/01/23,-41,0,-68,-109,115974,133,3450,119557,26.34%,27.15%,
106/01/20,134,0,19,153,116080,133,3518,119731,26.36%,27.19%,
106/01/19,248,0,-64,184,115946,133,3499,119578,26.33%,27.15%,
106/01/18,689,0,-171,518,115698,133,3563,119394,26.27%,27.11%,
106/01/17,378,0,-10,368,115007,133,3734,118874,26.12%,27.00%,
106/01/16,580,0,-149,431,114629,133,3744,118506,26.03%,26.91%,
106/01/13,633,0,137,770,114049,133,3893,118075,25.90%,26.81%,
106/01/12,352,0,21,373,113416,133,3756,117305,25.76%,26.64%,
106/01/11,655,0,-457,198,112933,133,3735,116801,25.65%,26.53%,
106/01/10,2177,0,-53,2124,112269,133,4192,116594,25.50%,26.48%,
106/01/09,-64,0,876,812,110010,133,4245,114388,24.98%,25.97%,
106/01/06,-147,1,-123,-269,110074,133,3369,113576,25.00%,25.80%,
106/01/05,310,132,183,625,111202,132,3492,114826,25.25%,26.07%,
106/01/04,42,0,40,82,110789,0,3309,114098,25.16%,25.92%,
106/01/03,12,0,-1,11,110627,0,3269,113896,25.12%,25.87%,
105/12/30,342,0,-12,330,110650,0,3270,113920,25.13%,25.88%,
105/12/29,-33,0,-4,-37,110424,0,3282,113706,25.08%,25.83%,
105/12/28,-33,0,38,5,110357,0,3286,113643,25.06%,25.81%,
105/12/27,-51,0,0,-51,109989,0,3248,113237,24.98%,25.72%,
105/12/26,-135,0,15,-120,110219,0,3248,113467,25.03%,25.77%,
105/12/23,47,0,12,59,110354,0,3233,113587,25.06%,25.80%,
105/12/22,-240,0,-127,-367,110307,0,3221,113528,25.05%,25.79%,
105/12/21,-375,0,-29,-404,110547,0,3348,113895,25.10%,25.86%,
105/12/20,-70,-80,-53,-203,110912,0,3377,114289,25.19%,25.96%,
105/12/19,-171,-28,-53,-252,111313,0,3430,114743,25.28%,26.06%,
105/12/16,330,0,-15,315,111483,0,3483,114966,25.32%,26.12%,
105/12/15,-409,-149,45,-513,111158,0,3498,114656,25.24%,26.04%,
105/12/14,238,-281,-40,-83,111237,0,3453,114690,25.26%,26.05%,
105/12/13,-1,-200,77,-124,110889,0,3493,114382,25.18%,25.98%,
105/12/12,508,-320,70,258,110933,0,3416,114349,25.19%,25.97%,
105/12/09,130,-280,55,-95,122266,0,3346,125612,27.95%,28.71%,
105/12/08,115,-422,-61,-368,122070,2,3291,125363,27.91%,28.66%,
105/12/07,208,-612,113,-291,121955,424,3352,125731,27.88%,28.74%,
105/12/06,168,-366,28,-170,121737,1036,3239,126012,27.83%,28.81%,
105/12/05,82,0,18,100,121975,1402,3211,126588,27.88%,28.93%,
105/12/02,102,0,-69,33,121844,1402,3193,126439,27.85%,28.90%,
105/12/01,57,0,80,137,121828,1402,3262,126492,27.85%,28.92%,
105/11/30,-40,0,-3,-43,121747,1402,3182,126331,27.83%,28.88%,
105/11/29,149,-30,22,141,121787,1402,3185,126374,27.84%,28.89%,
105/11/28,150,-180,-37,-67,121638,1432,3163,126233,27.81%,28.86%,
105/11/25,78,0,-22,56,121478,1612,3200,126290,27.77%,28.87%,
105/11/24,-128,0,48,-80,121512,1612,3222,126346,27.78%,28.88%,
105/11/23,-97,-250,55,-292,121557,1612,3174,126343,27.79%,28.88%,
105/11/22,-721,0,39,-682,121654,1862,3119,126635,27.81%,28.95%,
105/11/21,-545,-50,6,-589,122305,1862,3080,127247,27.96%,29.09%,
105/11/18,308,0,35,343,122850,1912,3074,127836,28.08%,29.22%,
105/11/17,117,-100,30,47,122542,1912,3039,127493,28.01%,29.14%,
105/11/16,-332,-200,-24,-556,122425,2012,3009,127446,27.99%,29.14%,
105/11/15,187,-148,74,113,122757,2212,3033,128002,28.06%,29.26%,
105/11/14,-62,-700,-9,-771,122570,2360,2959,127889,28.02%,29.23%,
105/11/11,-1051,-139,1,-1189,122632,3060,2968,128660,28.03%,29.41%,
105/11/10,-225,-238,13,-450,123683,3199,2967,129849,28.27%,29.68%,
105/11/09,-2,-214,-85,-301,123908,3437,2954,130299,28.33%,29.79%,
105/11/08,-383,-109,1,-491,123910,3651,3039,130600,28.33%,29.86%,
105/11/07,-131,-100,-26,-257,124292,3760,3038,131090,28.41%,29.96%,
105/11/04,-421,-490,21,-890,124423,3860,3064,131347,28.44%,30.02%,
105/11/03,-113,-97,-1,-211,124844,4350,3043,132237,28.54%,30.23%,
105/11/02,46,-0,-62,-16,124957,4447,3044,132448,28.57%,30.28%,
105/11/01,-497,-441,28,-910,124911,4447,3106,132464,28.56%,30.28%,
105/10/31,-91,0,-46,-137,125408,4888,3078,133374,28.67%,30.49%,
105/10/28,-570,-397,-15,-982,125499,4888,3124,133511,28.69%,30.52%,
105/10/27,92,0,1,93,126069,5285,3139,134493,28.82%,30.74%,
105/10/26,-270,0,-29,-299,125977,5285,3138,134400,28.80%,30.72%,
105/10/25,780,0,-39,741,126210,5285,3167,134662,28.85%,30.78%,
105/10/24,-109,-60,0,-169,125430,5285,3206,133921,28.67%,30.61%,
105/10/21,-400,-44,12,-432,125539,5345,3206,134090,28.70%,30.65%,
105/10/20,-344,-69,1,-412,125939,5389,3194,134522,28.79%,30.75%,
105/10/19,-537,-70,-12,-619,126283,5458,3193,134934,28.87%,30.85%,
105/10/18,-71,0,7,-64,127650,5528,3205,136383,29.18%,31.17%,
105/10/17,412,0,41,453,127921,5528,3198,136647,29.24%,31.23%,
105/10/14,208,-30,-29,149,127509,5528,3157,136194,29.15%,31.13%,
105/10/13,9,-175,21,-145,127251,5558,3186,135995,29.09%,31.09%,
105/10/12,-185,-30,38,-177,127242,5733,3165,136140,29.09%,31.12%,
105/10/11,98,70,1,169,127327,5763,3127,136217,29.11%,31.14%,
105/10/07,-1653,-150,-7,-1810,127229,5693,3126,136048,29.09%,31.10%,
105/10/06,58,-100,2,-40,128082,5843,3133,137058,29.28%,31.33%,
105/10/05,-309,-200,-15,-524,128084,5943,3131,137158,29.28%,31.35%,
105/10/04,-241,0,-47,-288,128393,6143,3146,137682,29.35%,31.47%,
105/10/03,709,-30,-40,639,128575,6143,3193,137911,29.39%,31.52%,
105/09/30,530,-243,14,301,127855,6173,3233,137261,29.23%,31.38%,
105/09/29,-759,-365,-13,-1137,127323,9012,3219,139554,29.11%,31.91%,
105/09/26,-145,-170,-10,-325,128098,9377,3232,140707,29.28%,32.16%,
105/09/23,83,-310,29,-198,128242,9547,3242,141031,29.32%,32.24%,
105/09/22,58,0,-64,-6,128160,9857,3213,141230,29.30%,32.29%,
105/09/21,123,0,-6,117,128102,9857,3277,141236,29.29%,32.29%,
105/09/20,-436,49,-123,-510,127979,9857,3283,141119,29.26%,32.26%,
105/09/19,-135,0,-279,-414,128394,9808,3406,141608,29.35%,32.37%,
105/09/14,-98,0,-183,-281,128519,9808,3685,142012,29.38%,32.47%,
105/09/13,-490,340,29,-121,128617,9808,3868,142293,29.40%,32.53%,
105/09/12,-53,530,56,533,128987,9468,3839,142294,29.49%,32.53%,
105/09/10,5,160,-222,-57,129000,8938,3783,141721,29.49%,32.40%,
105/09/09,-409,0,144,-265,128995,8778,4005,141778,29.49%,32.41%,
105/09/08,-580,-1,283,-298,129373,8778,3861,142012,29.58%,32.47%,
105/09/07,225,120,56,401,129952,8779,3578,142309,29.71%,32.54%,
105/09/06,-2543,190,-60,-2413,129637,8659,3522,141818,29.64%,32.43%,
105/09/05,132,36,-110,58,131280,8469,3582,143331,30.01%,32.77%,
105/09/02,-268,121,-76,-223,131148,8433,3692,143273,29.98%,32.75%,
105/09/01,-15,0,204,189,131966,8312,3768,144046,30.17%,32.93%,
105/08/31,101,228,61,390,131837,8312,3564,143713,30.14%,32.86%,
105/08/30,357,217,-35,539,131736,8084,3503,143323,30.12%,32.77%,
105/08/29,6,23,-54,-25,131379,7867,3538,142784,30.03%,32.64%,
105/08/26,482,-119,-176,187,131373,7844,3592,142809,30.03%,32.64%,
105/08/25,231,135,46,412,130891,7963,3768,142622,29.92%,32.60%,
105/08/24,586,172,141,899,130660,7828,3722,142210,29.87%,32.51%,
105/08/23,321,185,18,524,129924,7656,3581,141161,29.70%,32.27%,
105/08/22,-186,378,-38,154,129603,7471,3563,140637,29.63%,32.15%,
105/08/19,490,348,-215,623,129789,7093,3601,140483,29.67%,32.12%,
105/08/18,638,401,-212,827,129279,6745,3816,139840,29.55%,31.96%,
105/08/17,-454,0,12,-442,128641,6344,4028,139013,29.41%,31.78%,
105/08/16,184,0,-330,-146,129084,6344,4016,139444,29.51%,31.88%,
105/08/15,-472,0,-12,-484,128865,6344,4346,139555,29.46%,31.90%,
105/08/12,-483,0,-31,-514,129337,6344,4358,140039,29.57%,32.02%,
105/08/11,-468,200,52,-216,129810,6344,4389,140543,29.68%,32.13%,
105/08/10,495,-800,180,-125,130278,6144,4337,140759,29.78%,32.18%,
105/08/09,-982,-288,-308,-1578,129783,6944,4157,140884,29.67%,32.21%,
105/08/08,758,-233,64,589,131155,7232,4465,142852,29.98%,32.65%,
105/08/05,-393,-130,1,-522,130397,7465,4401,142263,29.81%,32.52%,
105/08/04,614,-314,-23,277,130279,7595,4400,142274,29.78%,32.52%,
105/08/03,-118,-430,2,-546,129655,7909,4423,141987,29.64%,32.46%,
105/08/02,166,-43,-128,-5,129773,8339,4421,142533,29.67%,32.59%,
105/08/01,285,0,-77,208,129027,8382,4549,141958,29.50%,32.46%,
105/07/29,-27,10,-118,-135,125683,8382,4626,138691,28.73%,31.70%,
105/07/28,1193,0,-1302,-109,126338,8372,4744,139454,28.88%,31.88%,
105/07/27,-991,-280,1402,131,125145,8372,6046,139563,28.61%,31.91%,
105/07/26,-765,0,620,-145,126136,8652,4644,139432,28.84%,31.88%,
105/07/25,-1043,0,-210,-1253,126900,8652,4024,139576,29.01%,31.91%,
105/07/22,416,23,-690,-251,127943,8652,4234,140829,29.25%,32.20%,
105/07/21,130,0,29,159,127635,8629,4924,141188,29.18%,32.28%,
105/07/20,556,0,-286,270,127493,8629,4895,141017,29.15%,32.24%,
105/07/19,192,0,-3,189,127835,8629,5181,141645,29.22%,32.38%,
105/07/18,200,0,126,326,127643,8629,5184,141456,29.18%,32.34%,
105/07/15,205,135,-357,-17,127635,8629,5058,141322,29.18%,32.31%,
105/07/14,827,135,-250,712,127727,8494,5415,141636,29.20%,32.38%,
105/07/13,1209,180,326,1715,127200,8359,5665,141224,29.08%,32.29%,
105/07/12,590,150,-1,739,127146,8179,5339,140664,29.07%,32.16%,
105/07/11,121,395,-140,376,126567,8029,5340,139936,28.93%,31.99%,
105/07/07,788,570,86,1444,126446,7634,5480,139560,28.91%,31.91%,
105/07/06,256,470,-213,513,125658,7064,5394,138116,28.73%,31.58%,
105/07/05,94,500,284,878,125402,6594,5607,137603,28.67%,31.46%,
105/07/04,337,0,-39,298,125385,6094,5323,136802,28.66%,31.27%,
105/07/01,185,405,118,708,125048,6094,5362,136504,28.59%,31.21%,
105/06/30,152,365,311,828,124918,5689,5244,135851,28.56%,31.06%,
105/06/29,-354,344,-143,-153,124727,4862,4933,134522,28.51%,30.75%,
105/06/28,-230,329,68,167,125081,4518,5076,134675,28.59%,30.78%,
105/06/27,-1326,564,-29,-791,125036,4189,5008,134233,28.58%,30.68%,
105/06/24,415,-11,-110,294,126362,3625,5037,135024,28.89%,30.87%,
105/06/23,-258,329,-62,9,124422,3636,5147,133205,28.44%,30.45%,
105/06/22,1036,2325,455,3816,124680,3307,5209,133196,28.50%,30.45%,
105/06/21,886,530,65,1481,123634,982,4754,129370,28.26%,29.57%,
105/06/20,308,63,187,558,122843,452,4689,127984,28.08%,29.26%,
105/06/17,280,0,-41,239,122470,389,4502,127361,28.00%,29.12%,
105/06/16,-256,0,-46,-302,121848,389,4543,126780,27.86%,28.99%,
105/06/15,51,-275,41,-183,122104,389,4589,127082,27.91%,29.05%,
105/06/14,-522,0,-50,-572,121859,664,4548,127071,27.86%,29.05%,
105/06/13,-468,0,18,-450,122311,664,4598,127573,27.96%,29.16%,
105/06/08,-954,0,229,-725,122754,664,4579,127997,28.06%,29.26%,
105/06/07,-20,0,11,-9,123874,664,4350,128888,28.32%,29.47%,
105/06/06,-5,0,-36,-41,123894,664,4339,128897,28.32%,29.46%,
105/06/04,3,64,0,67,123899,664,4375,128938,28.32%,29.47%,
105/06/03,214,33,-4,243,123896,600,4375,128871,28.32%,29.46%,
105/06/02,-733,0,5,-728,123648,567,4379,128594,28.27%,29.40%,
105/06/01,-274,37,-2,-239,124382,567,4374,129323,28.43%,29.56%,
105/05/31,-888,0,30,-858,124679,530,4376,129585,28.50%,29.62%,
105/05/30,-1234,209,-4,-1029,125567,530,4346,130443,28.71%,29.83%,
105/05/27,-853,200,124,-529,126789,321,4350,131460,28.99%,30.06%,
105/05/26,-1002,-74,242,-834,127642,121,4226,131989,29.18%,30.18%,
105/05/25,-780,0,101,-679,128644,195,3984,132823,29.41%,30.37%,
105/05/24,-556,0,429,-127,129380,195,3883,133458,29.58%,30.51%,
105/05/23,-833,-10,122,-721,129936,195,3454,133585,29.70%,30.54%,
105/05/20,-2285,-25,107,-2203,130687,205,3333,134225,29.88%,30.69%,
105/05/19,-366,-5,65,-306,132856,230,3226,136312,30.37%,31.16%,
105/05/18,377,0,68,445,133668,235,3161,137064,30.56%,31.34%,
105/05/17,-253,0,-15,-268,133291,235,3093,136619,30.47%,31.23%,
105/05/16,82,0,16,98,133544,235,3108,136887,30.53%,31.30%,
105/05/13,-902,0,79,-823,133462,235,3092,136789,30.51%,31.27%,
105/05/12,-150,0,66,-84,133838,235,3013,137086,30.60%,31.34%,
105/05/11,-617,0,-76,-693,133988,235,2947,137170,30.63%,31.36%,
105/05/10,274,0,-56,218,134605,235,3023,137863,30.77%,31.52%,
105/05/09,280,0,112,392,134328,235,3079,137642,30.71%,31.47%,
105/05/06,286,0,-13,273,134048,235,2967,137250,30.64%,31.37%,
105/05/05,420,0,-25,395,133762,235,2980,136977,30.58%,31.32%,
105/05/04,-623,0,11,-612,133434,235,3005,136674,30.95%,31.69%,
105/05/03,-53,0,-1,-54,134057,235,2994,137286,31.09%,31.83%,
105/04/29,-186,0,-10,-196,134070,235,2995,137300,31.09%,31.83%,
105/04/28,-150,0,1,-149,134256,235,3005,137496,31.14%,31.88%,
105/04/27,-694,0,17,-677,134321,235,3004,137560,31.15%,31.89%,
105/04/26,-728,0,63,-665,135005,235,2987,138227,31.31%,32.05%,
105/04/25,-62,0,41,-21,135633,235,2924,138792,31.46%,32.18%,
105/04/22,-212,-160,8,-364,135695,235,2883,138813,31.47%,32.18%,
105/04/21,-489,-400,39,-850,135907,395,2875,139177,31.52%,32.27%,
105/04/20,-63,0,113,50,136246,795,2836,139877,31.60%,32.43%,
105/04/19,-361,-379,-42,-782,136309,795,2723,139827,31.61%,32.42%,
105/04/18,466,0,2,468,136670,1174,2765,140609,31.70%,32.60%,
105/04/15,-284,-563,-13,-860,136430,1174,2763,140367,31.64%,32.54%,
105/04/14,-485,-137,1,-621,136714,1737,2776,141227,31.71%,32.74%,
105/04/13,-350,-14,14,-350,137199,1874,2775,141848,31.82%,32.89%,
105/04/12,-965,-425,-23,-1413,137549,1888,2761,142198,31.90%,32.97%,
105/04/11,-785,-60,-9,-854,138514,2313,2784,143611,32.13%,33.30%,
105/04/08,-185,-276,-8,-469,139354,2373,2793,144520,32.32%,33.50%,
105/04/07,-450,-407,-15,-872,139434,2649,2801,144884,32.34%,33.59%,
105/04/06,-2523,-782,-21,-3326,140233,3056,2816,146105,32.52%,33.87%,
105/04/01,-271,0,-11,-282,142766,3838,2837,149441,33.11%,34.64%,
105/03/31,-453,-120,-69,-642,144189,3838,2848,150875,33.44%,34.97%,
105/03/30,-215,-405,4,-616,144632,4689,2917,152238,33.54%,35.28%,
105/03/29,303,0,-113,190,144857,5094,2913,152864,33.60%,35.44%,
105/03/28,-666,0,46,-620,144626,5094,3026,152746,33.54%,35.40%,
105/03/25,-1031,-50,74,-1007,145283,5094,2980,153357,33.70%,35.55%,
105/03/24,23,-547,-10,-534,146369,5144,2906,154419,33.95%,35.80%,
105/03/23,-381,0,-3,-384,146336,5691,2916,154943,33.94%,35.91%,
105/03/22,-814,-98,-232,-1144,146707,5691,2919,155317,34.03%,36.00%,
105/03/21,-245,-69,227,-87,147511,5789,3151,156451,34.21%,36.26%,
105/03/18,314,-96,-47,171,147746,5858,2924,156528,34.27%,36.28%,
105/03/17,-780,-89,-153,-1022,147420,5954,2971,156345,34.19%,36.24%,
105/03/16,-854,-137,474,-517,148221,6043,3124,157388,34.38%,36.48%,
105/03/15,56,-355,-251,-550,149065,6180,2650,157895,34.57%,36.59%,
105/03/14,175,-362,-44,-231,149009,6535,2901,158445,34.56%,36.72%,
105/03/11,-436,0,178,-258,148834,6897,2945,158676,34.52%,36.78%,
105/03/10,-30,-112,-29,-171,149270,6897,2767,158934,34.62%,36.84%,
105/03/09,891,-93,-9,789,149790,7009,2796,159595,34.74%,36.99%,
105/03/08,-1329,-397,-424,-2150,148898,7102,2805,158805,34.53%,36.80%,
105/03/07,553,-630,254,177,150197,7499,3229,160925,34.84%,37.30%,
105/03/04,15,-865,-13,-863,149644,8129,2975,160748,34.71%,37.26%,
105/03/03,-1399,-120,-159,-1678,149633,8994,2988,161615,34.70%,37.45%,
105/03/02,-469,-220,-161,-850,151032,9114,3147,163293,35.03%,37.84%,
105/03/01,-945,-1163,209,-1899,152140,9334,3308,164782,35.29%,38.19%,
105/02/26,1045,1704,194,2943,153085,10497,3099,166681,35.51%,38.63%,
105/02/25,177,150,-177,150,152040,8793,2905,163738,35.26%,37.94%,
105/02/24,617,50,224,891,151863,8643,3082,163588,35.22%,37.91%,
105/02/23,376,173,23,572,151247,8593,2858,162698,35.08%,37.71%,
105/02/22,683,-150,4,537,150871,8420,2835,162126,34.99%,37.57%,
105/02/19,-688,-721,-132,-1541,150488,8570,2831,161889,34.90%,37.51%,
105/02/18,-138,78,94,34,151176,9291,2963,163430,35.06%,37.87%,
105/02/17,249,170,-28,391,151014,9213,2869,163096,35.03%,37.80%,
105/02/16,5,0,-69,-64,150795,9043,2897,162735,34.97%,37.71%,
105/02/15,240,-0,-205,35,150790,9043,2966,162799,34.97%,37.72%,
105/02/03,-297,138,-340,-499,150807,9043,3171,163021,34.98%,37.78%,
105/02/02,805,900,-221,1484,151337,8905,3511,163753,35.10%,37.95%,
105/02/01,509,1483,390,2382,149994,8005,3732,161731,34.79%,37.48%,
105/01/30,0,1666,-416,1250,150076,6522,3342,159940,34.81%,37.07%,
105/01/29,5568,1667,641,7876,150076,4856,3758,158690,34.81%,36.78%,
105/01/28,154,100,-37,217,145148,3189,3117,151454,33.66%,35.11%,
105/01/27,180,0,-81,99,144749,3089,3154,150992,33.57%,35.00%,
105/01/26,-343,50,-133,-426,145382,3089,3235,151706,33.72%,35.17%,
105/01/25,-242,270,232,260,145725,3039,3368,152132,33.80%,35.27%,
105/01/22,537,0,-218,319,145917,2769,3136,151822,33.84%,35.19%,
105/01/21,-271,0,-385,-656,145380,2769,3354,151503,33.72%,35.12%,
105/01/20,-730,199,18,-513,145652,2769,3739,152160,33.78%,35.27%,
105/01/19,898,271,-980,189,146017,2570,3721,152308,33.87%,35.31%,
105/01/18,-270,364,1325,1419,145009,2299,4701,152009,33.63%,35.23%,
105/01/15,1124,-1,203,1326,145124,1935,3376,150435,33.66%,34.88%,
105/01/14,-840,0,-253,-1093,144009,1936,3173,149118,33.40%,34.57%,
105/01/13,157,100,50,307,144186,1936,3426,149548,33.44%,34.67%,
105/01/12,2483,-25,168,2626,143819,1836,3376,149031,33.36%,34.55%,
105/01/11,-484,0,30,-454,141409,1861,3208,146478,32.80%,33.96%,
105/01/08,1367,238,205,1810,141975,1861,3178,147014,32.93%,34.09%,
105/01/07,-1109,0,-720,-1829,140598,1623,2973,145194,32.61%,33.66%,
105/01/06,-31,315,704,988,141697,1623,3693,147013,32.86%,34.08%,
105/01/05,44,0,53,97,141851,1308,2989,146148,32.90%,33.89%,
105/01/04,141,0,-81,60,141772,1308,2936,146016,32.88%,33.86%,
104/12/31,-454,-101,21,-534,141344,1308,3017,145669,32.78%,33.78%,
104/12/30,-580,0,-13,-593,141690,1104,2996,145790,32.86%,33.81%,
104/12/29,120,-15,-63,42,142273,1104,3009,146386,33.00%,33.95%,
104/12/28,-1059,-13,-37,-1109,142411,1119,3072,146602,33.03%,34.00%,
104/12/25,142,0,-78,64,143460,1132,3109,147701,33.27%,34.25%,
104/12/24,-446,0,-475,-921,143208,1132,3187,147527,33.21%,34.21%,
104/12/23,1112,0,498,1610,143626,1132,3662,148420,33.31%,34.42%,
104/12/22,1118,0,58,1176,142752,1132,3164,147048,33.11%,34.10%,
104/12/21,883,-469,163,577,141634,1132,3106,145872,32.85%,33.83%,
104/12/18,2280,-3574,-66,-1360,140751,1601,2943,145295,32.64%,33.69%,
104/12/17,1107,-1500,279,-114,138340,5175,3009,146524,32.09%,33.98%,
104/12/16,1915,-1500,373,788,137233,6675,2730,146638,31.83%,34.01%,
104/12/15,-609,0,-21,-630,135218,8175,2357,145750,31.36%,33.80%,
104/12/14,20,-1,17,36,136032,8175,2378,146585,31.55%,33.99%,
104/12/11,36,0,-162,-126,136012,8176,2361,146549,31.55%,33.99%,
104/12/10,661,0,-563,98,136763,8176,2523,147462,31.72%,34.20%,
104/12/09,-261,0,-416,-677,136207,8176,3086,147469,31.59%,34.20%,
104/12/08,748,0,760,1508,136468,8176,3502,148146,31.65%,34.35%,
104/12/07,-420,0,155,-265,137594,8176,2742,148512,31.91%,34.44%,
104/12/04,-327,81,-228,-474,138014,8176,2587,148777,32.01%,34.50%,
104/12/03,-357,0,397,40,138003,8095,2815,148913,32.01%,34.54%,
104/12/02,-491,87,11,-393,138290,8095,2418,148803,32.07%,34.50%,
104/12/01,-76,0,58,-18,138726,8008,2407,149141,32.17%,34.58%,
104/11/30,-829,202,-56,-683,138801,8008,2349,149158,32.19%,34.59%,
104/11/27,377,0,-151,226,139519,7806,2405,149730,32.36%,34.72%,
104/11/26,-662,0,-124,-786,139142,7806,2556,149504,32.27%,34.67%,
104/11/25,363,-100,-89,174,139304,7806,2680,149790,32.31%,34.74%,
104/11/24,-62,0,9,-53,138291,7906,2769,148966,32.07%,34.54%,
104/11/23,-62,-500,-125,-687,138573,7906,2760,149239,32.14%,34.61%,
104/11/20,-510,-501,21,-990,139081,8406,2885,150372,32.26%,34.87%,
104/11/19,-601,0,-3,-604,139591,8907,2864,151362,32.38%,35.11%,
104/11/18,-1053,-500,-507,-2060,140192,8907,2867,151966,32.51%,35.24%,
104/11/17,-444,0,676,232,139904,9407,3374,152685,32.45%,35.41%,
104/11/16,-292,0,158,-134,139877,9407,2698,151982,32.44%,35.24%,
104/11/13,-327,0,2,-325,139925,9407,2540,151872,32.45%,35.22%,
104/11/12,-338,-400,28,-710,139922,9407,2538,151867,32.45%,35.22%,
104/11/11,-536,-62,-65,-663,140134,9807,2510,152451,32.50%,35.35%,
104/11/10,-170,0,8,-162,140540,9869,2575,152984,32.60%,35.48%,
104/11/09,136,40,-118,58,140710,9869,2567,153146,32.64%,35.52%,
104/11/06,-429,-93,-65,-587,140585,9829,2685,153099,32.61%,35.51%,
104/11/05,287,0,13,300,141198,9922,2750,153870,32.75%,35.68%,
104/11/04,-206,-24,-129,-359,140911,9922,2737,153570,32.68%,35.61%,
104/11/03,-23,0,444,421,141117,9946,2866,153929,32.73%,35.70%,
104/11/02,451,0,36,487,141189,9946,2422,153557,32.75%,35.61%,
104/10/30,71,0,11,82,140879,9946,2386,153211,32.67%,35.53%,
104/10/29,-504,200,48,-256,140808,9946,2375,153129,32.66%,35.51%,
104/10/28,474,-21,-98,355,141312,9746,2327,153385,32.77%,35.57%,
104/10/27,806,0,75,881,140814,9767,2425,153006,32.66%,35.48%,
104/10/26,748,-150,296,894,140032,9767,2350,152149,32.48%,35.29%,
104/10/23,-218,-136,-166,-520,139284,9917,2054,151255,32.30%,35.07%,
104/10/22,-572,300,-60,-332,139575,10053,2220,151848,32.37%,35.21%,
104/10/21,-2484,0,-156,-2640,140147,9753,2280,152180,32.50%,35.29%,
104/10/20,-896,500,540,144,142631,9753,2436,154820,33.08%,35.90%,
104/10/19,-217,640,8,431,143467,9253,1896,154616,33.27%,35.85%,
104/10/16,936,500,-94,1342,143674,8613,1888,154175,33.32%,35.75%,
104/10/15,-728,170,-131,-689,142718,8113,1982,152813,33.10%,35.44%,
104/10/14,-563,0,111,-452,143385,7943,2113,153441,33.26%,35.59%,
104/10/13,-201,0,-57,-258,143548,7943,2002,153493,33.29%,35.59%,
104/10/12,434,0,34,468,143456,7943,2059,153458,33.27%,35.59%,
104/10/08,-894,0,-11,-905,143023,7943,2025,152991,33.17%,35.48%,
104/10/07,-392,-200,-28,-620,144071,7943,2036,154050,33.41%,35.72%,
104/10/06,-1736,-218,-344,-2298,144464,8143,2064,154671,33.51%,35.87%,
104/10/05,-191,2,156,-33,146251,8361,2408,157020,33.92%,36.41%,
104/10/02,-88,4,-14,-98,146442,8359,2252,157053,33.96%,36.42%,
104/10/01,-28,0,79,51,146526,8355,2266,157147,33.98%,36.44%,
104/09/30,-1,0,-3,-4,146554,8355,2187,157096,33.99%,36.44%,
104/09/25,160,-241,-48,-129,146663,7035,2190,155888,34.02%,36.16%,
104/09/24,-899,-15,-28,-942,146551,7276,2238,156065,33.99%,36.20%,
104/09/23,-266,-50,-99,-415,147380,7291,2266,156937,34.18%,36.40%,
104/09/22,-825,-94,-211,-1130,147646,7341,2365,157352,34.24%,36.49%,
104/09/21,-1705,3109,324,1728,148430,7435,2576,158441,34.43%,36.75%,
104/09/18,-1056,3501,-152,2293,150027,4326,2252,156605,34.80%,36.33%,
104/09/17,-738,0,323,-415,150705,825,2404,153934,34.95%,35.70%,
104/09/16,806,0,-100,706,151463,825,2081,154369,35.13%,35.80%,
104/09/15,-78,0,-75,-153,150439,825,2181,153445,34.89%,35.59%,
104/09/14,1921,35,-230,1726,150217,825,2256,153298,34.84%,35.55%,
104/09/11,-279,0,-168,-447,148248,790,2486,151524,34.38%,35.14%,
104/09/10,708,28,-147,589,148904,790,2654,152348,34.54%,35.34%,
104/09/09,2022,182,-442,1762,148172,762,2801,151735,34.37%,35.20%,
104/09/08,1615,400,261,2276,146469,580,3243,150292,33.97%,34.86%,
104/09/07,1114,1,171,1286,144981,180,2982,148143,33.63%,34.36%,
104/09/04,-811,178,-292,-925,143643,179,2811,146633,33.32%,34.01%,
104/09/03,123,1,294,418,144369,1,3103,147473,33.48%,34.20%,
104/09/02,-561,0,-12,-573,144246,0,2809,147055,33.46%,34.11%,
104/09/01,-252,-10,38,-224,145265,0,2821,148086,33.69%,34.34%,
104/08/31,-218,-6,172,-52,145517,0,2783,148300,33.75%,34.40%,
104/08/28,-320,1,9,-310,145146,1,2611,147758,33.66%,34.27%,
104/08/27,-388,0,6,-382,145505,0,2602,148107,33.75%,34.35%,
104/08/26,-684,0,3,-681,145943,0,2596,148539,33.85%,34.45%,
104/08/25,-1494,0,6,-1488,146927,0,2593,149520,34.08%,34.68%,
104/08/24,40,-407,242,-125,148421,0,2587,151008,34.42%,35.02%,
104/08/21,-956,0,38,-918,148381,277,2345,151003,34.41%,35.02%,
104/08/20,-222,0,28,-194,149337,277,2307,151921,34.64%,35.24%,
104/08/19,-546,0,70,-476,149549,277,2279,152105,34.69%,35.28%,
104/08/18,238,0,30,268,150095,277,2209,152581,34.81%,35.39%,
104/08/17,-387,0,29,-358,149857,277,2179,152313,34.76%,35.33%,
104/08/14,-289,0,-85,-374,150244,277,2150,152671,34.85%,35.41%,
104/08/13,334,0,-40,294,150226,277,2235,152738,34.84%,35.42%,
104/08/12,-56,0,-79,-135,149761,277,2275,152313,34.73%,35.32%,
104/08/11,-162,0,16,-146,149808,277,2354,152439,34.75%,35.36%,
104/08/10,-119,-182,-7,-308,149658,277,2338,152273,34.71%,35.32%,
104/08/07,-646,-344,46,-944,149800,459,2345,152604,34.74%,35.39%,
104/08/06,-223,0,-48,-271,150381,803,2299,153483,34.88%,35.60%,
104/08/05,633,0,-19,614,150637,803,2347,153787,34.94%,35.67%,
104/08/04,-337,0,-113,-450,149965,803,2366,153134,34.78%,35.52%,
104/08/03,824,-205,-88,531,150129,803,2479,153411,34.82%,35.58%,
104/07/31,-1366,-150,-145,-1661,148895,1008,2567,152470,34.53%,35.36%,
104/07/30,280,-408,-119,-247,150261,1158,2712,154131,34.85%,35.75%,
104/07/29,-843,-19,85,-777,149666,1566,2831,154063,34.71%,35.73%,
104/07/28,729,-10,-141,578,150509,1585,2746,154840,34.91%,35.91%,
104/07/27,-900,0,145,-755,149780,1595,2887,154262,34.74%,35.78%,
104/07/24,-562,1,-17,-578,150387,1595,2742,154724,34.88%,35.89%,
104/07/23,28,0,25,53,150747,1594,2759,155100,34.96%,35.97%,
104/07/22,-440,-64,154,-350,151254,1594,2734,155582,35.08%,36.08%,
104/07/21,-684,-1,50,-635,152857,1658,2580,157095,35.45%,36.43%,
104/07/20,-1157,0,22,-1135,154520,1659,2530,158709,35.84%,36.81%,
104/07/17,-809,-88,56,-841,155942,1659,2508,160109,36.17%,37.14%,
104/07/16,-1878,-115,139,-1854,157022,1747,2452,161221,36.42%,37.39%,
104/07/15,-241,2,-112,-351,159000,1862,2313,163175,36.88%,37.85%,
104/07/14,-752,-22,-40,-814,159341,1860,2425,163626,36.96%,37.95%,
104/07/13,-1223,0,-245,-1468,160593,1882,2465,164940,37.25%,38.26%,
104/07/09,-2798,-110,458,-2450,161929,1882,2710,166521,37.56%,38.63%,
104/07/08,-1191,-400,-239,-1830,164801,1992,2253,169046,38.22%,39.20%,
104/07/07,36,0,-37,-1,166118,2392,2492,171002,38.53%,39.66%,
104/07/06,180,-213,167,134,166082,2392,2529,171003,38.52%,39.66%,
104/07/03,750,0,8,758,166084,2605,2362,171051,38.52%,39.67%,
104/07/02,275,0,-45,230,166195,2605,2354,171154,38.55%,39.70%,
104/07/01,323,0,-79,244,165880,2605,2399,170884,38.47%,39.63%,
104/06/30,70,0,36,106,165522,2605,2478,170605,38.39%,39.57%,
104/06/29,263,0,-11,252,165452,3786,2442,171680,38.37%,39.82%,
104/06/26,321,0,450,771,165352,3786,2453,171591,38.35%,39.80%,
104/06/25,507,0,135,642,165359,3786,2003,171148,38.35%,39.70%,
104/06/24,-711,0,54,-657,164852,3786,1868,170506,38.24%,39.56%,
104/06/23,-1130,-300,74,-1356,165603,3786,1814,171203,38.41%,39.71%,
104/06/22,-731,-233,18,-946,166919,4086,1740,172745,38.71%,40.07%,
104/06/18,517,-1,-4,512,167613,4319,1722,173654,38.88%,40.29%,
104/06/17,-1501,0,296,-1205,166591,4320,1726,172637,38.64%,40.05%,
104/06/16,89,0,38,127,168141,4320,1430,173891,39.00%,40.34%,
104/06/15,-599,0,69,-530,169803,4320,1392,175515,39.38%,40.71%,
104/06/12,784,0,-64,720,170402,4320,1323,176045,39.52%,40.83%,
104/06/11,400,-247,407,560,169826,4320,1387,175533,39.39%,40.72%,
104/06/10,1335,-1073,-644,-382,169383,4567,980,174930,39.29%,40.58%,
104/06/09,1218,-165,47,1100,168011,5640,1624,175275,38.97%,40.66%,
104/06/08,849,0,-60,789,166507,5805,1577,173889,38.62%,40.34%,
104/06/05,228,-298,-13,-83,165645,5805,1637,173087,38.42%,40.15%,
104/06/04,281,-126,-185,-30,165351,6103,1650,173104,38.35%,40.15%,
104/06/03,686,-288,-1,397,165070,6229,1835,173134,38.29%,40.17%,
104/06/02,-333,0,-17,-350,164384,6517,1836,172737,38.13%,40.07%,
104/06/01,339,0,-86,253,164717,6517,1853,173087,38.20%,40.15%,
104/05/29,654,0,-64,590,164378,6517,1939,172834,38.13%,40.10%,
104/05/28,525,-40,-253,232,164034,6517,2003,172554,38.05%,40.03%,
104/05/27,312,-173,-69,70,163509,6557,2256,172322,37.92%,39.97%,
104/05/26,-751,-65,8,-808,163197,6730,2325,172252,37.85%,39.96%,
104/05/25,-4,0,31,27,164008,6795,2317,173120,38.04%,40.16%,
104/05/22,224,-173,399,450,164012,6795,2286,173093,38.04%,40.15%,
104/05/21,-633,-34,-48,-715,164108,6968,1887,172963,38.06%,40.12%,
104/05/20,-72,-508,43,-537,164741,7002,1935,173678,38.21%,40.29%,
104/05/19,-1209,-252,-1,-1462,164242,7510,1891,173643,38.09%,40.28%,
104/05/18,-697,0,-3,-700,165451,7762,1892,175105,38.37%,40.62%,
104/05/15,772,-3,-355,414,165717,7762,1895,175374,38.68%,40.93%,
104/05/14,49,-71,8,-14,164921,7765,2250,174936,38.50%,40.83%,
104/05/13,499,-261,4,242,164771,7836,2242,174849,38.46%,40.80%,
104/05/12,143,145,-38,250,164272,8097,2238,174607,38.35%,40.75%,
104/05/11,2495,50,-427,2118,164129,7952,2276,174357,38.31%,40.69%,
104/05/08,294,38,-56,276,161634,7902,2703,172239,37.73%,40.20%,
104/05/07,1016,0,-145,871,161340,7864,2759,171963,37.66%,40.13%,
104/05/06,1010,15,122,1147,160346,7864,2904,171114,37.43%,39.93%,
104/05/05,1504,296,-13,1787,159277,7849,2782,169908,37.18%,39.66%,
104/05/04,2890,0,-65,2825,157763,7553,2795,168111,36.83%,39.25%,
104/04/30,2080,-639,348,1789,154873,7553,2860,165286,36.15%,38.58%,
104/04/29,634,-363,33,304,152776,8192,2512,163480,35.66%,38.16%,
104/04/28,-436,-2,-125,-563,152142,8555,2479,163176,35.51%,38.09%,
104/04/27,-24,0,424,400,152728,8557,2604,163889,35.65%,38.26%,
104/04/24,1045,-362,84,767,152952,8557,2180,163689,35.70%,38.21%,
104/04/23,-1766,-866,164,-2468,151907,8919,2096,162922,35.46%,38.03%,
104/04/22,-868,-41,29,-880,153673,9785,1932,165390,35.87%,38.61%,
104/04/21,-321,-50,92,-279,154541,9826,1903,166270,36.07%,38.81%,
104/04/20,258,0,-90,168,154861,9876,1811,166548,36.15%,38.88%,
104/04/17,309,0,75,384,154453,9876,1901,166230,36.05%,38.80%,
104/04/16,464,-247,82,299,154134,9876,1826,165836,35.98%,38.71%,
104/04/15,-323,-7,-57,-387,153670,10123,1744,165537,35.87%,38.64%,
104/04/14,-100,60,31,-9,153993,10130,1801,165924,35.95%,38.74%,
104/04/13,383,60,-106,337,154093,10070,1770,165933,35.97%,38.73%,
104/04/10,-1788,85,123,-1580,153710,10010,1876,165596,35.88%,38.65%,
104/04/09,47,-7,-37,3,155373,9925,1753,167051,36.27%,39.00%,
104/04/08,62,-348,194,-92,155326,9932,1790,167048,36.26%,39.00%,
104/04/07,39,-9,276,306,156263,10280,1596,168139,36.48%,39.25%,
104/04/02,-823,-963,467,-1319,156124,10289,1320,167733,36.44%,39.15%,
104/04/01,-32,-55,-64,-151,156997,11252,853,169102,36.65%,39.48%,
104/03/31,-702,-93,-23,-818,156929,11307,917,169153,36.63%,39.48%,
104/03/30,-495,-128,13,-610,157064,11971,940,169975,36.66%,39.67%,
104/03/27,807,-397,-217,193,158771,12099,927,171797,37.06%,40.10%,
104/03/26,-2325,-2108,498,-3935,157964,12496,1144,171604,36.87%,40.05%,
104/03/25,-5166,-1629,-204,-6999,160289,14604,646,175539,37.42%,40.98%,
104/03/24,-1201,-39,-16,-1256,165455,16233,850,182538,38.62%,42.61%,
104/03/23,-377,-10,-112,-499,166656,16272,866,183794,38.90%,42.90%,
104/03/20,-839,-1,-31,-871,167001,16282,978,184261,38.98%,43.01%,
104/03/19,-62,-684,-189,-935,167976,16283,1009,185268,39.21%,43.25%,
104/03/18,89,-1358,229,-1040,167996,16967,1198,186161,39.21%,43.45%,
104/03/17,4,-874,342,-528,167907,18325,969,187201,39.19%,43.69%,
104/03/16,-316,1,-104,-419,167968,19199,627,187794,39.21%,43.84%,
104/03/13,318,-142,313,489,168284,19198,731,188213,39.28%,43.93%,
104/03/12,1309,-16,-5,1288,167967,19340,418,187725,39.21%,43.82%,
104/03/11,411,-70,-69,272,166586,19356,423,186365,38.89%,43.51%,
104/03/10,924,-80,-208,636,166174,19426,492,186092,38.79%,43.44%,
104/03/09,-220,-228,102,-346,165178,19506,700,185384,38.56%,43.28%,
104/03/06,-156,-471,15,-612,165267,19734,598,185599,38.58%,43.33%,
104/03/05,1202,-1037,-143,22,165445,20205,583,186233,38.62%,43.47%,
104/03/04,108,-770,153,-509,164243,21242,726,186211,38.34%,43.47%,
104/03/03,1303,-97,-16,1190,164134,22012,573,186719,38.31%,43.58%,
104/03/02,756,81,-25,812,162831,22109,589,185529,38.01%,43.31%,
104/02/26,1875,65,-49,1891,161975,22028,614,184617,37.81%,43.10%,
104/02/25,-648,-34,127,-555,160110,21963,663,182736,37.37%,42.65%,
104/02/24,1434,44,-81,1397,159624,21997,536,182157,37.26%,42.52%,
104/02/13,-262,12,56,-194,157450,21953,617,180020,36.75%,42.02%,
104/02/12,2160,-845,-96,1219,157796,21941,561,180298,36.83%,42.08%,
104/02/11,-995,-199,165,-1029,155491,22786,657,178934,36.30%,41.77%,
104/02/10,-181,165,73,57,156136,22985,492,179613,36.45%,41.93%,
104/02/09,3630,264,-287,3607,154652,22820,419,177891,36.10%,41.53%,
104/02/06,1536,-563,-77,896,151022,22556,706,174284,35.25%,40.68%,
104/02/05,1281,-173,-175,933,149388,23119,783,173290,34.87%,40.45%,
104/02/04,1800,-239,-282,1279,148473,23292,958,172723,34.66%,40.32%,
104/02/03,1703,-1083,-23,597,147223,23531,1240,171994,34.37%,40.15%,
104/02/02,2386,298,-174,2510,145520,24614,1263,171397,33.97%,40.01%,
104/01/30,164,572,-28,708,142534,24316,1437,168287,33.27%,39.28%,
104/01/29,1298,208,-256,1250,141921,23744,1465,167130,33.13%,39.02%,
104/01/28,1325,250,-172,1403,140583,23536,1721,165840,32.82%,38.72%,
104/01/27,1104,160,-215,1049,138598,23286,1893,163777,32.35%,38.23%,
104/01/26,-603,35,-178,-746,137494,23126,2108,162728,32.09%,37.98%,
104/01/23,2794,23,-440,2377,138097,23091,2286,163474,32.23%,38.15%,
104/01/22,810,25,-446,389,135321,23068,2726,161115,31.59%,37.61%,
104/01/21,269,675,-307,637,134511,23043,3172,160726,31.40%,37.52%,
104/01/20,1094,15,-579,530,134242,22368,3479,160089,31.33%,37.36%,
104/01/19,-53,76,-270,-247,133319,22353,4058,159730,31.12%,37.29%,
104/01/16,544,554,-294,804,133142,22277,4328,159747,31.08%,37.29%,
104/01/15,604,611,-262,953,132548,21723,4622,158893,30.94%,37.09%,
104/01/14,456,111,-106,461,131944,21112,4884,157940,30.80%,36.87%,
104/01/13,633,264,-165,732,131520,21001,4990,157511,30.70%,36.77%,
104/01/12,800,1023,158,1981,130935,20737,5155,156827,30.56%,36.60%,
104/01/09,-239,55,-942,-1126,130021,19714,4997,154732,30.35%,36.12%,
104/01/08,89,-38,-48,3,130309,19659,5939,155907,30.42%,36.40%,
104/01/07,-477,-1,-126,-604,130220,19697,5987,155904,30.40%,36.40%,
104/01/06,440,55,-73,422,130737,19698,6113,156548,30.52%,36.55%,
104/01/05,101,4,-92,13,130297,19643,6186,156126,30.41%,36.44%,
