日期,外資買賣超,投信買賣超,自營商買賣超,單日合計買賣超,外資估計持股,投信估計持股,自營商估計持股,單日合計估計持股,外資持股比重,三大法人持股比重,
107/03/31,222,0,-670,-448,1018228,3801,1976,1024005,25.58%,25.73%,
107/03/30,-4648,-1,1547,-3102,1018006,3801,2646,1024453,25.57%,25.73%,
107/03/29,-4620,0,-212,-4832,1023654,3802,1099,1028555,25.71%,25.83%,
107/03/28,-3391,0,-962,-4353,1029774,3802,1311,1034887,25.87%,26.00%,
107/03/27,-2972,-1,853,-2120,1034746,3802,2273,1040821,25.99%,26.14%,
107/03/26,-6323,0,79,-6244,1037718,3802,1420,1042940,26.07%,26.20%,
107/03/23,5714,0,-3341,2373,1041331,3802,1341,1046474,26.16%,26.29%,
107/03/22,-1157,0,-1973,-3130,1033617,3802,4682,1042101,25.97%,26.18%,
107/03/21,1664,-1,114,1777,1034774,3802,6655,1045231,25.99%,26.25%,
107/03/20,-176,-7,-1587,-1770,1033110,3803,6541,1043454,25.95%,26.21%,
107/03/19,-1293,-8,-310,-1611,1032492,3810,8128,1044430,25.94%,26.24%,
107/03/16,-13061,252,732,-12077,1034095,3818,8438,1046351,25.98%,26.29%,
107/03/15,398,0,-500,-102,1047061,3566,7706,1058333,26.30%,26.58%,
107/03/14,-15131,380,-1076,-15827,1046164,3566,8206,1057936,26.28%,26.58%,
107/03/13,12965,-3,3194,16156,1061295,3186,9282,1073763,26.66%,26.97%,
107/03/12,-385,0,-343,-728,1051330,3189,6088,1060607,26.41%,26.64%,
107/03/09,-10453,0,-862,-11315,1051524,3189,6431,1061144,26.42%,26.66%,
107/03/08,7679,0,1466,9145,1060597,3189,7293,1071079,26.64%,26.90%,
107/03/07,-5783,0,-94,-5877,1052918,3189,5827,1061934,26.45%,26.68%,
107/03/06,665,0,336,1001,1058701,3189,5921,1067811,26.60%,26.83%,
107/03/05,-5547,-22,27,-5542,1058035,3189,5585,1066809,26.58%,26.80%,
107/03/02,-724,2,-1778,-2500,1063805,3211,5558,1072574,26.72%,26.94%,
107/03/01,-3594,0,-3407,-7001,1063673,3209,7336,1074218,26.72%,26.98%,
107/02/27,2948,1,9287,12236,1066770,3209,10743,1080722,26.80%,27.15%,
107/02/26,-5684,2,-101,-5783,1065098,3208,1456,1069762,26.76%,26.88%,
107/02/23,-10868,0,598,-10270,1069145,3206,1557,1073908,26.86%,26.98%,
107/02/22,-17845,-7,-467,-18319,1079319,3206,959,1083484,27.11%,27.21%,
107/02/21,-12836,0,340,-12496,1096592,3213,1426,1101231,27.55%,27.67%,
107/02/12,-8099,0,-282,-8381,1109077,3213,1086,1113376,27.86%,27.97%,
107/02/09,-7253,0,119,-7134,1118392,3213,1368,1122973,28.10%,28.22%,
107/02/08,-2609,-670,-2671,-5950,1125215,3213,1249,1129677,28.27%,28.38%,
107/02/07,-21887,17,1173,-20697,1125330,3883,3920,1133133,28.27%,28.47%,
107/02/06,-10220,2,-4855,-15073,1143906,3866,2747,1150519,28.74%,28.91%,
107/02/05,-17766,0,-5787,-23553,1156611,3864,7602,1168077,29.06%,29.35%,
107/02/02,-29981,-391,-882,-31254,1173509,3864,13389,1190762,29.48%,29.91%,
107/02/01,-2631,0,1718,-913,1198609,4255,14271,1217135,30.11%,30.58%,
107/01/31,-2446,-30,3027,551,1200701,4255,12553,1217509,30.16%,30.58%,
107/01/30,-6485,0,-968,-7453,1203165,4285,9526,1216976,30.23%,30.58%,
107/01/29,-6,0,-161,-167,1209084,4285,10494,1223863,30.37%,30.74%,
107/01/26,-11218,-987,1498,-10707,1208838,4285,10655,1223778,30.37%,30.75%,
107/01/25,-7014,0,91,-6923,1223339,5272,9157,1237768,30.73%,31.09%,
107/01/24,-16785,-6,-2557,-19348,1233832,5272,9066,1248170,31.00%,31.36%,
107/01/23,-2316,-1500,4391,575,1250427,5278,11623,1267328,31.41%,31.83%,
107/01/22,-9298,0,-654,-9952,1252743,6778,7232,1266753,31.47%,31.82%,
107/01/19,-3905,0,685,-3220,1261713,6778,7886,1276377,31.70%,32.07%,
107/01/18,-9211,0,1340,-7871,1267634,6778,7201,1281613,31.85%,32.20%,
107/01/17,-17758,0,-1618,-19376,1274818,6778,5861,1287457,32.03%,32.35%,
107/01/16,-3211,-1507,4981,263,1285101,6778,7479,1299358,32.28%,32.64%,
107/01/15,397,-2046,642,-1007,1288126,8286,2498,1298910,32.36%,32.63%,
107/01/12,-13969,-2000,-26,-15995,1287729,10332,1856,1299917,32.35%,32.66%,
107/01/11,-22481,-1400,-1981,-25862,1300223,12332,1882,1314437,32.66%,33.02%,
107/01/10,-24281,-916,-807,-26004,1322649,13732,3863,1340244,33.23%,33.67%,
107/01/09,5557,-82,1611,7086,1346930,14648,4670,1366248,33.84%,34.33%,
107/01/08,-1145,0,-372,-1517,1341372,14730,3059,1359161,33.70%,34.15%,
107/01/05,1893,-6,-109,1778,1342231,14730,3431,1360392,33.72%,34.18%,
107/01/04,-11160,153,-754,-11761,1340338,14736,3540,1358614,33.67%,34.13%,
107/01/03,12455,-125,2612,14942,1351498,14583,4294,1370375,33.95%,34.42%,
107/01/02,6404,0,-530,5874,1339043,14708,1682,1355433,33.64%,34.05%,
106/12/29,-2143,0,912,-1231,1332639,14708,2212,1349559,33.48%,33.91%,
106/12/28,2366,-895,52,1523,1334782,11456,1300,1347538,33.53%,33.85%,
106/12/27,616,-122,-275,219,1332416,12351,1248,1346015,33.47%,33.81%,
106/12/26,-2831,-100,-1106,-4037,1335531,12473,1523,1349527,33.55%,33.90%,
106/12/25,8236,-978,-678,6580,1338362,12573,2629,1353564,33.62%,34.00%,
106/12/22,5061,-632,-5235,-806,1331126,13551,3307,1347984,33.44%,33.86%,
106/12/21,-322,-553,-733,-1608,1324397,14183,8542,1347122,33.27%,33.84%,
106/12/20,2822,-1965,-1391,-534,1325130,14736,9275,1349141,33.29%,33.89%,
106/12/19,3926,-80,730,4576,1325373,16701,10666,1352740,33.30%,33.99%,
106/12/18,883,-200,-466,217,1321447,16781,9936,1348164,33.20%,33.87%,
106/12/15,741,225,-1447,-481,1320564,16981,10401,1347946,33.17%,33.86%,
106/12/14,10834,0,-85,10749,1220708,16756,11848,1249312,34.09%,34.81%,
106/12/13,983,0,576,1559,1209874,16756,11933,1238563,33.79%,34.51%,
106/12/12,836,1,-3353,-2516,1208357,16756,11357,1236470,33.75%,34.46%,
106/12/11,-5032,0,4068,-964,1210449,16755,14710,1241914,33.81%,34.60%,
106/12/08,2064,-68,1261,3257,1215481,16755,10642,1242878,33.95%,34.64%,
106/12/07,-214,365,-503,-352,1214394,16823,9381,1240598,33.92%,34.58%,
106/12/06,-14259,-285,-2157,-16701,1219371,16458,9884,1245713,34.06%,34.72%,
106/12/05,10805,111,-2487,8429,1235745,16743,12041,1264529,34.51%,35.23%,
106/12/04,-20352,-2413,-3281,-26046,1228840,16632,14528,1260000,34.32%,35.10%,
106/12/01,410,-1095,-3311,-3996,1248652,19045,17809,1285506,34.87%,35.80%,
106/11/30,28527,-5561,-1726,21240,1248077,20140,21120,1289337,34.86%,35.90%,
106/11/29,-11125,-1996,-517,-13638,1212434,25701,22846,1260981,33.86%,35.08%,
106/11/28,-26479,-1278,-2475,-30232,1222807,27697,23363,1273867,34.15%,35.43%,
106/11/27,26036,0,3610,29646,1249203,28975,25838,1304016,34.89%,36.27%,
106/11/24,7933,-599,-104,7230,1223146,28975,22228,1274349,34.16%,35.45%,
106/11/23,16059,-1800,-14,14245,1211195,29574,22332,1263101,33.83%,35.13%,
106/11/22,634,-92,456,998,1195436,31374,22346,1249156,33.39%,34.74%,
106/11/21,10373,-20,111,10464,1194462,31466,21890,1247818,33.36%,34.70%,
106/11/20,-2034,331,1368,-335,1184089,31486,21779,1237354,33.07%,34.41%,
106/11/17,14812,103,350,15265,1186123,31155,20411,1237689,33.13%,34.43%,
106/11/16,2497,65,-177,2385,1171512,31052,20061,1222625,32.72%,34.00%,
106/11/15,6240,973,-83,7130,1169015,30987,20238,1220240,32.65%,33.94%,
106/11/14,5105,1939,3530,10574,1162775,30014,20321,1213110,32.47%,33.73%,
106/11/13,1851,27,-2582,-704,1151593,28075,16791,1196459,32.16%,33.29%,
106/11/10,5092,10,3314,8416,1149454,28048,19373,1196875,32.10%,33.29%,
106/11/09,3537,2,-1536,2003,1144371,28038,16059,1188468,31.96%,33.07%,
106/11/08,2178,323,-6164,-3663,1140482,28036,17595,1186113,31.85%,33.00%,
106/11/07,16031,1592,8509,26132,1137881,27713,23759,1189353,31.78%,33.07%,
106/11/06,8384,-1529,996,7851,1121548,26121,15250,1162919,31.32%,32.36%,
106/11/03,5150,-4428,329,1051,1114997,27650,14254,1156901,31.14%,32.19%,
106/11/02,2244,-481,-1647,116,1113085,32078,13925,1159088,31.09%,32.25%,
106/11/01,-4449,-2136,1592,-4993,1113421,32559,15572,1161552,31.10%,32.31%,
106/10/31,2100,-2446,768,422,1116881,34695,13980,1165556,31.19%,32.41%,
106/10/30,4605,8,510,5123,1114781,37141,13212,1165134,31.13%,32.54%,
106/10/27,6462,-7401,-1820,-2759,1110176,37133,12702,1160011,31.01%,32.40%,
106/10/26,7620,-961,1111,7770,1104427,44534,14522,1163483,30.84%,32.49%,
106/10/25,751,-4424,-5909,-9582,1096807,45495,13411,1155713,30.63%,32.28%,
106/10/24,3206,631,-206,3631,1093778,49919,19320,1163017,30.55%,32.48%,
106/10/23,1039,-89,230,1180,1090573,49288,19526,1159387,30.46%,32.38%,
106/10/20,1144,-332,2044,2856,1089533,49377,19296,1158206,30.43%,32.35%,
106/10/19,8205,-235,519,8489,1092558,49709,17252,1159519,30.51%,32.38%,
106/10/18,-16521,-897,-3077,-20495,1085018,49944,16733,1151695,30.30%,32.16%,
106/10/17,-1217,48,-1888,-3057,1101817,50841,19810,1172468,30.77%,32.74%,
106/10/16,1558,-502,-4378,-3322,1102817,50793,21698,1175308,30.80%,32.82%,
106/10/13,5317,4623,2994,12934,1099254,51295,26076,1176625,30.70%,32.86%,
106/10/12,-747,3475,-4218,-1490,1093532,46672,23082,1163286,30.54%,32.49%,
106/10/11,25612,-278,6002,31336,1094268,43197,27300,1164765,30.56%,32.53%,
106/10/06,-851,968,-804,-687,1068644,43475,21298,1133417,29.85%,31.66%,
106/10/05,-4948,-20,556,-4412,1069495,42507,22102,1134104,29.87%,31.67%,
106/10/03,4438,112,-396,4154,1075084,42527,21546,1139157,30.03%,31.82%,
106/10/02,3997,0,-1849,2148,1070886,42415,21942,1135243,29.91%,31.71%,
106/09/30,3,60,3889,3952,1066989,42415,23791,1133195,29.80%,31.65%,
106/09/29,11735,-2081,-995,8659,1066986,40769,19902,1127657,29.80%,31.49%,
106/09/28,1470,120,914,2504,1055011,42850,20897,1118758,29.46%,31.24%,
106/09/27,2282,369,1264,3915,1053542,42730,19983,1116255,29.42%,31.17%,
106/09/26,3091,43,-5028,-1894,1051260,42361,18719,1112340,29.36%,31.07%,
106/09/25,-16019,944,-1611,-16686,1048053,42318,23747,1114118,29.27%,31.12%,
106/09/22,8299,-577,-3625,4097,1064072,41374,25358,1130804,29.72%,31.58%,
106/09/21,-1508,675,4144,3311,1053709,41951,28983,1124643,29.43%,31.41%,
106/09/20,-907,1842,245,1180,1055217,41276,24839,1121332,29.47%,31.32%,
106/09/19,-9291,78,-5505,-14718,1056166,39434,24594,1120194,29.50%,31.29%,
106/09/18,8172,5305,-124,13353,1065679,39356,30099,1135134,29.76%,31.70%,
106/09/15,673,4137,4808,9618,1057507,34051,30223,1121781,29.53%,31.33%,
106/09/14,13594,-1494,917,13017,1058770,29914,25415,1114099,29.57%,31.12%,
106/09/13,-10668,0,-4582,-15250,1045204,31408,24498,1101110,29.19%,30.75%,
106/09/12,-12493,0,2367,-10126,1055875,31408,29080,1116363,29.49%,31.18%,
106/09/11,5463,0,-937,4526,1067918,31408,26713,1126039,29.83%,31.45%,
106/09/08,10630,-58,-1707,8865,1062438,31408,27650,1121496,29.67%,31.32%,
106/09/07,-2236,-1379,-1904,-5519,1049558,31466,29357,1110381,29.31%,31.01%,
106/09/06,3666,-578,-4646,-1558,1054423,32845,31261,1118529,29.45%,31.24%,
106/09/05,-10401,31,-2925,-13295,1050335,33423,35907,1119665,29.33%,31.27%,
106/09/04,31856,-1087,4321,35090,1060701,33392,38832,1132925,29.62%,31.64%,
106/09/01,7841,158,-1218,6781,1028777,34479,34511,1097767,28.73%,30.66%,
106/08/31,10786,-936,-1842,8008,1020926,34321,35729,1090976,28.51%,30.47%,
106/08/30,5385,0,-902,4483,1010086,35257,37571,1082914,28.21%,30.24%,
106/08/29,10841,301,-5076,6066,1004700,35257,38473,1078430,28.06%,30.12%,
106/08/28,-17531,1111,-1616,-18036,993741,34956,43549,1072246,27.75%,29.94%,
106/08/25,14318,1844,6059,22221,1010950,33845,45165,1089960,28.23%,30.44%,
106/08/24,2927,1070,-2235,1762,997450,32001,39106,1068557,27.86%,29.85%,
106/08/23,305,2882,-2321,866,994909,30931,41341,1067181,27.79%,29.81%,
106/08/22,10554,1361,5202,17117,994267,28049,43662,1065978,27.77%,29.77%,
106/08/21,5003,2487,-7781,-291,976111,26688,38460,1041259,27.26%,29.08%,
106/08/18,21013,1285,8379,30677,971019,24201,46241,1041461,27.12%,29.09%,
106/08/17,18646,567,10433,29646,950006,22916,37862,1010784,26.53%,28.23%,
106/08/16,3285,904,3890,8079,931360,22349,27429,981138,26.01%,27.40%,
106/08/15,-7506,-1855,-2333,-11694,927775,21445,23539,972759,25.91%,27.17%,
106/08/14,-15777,-1446,-6323,-23546,936341,23300,25872,985513,26.15%,27.52%,
106/08/11,2500,0,7906,10406,952187,24746,32195,1009128,26.59%,28.18%,
106/08/10,2700,-639,-1130,931,948627,24746,24289,997662,26.49%,27.86%,
106/08/09,4278,-30,-2970,1278,945968,25385,25419,996772,26.42%,27.84%,
106/08/08,5111,-1452,853,4512,942760,25415,28389,996564,26.33%,27.83%,
106/08/07,-960,-350,666,-644,943690,26867,27536,998093,26.36%,27.88%,
106/08/04,3502,-659,-482,2361,948990,27217,26870,1003077,26.50%,28.01%,
106/08/03,2757,-860,1978,3875,945488,27876,27352,1000716,26.41%,27.95%,
106/08/02,3166,-3037,146,275,942731,28736,25374,996841,26.33%,27.84%,
106/08/01,1568,-8069,-1314,-7815,940555,31773,25228,997556,26.27%,27.86%,
106/07/31,-6320,-3797,-5828,-15945,938587,39842,26542,1004971,26.21%,28.06%,
106/07/28,-2524,0,3982,1458,945041,43639,32370,1021050,26.39%,28.51%,
106/07/27,3129,0,-1374,1755,947565,43639,28388,1019592,26.46%,28.47%,
106/07/26,1712,670,77,2459,945686,43639,29762,1019087,26.41%,28.46%,
106/07/25,9010,1102,612,10724,943974,42969,29685,1016628,26.36%,28.39%,
106/07/24,798,0,-559,239,934964,41867,29073,1005904,26.11%,28.09%,
106/07/21,2881,-257,1911,4535,934166,41867,29632,1005665,26.09%,28.09%,
106/07/20,2680,-1258,37,1459,931785,42124,27721,1001630,26.02%,27.97%,
106/07/19,7442,-1212,-112,6118,929105,43382,27684,1000171,25.95%,27.94%,
106/07/18,3216,-2026,1476,2666,921663,44594,27796,994053,25.74%,27.76%,
106/07/17,336,-3716,-484,-3864,918697,46620,26320,991637,25.66%,27.70%,
106/07/14,-2659,-4605,-649,-7913,917861,50336,26804,995001,25.63%,27.78%,
106/07/13,2509,65,3573,6147,920545,54941,27453,1002939,25.71%,28.01%,
106/07/12,3883,-818,-29,3036,918092,54876,23880,996848,25.64%,27.84%,
106/07/11,1441,-627,435,1249,914209,55694,23909,993812,25.53%,27.75%,
106/07/10,706,-17,121,810,912968,56321,23474,992763,25.50%,27.73%,
106/07/07,1295,-268,-1625,-598,912180,56338,23353,991871,25.47%,27.70%,
106/07/06,-1110,-894,2357,353,910757,56606,24978,992341,25.44%,27.72%,
106/07/05,1509,-3690,-1927,-4108,906405,57500,22621,986526,25.31%,27.55%,
106/07/04,-407,-503,724,-186,904896,61190,24548,990634,25.27%,27.66%,
106/07/03,1147,-533,159,773,904903,61693,23824,990420,25.27%,27.66%,
106/06/30,1793,-992,-1907,-1106,903756,62226,23665,989647,25.24%,27.64%,
106/06/29,3320,-25,-185,3110,901829,57510,25572,984911,25.19%,27.51%,
106/06/28,-844,-1060,-6800,-8704,898509,57535,25757,981801,25.09%,27.42%,
106/06/27,10969,-1038,6902,16833,899353,58595,32557,990505,25.12%,27.67%,
106/06/26,3723,-658,1754,4819,890084,59633,25655,975372,24.86%,27.24%,
106/06/23,4673,-1314,-1726,1633,886361,60291,23901,970553,24.75%,27.10%,
106/06/22,-702,-292,-1314,-2308,881688,61605,25627,968920,24.62%,27.06%,
106/06/21,15037,-3455,138,11720,882390,61897,26941,971228,24.64%,27.12%,
106/06/20,-4192,-2535,277,-6450,867353,65352,26803,959508,24.22%,26.79%,
106/06/19,7586,41,-2661,4966,871092,67887,26526,965505,24.33%,26.97%,
106/06/16,694,-328,4259,4625,863686,67846,29187,960719,24.12%,26.83%,
106/06/15,-8286,-3358,2303,-9341,860612,68174,24928,953714,24.03%,26.63%,
106/06/14,11817,-5395,-1186,5236,866481,71532,22625,960638,24.20%,26.83%,
106/06/13,-13671,-1275,-2738,-17684,854664,76927,23811,955402,23.87%,26.68%,
106/06/12,1280,-280,969,1969,865294,78202,26549,970045,24.17%,27.10%,
106/06/09,-4311,-6061,-7614,-17986,863986,78482,25580,968048,24.13%,27.04%,
106/06/08,-1225,-1055,1859,-421,875896,84543,33194,993633,24.46%,27.75%,
106/06/07,8680,-1848,-9187,-2355,877201,85598,31335,994134,24.50%,27.77%,
106/06/06,1267,-100,4107,5274,871519,87446,40522,999487,24.34%,27.91%,
106/06/05,-2949,-1084,-436,-4469,870152,87546,36415,994113,24.30%,27.76%,
106/06/03,2179,355,-290,2244,872873,88630,36851,998354,24.38%,27.89%,
106/06/02,-6425,-1252,-3802,-11479,870694,88275,37141,996110,24.32%,27.82%,
106/06/01,9402,4414,14170,27986,878489,89527,40943,1008959,24.53%,28.17%,
106/05/31,3450,-508,6499,9441,870100,85113,26773,981986,24.30%,27.43%,
106/05/26,350,-19,-2629,-2298,866343,85621,20274,972238,24.19%,27.15%,
106/05/25,-1075,-4,2402,1323,864293,85640,22903,972836,24.14%,27.17%,
106/05/24,-874,209,1500,835,867708,85644,20501,973853,24.23%,27.19%,
106/05/23,-33,-155,-1029,-1217,868237,85435,19001,972673,24.25%,27.17%,
106/05/22,605,40,525,1170,868588,85590,20030,974208,24.26%,27.21%,
106/05/19,736,61,-2847,-2050,868475,85550,19505,973530,24.25%,27.18%,
106/05/18,8751,447,4310,13508,866435,85489,22352,974276,24.20%,27.21%,
106/05/17,85,-325,-1796,-2036,855825,85042,18042,958909,23.90%,26.78%,
106/05/16,-673,-1683,-2028,-4384,858057,85367,19838,963262,23.96%,26.90%,
106/05/15,-5516,4503,8306,7293,858614,87050,21866,967530,23.98%,27.02%,
106/05/12,4417,-4417,671,671,866735,82547,13560,962842,24.21%,26.89%,
106/05/11,5721,-1830,-476,3415,862304,86964,12889,962157,24.08%,26.87%,
106/05/10,10249,-1128,2686,11807,855562,88794,13365,957721,23.89%,26.74%,
106/05/09,5651,-6390,-3229,-3968,844287,89922,10679,944888,23.58%,26.39%,
106/05/08,4034,-1099,-2112,823,839978,96312,13909,950199,23.46%,26.54%,
106/05/05,5826,99,-3253,2672,836218,97411,16021,949650,23.35%,26.52%,
106/05/04,10209,-1763,1987,10433,830375,97312,19274,946961,23.19%,26.45%,
106/05/03,13461,-4099,-1713,7649,820104,99075,17287,936466,22.90%,26.15%,
106/05/02,2176,-4777,-3508,-6109,806557,103174,19000,928731,22.52%,25.93%,
106/04/28,-1693,-1191,-1339,-4223,804350,107951,22508,934809,22.46%,26.10%,
106/04/27,-2985,-1,-5455,-8441,805763,109142,23847,938752,22.50%,26.21%,
106/04/26,-2873,-600,12046,8573,808636,109143,29302,947081,22.58%,26.45%,
106/04/25,-158,-1,-436,-595,811345,109743,17256,938344,22.66%,26.21%,
106/04/24,-9347,0,-2307,-11654,809304,109744,17692,936740,22.60%,26.16%,
106/04/21,8069,81,1595,9745,816620,109744,19999,946363,22.81%,26.43%,
106/04/20,14146,-4600,-1420,8126,807123,109663,18404,935190,22.54%,26.12%,
106/04/19,-20940,5640,-3672,-18972,785806,114263,19824,919893,21.94%,25.69%,
106/04/18,52,1259,5595,6906,806568,108623,23496,938687,22.52%,26.21%,
106/04/17,-1346,347,-1898,-2897,806501,107364,17901,931766,22.52%,26.02%,
106/04/14,-4454,-327,-1519,-6300,808830,107017,19799,935646,22.59%,26.13%,
106/04/13,703,-499,-840,-636,813274,107344,21318,941936,22.71%,26.30%,
106/04/12,6272,-1068,-1217,3987,812571,107843,22158,942572,22.69%,26.32%,
106/04/11,13931,-228,-3803,9900,806288,108911,23375,938574,22.52%,26.22%,
106/04/10,-10243,1802,-2615,-11056,792348,109139,27178,928665,22.13%,25.94%,
106/04/07,6137,2083,7533,15753,802581,107337,29793,939711,22.41%,26.24%,
106/04/06,3762,-2894,-1446,-578,796434,105254,22260,923948,22.24%,25.80%,
106/04/05,31581,-1287,-7689,22605,792824,108148,23706,924678,22.14%,25.82%,
106/03/31,17025,7151,-2909,21267,760750,109435,31395,901580,21.24%,25.17%,
106/03/30,-11415,16503,-8237,-3149,745598,107006,34304,886908,20.82%,24.77%,
106/03/29,30417,3286,7019,40722,757123,90503,42541,890167,21.14%,24.86%,
106/03/28,-12025,6893,-9049,-14181,727142,87217,35522,849881,20.31%,23.74%,
106/03/27,-1698,10954,3711,12967,739750,80324,44571,864645,20.66%,24.15%,
106/03/24,-14114,15082,13200,14168,741221,69370,40860,851451,20.70%,23.78%,
106/03/23,9164,14690,2526,26380,754910,54288,27660,836858,21.08%,23.37%,
106/03/22,4919,4898,3750,13567,745470,39598,25134,810202,20.82%,22.63%,
106/03/21,-342,4463,-2995,1126,742250,34700,21384,798334,20.73%,22.30%,
106/03/20,1339,9097,8925,19361,742382,30237,24379,796998,20.73%,22.26%,
106/03/17,-659,94,3243,2678,740975,21140,15454,777569,20.69%,21.71%,
106/03/16,3687,100,-354,3433,741657,21046,12211,774914,20.71%,21.64%,
106/03/15,-850,2201,778,2129,738297,20946,12565,771808,20.62%,21.56%,
106/03/14,-6374,1405,-261,-5230,738902,18745,11787,769434,20.63%,21.48%,
106/03/13,73,5526,1071,6670,745232,17340,12048,774620,20.81%,21.63%,
106/03/10,-2335,50,-1527,-3812,745690,11814,10977,768481,20.82%,21.46%,
106/03/09,-12275,250,102,-11923,747318,11764,12504,771586,20.87%,21.55%,
106/03/08,-11005,2646,1469,-6890,758908,11514,12402,782824,21.19%,21.86%,
106/03/07,-6230,0,83,-6147,769683,8868,10933,789484,21.49%,22.04%,
106/03/06,-4938,0,912,-4026,775727,8868,10850,795445,21.66%,22.21%,
106/03/03,-6998,590,-2538,-8946,780617,8868,9938,799423,21.80%,22.33%,
106/03/02,-1730,638,4692,3600,788769,8278,12476,809523,22.03%,22.61%,
106/03/01,-5927,400,-662,-6189,790448,7640,7784,805872,22.07%,22.50%,
106/02/24,-1850,-1127,-158,-3135,796221,7240,8446,811907,22.24%,22.68%,
106/02/23,4448,-1933,-1073,1442,797286,8367,8604,814257,22.27%,22.74%,
106/02/22,-659,-180,1965,1126,792400,10300,9677,812377,22.13%,22.69%,
106/02/21,-2062,-1650,-53,-3765,792887,10480,7712,811079,22.14%,22.65%,
106/02/20,-6217,0,-3064,-9281,793800,12130,7765,813695,22.17%,22.73%,
106/02/18,-492,0,-232,-724,799377,12130,10829,822336,22.32%,22.96%,
106/02/17,504,0,694,1198,799869,12130,11061,823060,22.34%,22.99%,
106/02/16,-1175,0,-257,-1432,799365,12130,10367,821862,22.32%,22.95%,
106/02/15,-4453,0,226,-4227,800541,12130,10624,823295,22.36%,23.00%,
106/02/14,-1375,-158,-363,-1896,804994,12130,10398,827522,22.48%,23.11%,
106/02/13,-2301,-305,929,-1677,806369,12288,10761,829418,22.52%,23.16%,
106/02/10,-2485,-1325,1727,-2083,808670,12593,9832,831095,22.58%,23.21%,
106/02/09,-1006,-4688,235,-5459,811156,13918,8105,833179,22.65%,23.27%,
106/02/08,-9877,-1424,-2945,-14246,812212,18606,7870,838688,22.68%,23.42%,
106/02/07,-4669,-53,1925,-2797,822089,20030,10815,852934,22.96%,23.82%,
106/02/06,-3038,-178,2808,-408,826695,20083,8890,855668,23.09%,23.90%,
106/02/03,5807,2081,35,7923,829733,20261,6082,856076,23.17%,23.91%,
106/02/02,-6160,0,907,-5253,823834,18180,6047,848061,23.01%,23.69%,
106/01/24,3106,379,444,3929,830053,18180,5140,853373,23.18%,23.83%,
106/01/23,21017,1507,-1905,20619,826815,17801,4696,849312,23.09%,23.72%,
106/01/20,6540,11450,1293,19283,805663,16293,6601,828557,22.50%,23.14%,
106/01/19,12670,1551,-897,13324,799051,4843,5308,809202,22.31%,22.59%,
106/01/18,7436,950,-1734,6652,786381,3292,6205,795878,21.96%,22.23%,
106/01/17,7298,0,4224,11522,779916,2342,7939,790197,21.78%,22.07%,
106/01/16,-457,0,326,-131,773096,2342,3715,779153,21.59%,21.76%,
106/01/13,744,0,-227,517,773553,2342,3389,779284,21.60%,21.76%,
106/01/12,1300,0,27,1327,772810,2342,3616,778768,21.58%,21.75%,
106/01/11,1146,0,2,1148,771410,2342,3589,777341,21.54%,21.71%,
106/01/10,113,0,28,141,770264,2342,3587,776193,21.51%,21.68%,
106/01/09,-1001,0,-148,-1149,770151,2342,3559,776052,21.51%,21.67%,
106/01/06,-1099,43,406,-650,771152,2342,3707,777201,21.54%,21.71%,
106/01/05,825,65,314,1204,772214,2299,3301,777814,21.57%,21.73%,
106/01/04,1925,0,-141,1784,771333,2234,2987,776554,21.54%,21.69%,
106/01/03,1857,0,25,1882,769408,2234,3128,774770,21.49%,21.64%,
105/12/30,69,0,-416,-347,767551,2234,3103,772888,21.43%,21.58%,
105/12/29,900,0,-72,828,767482,2234,3519,773235,21.43%,21.59%,
105/12/28,1167,0,178,1345,766581,2234,3591,772406,21.41%,21.57%,
105/12/27,-137,0,-20,-157,765414,2234,3413,771061,21.38%,21.54%,
105/12/26,-72,9,-161,-224,765551,2234,3433,771218,21.38%,21.54%,
105/12/23,-1163,222,-203,-1144,765607,2225,3594,771426,21.38%,21.54%,
105/12/22,-614,283,-381,-712,766751,2003,3797,772551,21.41%,21.57%,
105/12/21,3919,0,341,4260,767354,1720,4178,773252,21.43%,21.59%,
105/12/20,-461,0,135,-326,763425,1720,3837,768982,21.32%,21.48%,
105/12/19,593,0,-131,462,763854,1720,3702,769276,21.33%,21.48%,
105/12/16,758,-6,287,1039,763229,1720,3833,768782,21.31%,21.47%,
105/12/15,139,0,65,204,762461,1726,3546,767733,21.29%,21.44%,
105/12/14,3214,0,55,3269,762294,1726,3481,767501,21.29%,21.44%,
105/12/13,3848,0,-55,3793,759047,1726,3426,764199,21.20%,21.34%,
105/12/12,-106,-1292,-16,-1414,755199,1726,3481,760406,21.09%,21.24%,
105/12/09,4923,0,545,5468,755295,3018,3497,761810,21.09%,21.27%,
105/12/08,-1834,-1655,13,-3476,750358,3018,2952,756328,20.95%,21.12%,
105/12/07,-643,0,-16,-659,752192,4673,2939,759804,21.01%,21.22%,
105/12/06,-3536,0,48,-3488,752835,4673,2955,760463,21.02%,21.23%,
105/12/05,-3220,0,-177,-3397,756361,4673,2907,763941,21.12%,21.33%,
105/12/02,-6730,-140,-961,-7831,759581,4673,3084,767338,21.21%,21.43%,
105/12/01,-1666,3,437,-1226,766288,4813,4045,775146,21.40%,21.65%,
105/11/30,-2474,0,103,-2371,767954,4810,3608,776372,21.45%,21.69%,
105/11/29,473,14,-245,242,770418,4810,3505,778733,21.52%,21.75%,
105/11/28,373,0,-29,344,770284,4796,3750,778830,21.51%,21.75%,
105/11/25,323,140,-841,-378,769862,4796,3779,778437,21.50%,21.74%,
105/11/24,-204,0,621,417,769510,4656,4620,778786,21.49%,21.75%,
105/11/23,572,0,592,1164,769700,4656,3999,778355,21.50%,21.74%,
105/11/22,-1025,4,145,-876,769128,4656,3407,777191,21.48%,21.71%,
105/11/21,-1738,0,967,-771,769154,4652,3262,777068,21.48%,21.70%,
105/11/18,538,0,575,1113,770891,4652,2295,777838,21.53%,21.72%,
105/11/17,-1095,0,-215,-1310,770179,4652,1720,776551,21.51%,21.69%,
105/11/16,-1282,0,-6,-1288,771274,4652,1935,777861,21.54%,21.72%,
105/11/15,-542,0,213,-329,772537,4652,1941,779130,21.57%,21.75%,
105/11/14,-82,0,-697,-779,773054,4652,1728,779434,21.59%,21.77%,
105/11/11,346,-145,-4,197,773136,4652,2425,780213,21.59%,21.79%,
105/11/10,1433,0,89,1522,772790,4797,2429,780016,21.58%,21.78%,
105/11/09,605,0,-260,345,771357,4797,2340,778494,21.54%,21.74%,
105/11/08,-590,0,-59,-649,770752,4797,2600,778149,21.52%,21.73%,
105/11/07,1269,-416,103,956,771342,4797,2659,778798,21.54%,21.75%,
105/11/04,-2537,146,-90,-2481,770073,5213,2556,777842,21.51%,21.73%,
105/11/03,-1457,0,122,-1335,772610,5067,2646,780323,21.58%,21.80%,
105/11/02,-4061,0,-45,-4106,774067,5067,2524,781658,21.62%,21.83%,
105/11/01,-441,0,-57,-498,778128,5067,2569,785764,21.73%,21.94%,
105/10/31,353,0,-88,265,778580,5067,2626,786273,21.74%,21.95%,
105/10/28,950,0,32,982,778540,5067,2714,786321,21.74%,21.96%,
105/10/27,-1584,0,16,-1568,777590,5067,2682,785339,21.72%,21.94%,
105/10/26,673,0,-229,444,779174,5067,2666,786907,21.76%,21.98%,
105/10/25,144,-215,-527,-598,778501,5067,2895,786463,21.74%,21.96%,
105/10/24,-67,0,853,786,778347,5282,3422,787051,21.74%,21.98%,
105/10/21,-286,286,-18,-18,778628,5282,2569,786479,21.74%,21.96%,
105/10/20,2067,295,-98,2264,778601,4996,2587,786184,21.74%,21.95%,
105/10/19,-1473,0,130,-1343,776534,4701,2685,783920,21.69%,21.90%,
105/10/18,582,0,115,697,778006,4701,2555,785262,21.73%,21.93%,
105/10/17,-121,0,112,-9,777613,4701,2440,784754,21.72%,21.92%,
105/10/14,-819,0,15,-804,777688,4701,2328,784717,21.72%,21.92%,
105/10/13,-262,0,-141,-403,778318,4701,2313,785332,21.74%,21.94%,
105/10/12,959,0,-209,750,778564,4701,2454,785719,21.74%,21.94%,
105/10/11,1229,0,-619,610,777605,4701,2663,784969,21.72%,21.93%,
105/10/07,-492,-2,-264,-758,776376,4701,3282,784359,21.68%,21.90%,
105/10/06,-311,0,124,-187,776868,4703,3546,785117,21.70%,21.93%,
105/10/05,492,0,-9,483,777179,4703,3422,785304,21.70%,21.93%,
105/10/04,-872,0,94,-778,776687,4703,3431,784821,21.69%,21.92%,
105/10/03,-2346,0,-91,-2437,777560,4703,3337,785600,21.71%,21.93%,
105/09/30,-1467,-150,-282,-1899,780245,4703,3428,788376,21.79%,22.02%,
105/09/29,-1062,0,189,-873,778695,5009,3710,787414,21.75%,21.99%,
105/09/26,-647,0,-84,-731,779721,5009,3521,788251,21.77%,22.01%,
105/09/23,2013,151,108,2272,780358,5009,3605,788972,21.79%,22.03%,
105/09/22,1959,0,-824,1135,778345,4858,3497,786700,21.74%,21.97%,
105/09/21,3293,0,54,3347,776386,4858,4321,785565,21.68%,21.94%,
105/09/20,1133,0,-46,1087,773093,4858,4267,782218,21.59%,21.84%,
105/09/19,-1860,0,106,-1754,771960,4858,4313,781131,21.56%,21.82%,
105/09/14,1027,-1002,-166,-141,773820,4858,4207,782885,21.61%,21.86%,
105/09/13,-1662,0,-365,-2027,772793,5860,4373,783026,21.58%,21.87%,
105/09/12,-1442,356,157,-929,774434,5860,4738,785032,21.63%,21.93%,
105/09/10,9,0,-978,-969,775866,5504,4581,785951,21.67%,21.95%,
105/09/09,-1200,-154,736,-618,775857,5504,5559,786920,21.67%,21.98%,
105/09/08,-1282,0,-554,-1836,777057,5658,4823,787538,21.70%,21.99%,
105/09/07,1086,0,1132,2218,778339,5658,5377,789374,21.74%,22.05%,
105/09/06,592,0,-323,269,777254,5658,4245,787157,21.71%,21.99%,
105/09/05,454,0,539,993,776662,5658,4568,786888,21.69%,21.98%,
105/09/02,949,154,-772,331,776161,5658,4029,785848,21.68%,21.95%,
105/09/01,889,0,-696,193,775264,5504,4801,785569,21.65%,21.94%,
105/08/31,5473,0,481,5954,774356,5504,5497,785357,21.63%,21.94%,
105/08/30,-1510,0,-249,-1759,768883,5504,5016,779403,21.47%,21.76%,
105/08/29,274,-293,-91,-110,770375,5504,5265,781144,21.51%,21.81%,
105/08/26,4339,1,77,4417,770074,5797,5356,781227,21.51%,21.82%,
105/08/25,1996,-1329,-366,301,765735,5796,5279,776810,21.38%,21.69%,
105/08/24,-1702,0,-2371,-4073,763694,7125,5645,776464,21.33%,21.69%,
105/08/23,-735,0,2832,2097,765259,7125,8016,780400,21.37%,21.79%,
105/08/22,5639,0,784,6423,765906,7125,5184,778215,21.39%,21.73%,
105/08/19,3392,-700,-347,2345,760267,7125,4400,771792,21.23%,21.55%,
105/08/18,2382,-2000,-447,-65,756875,7825,4747,769447,21.14%,21.49%,
105/08/17,3459,0,264,3723,755039,9825,5194,770058,21.09%,21.51%,
105/08/16,4306,0,684,4990,751581,9825,4930,766336,20.99%,21.40%,
105/08/15,1277,0,-217,1060,747560,9825,4246,761631,20.88%,21.27%,
105/08/12,4213,1183,807,6203,746282,9825,4463,760570,20.84%,21.24%,
105/08/11,538,0,-20,518,742039,8642,3656,754337,20.72%,21.06%,
105/08/10,1452,-13,-125,1314,741464,8642,3676,753782,20.71%,21.05%,
105/08/09,2065,0,-101,1964,739953,8655,3801,752409,20.66%,21.01%,
105/08/08,2579,-501,-196,1882,737888,8655,3902,750445,20.61%,20.96%,
105/08/05,-830,0,-56,-886,735309,9156,4098,748563,20.53%,20.90%,
105/08/04,-744,-3,-860,-1607,736024,9156,4154,749334,20.55%,20.92%,
105/08/03,7699,0,1384,9083,736710,9159,5014,750883,20.57%,20.97%,
105/08/02,2357,0,-342,2015,728951,9159,3630,741740,20.36%,20.72%,
105/08/01,6894,-299,-1182,5413,727123,9159,3972,740254,20.31%,20.68%,
105/07/29,-113,164,-1474,-1423,720506,9458,5154,735118,20.12%,20.53%,
105/07/28,5511,0,261,5772,720600,9294,6628,736522,20.12%,20.56%,
105/07/27,3310,0,-2212,1098,715066,9294,6367,730727,19.97%,20.41%,
105/07/26,2567,350,3554,6471,711647,9294,8579,729520,19.87%,20.37%,
105/07/25,2911,0,-424,2487,708988,8944,5025,722957,19.80%,20.19%,
105/07/22,-3071,1852,-1936,-3155,706043,8944,5449,720436,19.72%,20.12%,
105/07/21,-86,2046,3386,5346,709010,7092,7385,723487,19.80%,20.20%,
105/07/20,4389,0,-669,3720,708970,5046,3999,718015,19.80%,20.05%,
105/07/19,1519,767,724,3010,704552,5046,4668,714266,19.68%,19.95%,
105/07/18,179,0,-15,164,704533,4279,3944,712756,19.67%,19.90%,
105/07/15,1987,0,50,2037,704354,4279,3959,712592,19.67%,19.90%,
105/07/14,-1890,-1,63,-1828,700321,4279,3909,708509,19.56%,19.79%,
105/07/13,1196,0,-468,728,702199,4280,3846,710325,19.61%,19.84%,
105/07/12,1098,0,-340,758,700960,4280,4314,709554,19.57%,19.81%,
105/07/11,3138,0,1016,4154,699862,4280,4654,708796,19.54%,19.79%,
105/07/07,-1158,0,-88,-1246,696616,4280,3638,704534,19.45%,19.67%,
105/07/06,-3246,0,-439,-3685,697774,4280,3726,705780,19.49%,19.71%,
105/07/05,755,0,174,929,701007,4280,4165,709452,19.58%,19.82%,
105/07/04,80,0,-133,-53,700206,4280,3991,708477,19.55%,19.78%,
105/07/01,-1114,0,-327,-1441,700126,4280,4124,708530,19.55%,19.78%,
105/06/30,-1213,0,-93,-1306,701230,4280,4451,709961,19.58%,19.82%,
105/06/29,-2645,0,-406,-3051,702433,7633,4544,714610,19.62%,19.96%,
105/06/28,-1494,402,1937,845,705078,7633,4950,717661,19.69%,20.04%,
105/06/27,958,0,-21,937,706532,7231,3013,716776,19.73%,20.02%,
105/06/24,247,500,57,804,705574,7231,3034,715839,19.70%,19.99%,
105/06/23,4691,0,149,4840,705327,6731,2977,715035,19.70%,19.97%,
105/06/22,-280,0,-86,-366,700636,6731,2828,710195,19.57%,19.84%,
105/06/21,-1615,0,59,-1556,700916,6731,2914,710561,19.57%,19.84%,
105/06/20,608,0,44,652,702531,6731,2855,712117,19.62%,19.89%,
105/06/17,-1921,12,-47,-1956,701923,6731,2811,711465,19.60%,19.87%,
105/06/16,-636,0,-39,-675,703845,6719,2858,713422,19.66%,19.93%,
105/06/15,1216,0,48,1264,704481,6719,2897,714097,19.67%,19.94%,
105/06/14,-1331,0,31,-1300,703285,6719,2849,712853,19.64%,19.91%,
105/06/13,-827,-81,-85,-993,704538,6719,2818,714075,19.67%,19.94%,
105/06/08,-236,0,-215,-451,705365,6800,2903,715068,19.70%,19.97%,
105/06/07,-1666,0,443,-1223,705601,6800,3118,715519,19.70%,19.98%,
105/06/06,-1230,0,-70,-1300,707267,6800,2675,716742,19.75%,20.01%,
105/06/04,0,0,2,2,708497,6800,2745,718042,19.79%,20.06%,
105/06/03,-455,0,1,-454,708497,6800,2743,718040,19.79%,20.06%,
105/06/02,337,0,-207,130,708932,6800,2742,718474,19.80%,20.07%,
105/06/01,1245,0,326,1571,708595,6800,2949,718344,19.79%,20.06%,
105/05/31,-1226,0,78,-1148,707921,6800,2623,717344,19.77%,20.03%,
105/05/30,-978,0,5,-973,709147,6800,2545,718492,19.80%,20.06%,
105/05/27,166,0,-90,76,710073,6800,2540,719413,19.83%,20.09%,
105/05/26,-1218,4,-221,-1435,709897,6800,2630,719327,19.82%,20.08%,
105/05/25,1195,0,540,1735,711066,6796,2851,720713,19.86%,20.13%,
105/05/24,1046,0,13,1059,709861,6796,2311,718968,19.82%,20.07%,
105/05/23,550,0,92,642,708815,6796,2298,717909,19.79%,20.04%,
105/05/20,440,330,-35,735,708232,6796,2206,717234,19.78%,20.03%,
105/05/19,-446,0,144,-302,707757,6466,2241,716464,19.76%,20.00%,
105/05/18,-677,0,11,-666,708203,6466,2097,716766,19.78%,20.02%,
105/05/17,1771,0,-81,1690,708838,6466,2086,717390,19.79%,20.03%,
105/05/16,978,0,10,988,707067,6466,2167,715700,19.75%,19.99%,
105/05/13,-803,0,-67,-870,706079,6466,2157,714702,19.72%,19.96%,
105/05/12,-539,0,-254,-793,706882,6466,2224,715572,19.74%,19.98%,
105/05/11,-2058,0,74,-1984,707373,6466,2478,716317,19.75%,20.00%,
105/05/10,-1621,2,180,-1439,709394,6466,2404,718264,19.81%,20.06%,
105/05/09,-79,0,225,146,711015,6464,2224,719703,19.86%,20.10%,
105/05/06,-902,0,-11,-913,711094,6464,1999,719557,19.86%,20.10%,
105/05/05,-813,-437,115,-1135,711996,6464,2010,720470,19.88%,20.12%,
105/05/04,-3572,-1818,-287,-5677,712809,6901,1895,721605,19.91%,20.16%,
105/05/03,2609,-8,74,2675,716318,8719,2182,727219,20.00%,20.30%,
105/04/29,-224,0,-281,-505,713709,8727,2108,724544,19.93%,20.23%,
105/04/28,-1734,0,-139,-1873,713933,8727,2389,725049,19.94%,20.25%,
105/04/27,-1528,0,-39,-1567,715667,8727,2528,726922,19.99%,20.30%,
105/04/26,-292,0,-19,-311,717152,8727,2567,728446,20.03%,20.35%,
105/04/25,984,1,93,1078,717444,8727,2586,728757,20.04%,20.36%,
105/04/22,-1744,0,-42,-1786,716459,8726,2493,727678,20.01%,20.32%,
105/04/21,-262,0,-627,-889,718203,8726,2535,729464,20.06%,20.37%,
105/04/20,-2552,-2,376,-2178,718465,8726,3162,730353,20.06%,20.39%,
105/04/19,-6282,0,-175,-6457,721007,8728,2786,732521,20.13%,20.45%,
105/04/18,-671,0,4,-667,727238,8728,2961,738927,20.31%,20.64%,
105/04/15,-643,-239,-446,-1328,727909,8728,2957,739594,20.33%,20.66%,
105/04/14,486,0,-97,389,728531,8967,3403,740901,20.35%,20.70%,
105/04/13,4,0,529,533,728028,8967,3500,740495,20.33%,20.68%,
105/04/12,890,0,25,915,728006,8967,2971,739944,20.33%,20.66%,
105/04/11,-51,388,-224,113,727117,8967,2946,739030,20.31%,20.64%,
105/04/08,3264,0,-139,3125,727167,8579,3170,738916,20.31%,20.64%,
105/04/07,425,0,-700,-275,724002,8579,3309,735890,20.22%,20.55%,
105/04/06,3973,0,1161,5134,723546,8579,4009,736134,20.21%,20.56%,
105/04/01,24,0,-1820,-1796,719484,8579,2848,730911,20.09%,20.41%,
105/03/31,265,0,-440,-175,719460,8579,4668,732707,20.09%,20.46%,
105/03/30,5459,0,1074,6533,719195,8668,5108,732971,20.08%,20.46%,
105/03/29,2445,0,-215,2230,713736,8668,4034,726438,19.93%,20.28%,
105/03/28,2347,0,-5,2342,711291,8668,4249,724208,19.86%,20.22%,
105/03/25,-658,0,-707,-1365,708944,8668,4254,721866,19.80%,20.16%,
105/03/24,-1345,0,-341,-1686,709602,8668,4961,723231,19.82%,20.20%,
105/03/23,-389,0,857,468,710947,8668,5302,724917,19.85%,20.24%,
105/03/22,3162,0,67,3229,711336,8668,4445,724449,19.86%,20.23%,
105/03/21,295,0,-125,170,708174,8668,4378,721220,19.78%,20.14%,
105/03/18,244,-1,124,367,707879,8668,4503,721050,19.77%,20.14%,
105/03/17,469,0,291,760,707635,8669,4379,720683,19.76%,20.12%,
105/03/16,7319,1,271,7591,707324,8669,4088,720081,19.75%,20.11%,
105/03/15,-755,-1,-431,-1187,700005,8668,3817,712490,19.55%,19.90%,
105/03/14,1584,0,635,2219,700760,8669,4248,713677,19.57%,19.93%,
105/03/11,2066,0,521,2587,699176,8669,3613,711458,19.53%,19.87%,
105/03/10,2298,0,-89,2209,697110,8669,3092,708871,19.47%,19.80%,
105/03/09,-4063,0,-274,-4337,694812,8669,3181,706662,19.40%,19.73%,
105/03/08,6536,1,478,7015,698849,8669,3455,710973,19.52%,19.86%,
105/03/07,5187,0,294,5481,692313,8668,2977,703958,19.33%,19.66%,
105/03/04,-699,81,-98,-716,687126,8668,2683,698477,19.19%,19.51%,
105/03/03,640,0,-668,-28,687814,8587,2781,699182,19.21%,19.53%,
105/03/02,1525,-3,-1492,30,687162,8587,3449,699198,19.19%,19.53%,
105/03/01,9383,-81,1572,10874,685563,8590,4941,699094,19.14%,19.52%,
105/02/26,7275,0,-524,6751,676180,8671,3369,688220,18.88%,19.22%,
105/02/25,2041,0,-63,1978,668905,8671,3893,681469,18.68%,19.03%,
105/02/24,7865,0,-274,7591,667630,8671,3956,680257,18.64%,18.99%,
105/02/23,2338,0,-937,1401,659765,8671,4230,672666,18.42%,18.78%,
105/02/22,2305,0,1670,3975,657385,8671,5167,671223,18.36%,18.75%,
105/02/19,6752,-4,-59,6689,655080,8671,3497,667248,18.29%,18.63%,
105/02/18,4062,0,-379,3683,648328,8675,3556,660559,18.10%,18.44%,
105/02/17,15327,0,-877,14450,644266,8675,3935,656876,17.99%,18.34%,
105/02/16,-6616,0,56,-6560,628939,8675,4812,642426,17.56%,17.94%,
105/02/15,5598,-4,2423,8017,635506,8675,4756,648937,17.75%,18.13%,
105/02/03,9397,0,-1136,8261,629736,8679,2333,640748,17.59%,17.90%,
105/02/02,5394,0,-165,5229,620042,8679,3469,632190,17.31%,17.65%,
105/02/01,10322,81,-475,9928,614612,8679,3634,626925,17.16%,17.50%,
105/01/30,10,3,-218,-205,604259,8598,4109,616966,16.87%,17.22%,
105/01/29,9247,203,462,9912,604249,8595,4327,617171,16.87%,17.23%,
105/01/28,15372,0,1345,16717,594936,8392,3865,607193,16.61%,16.95%,
105/01/27,9118,0,394,9512,579564,8392,2520,590476,16.18%,16.48%,
105/01/26,8376,0,23,8399,570973,8392,2126,581491,15.94%,16.23%,
105/01/25,12299,0,85,12384,562597,8392,2103,573092,15.71%,16.00%,
105/01/22,10098,0,-134,9964,550298,8392,2018,560708,15.37%,15.66%,
105/01/21,10270,0,30,10300,540200,8392,2152,550744,15.08%,15.37%,
105/01/20,10508,-2,-620,9886,530063,8392,2122,540577,14.80%,15.09%,
105/01/19,18997,-6,907,19898,519624,8394,2742,530760,14.51%,14.82%,
105/01/18,1939,0,42,1981,500627,8400,1835,510862,13.98%,14.27%,
105/01/15,824,-2,-557,265,498701,8400,1793,508894,13.93%,14.21%,
105/01/14,2165,0,-163,2002,497877,8402,2350,508629,13.90%,14.20%,
105/01/13,-740,0,-11,-751,500910,8402,2513,511825,13.99%,14.29%,
105/01/12,709,0,-174,535,501650,8402,2524,512576,14.01%,14.32%,
105/01/11,-916,0,15,-901,500941,8402,2698,512041,13.99%,14.30%,
105/01/08,281,0,64,345,501857,8402,2683,512942,14.01%,14.32%,
105/01/07,-350,0,-269,-619,501576,8402,2619,512597,14.01%,14.32%,
105/01/06,-3075,0,-312,-3387,501926,8402,2888,513216,14.02%,14.34%,
105/01/05,-1735,-650,-172,-2557,504868,8402,3200,516470,14.10%,14.42%,
105/01/04,-3191,0,-744,-3935,505328,9052,3372,517752,14.11%,14.46%,
104/12/31,-1655,-450,-240,-2345,505586,9052,4116,518754,14.12%,14.49%,
104/12/30,-1111,0,-338,-1449,507241,4346,4356,515943,14.16%,14.40%,
104/12/29,-1120,-17,-428,-1565,506737,4346,4694,515777,14.15%,14.40%,
104/12/28,-1720,-15,-246,-1981,507857,4363,5122,517342,14.18%,14.44%,
104/12/25,393,0,-50,343,509577,4378,5368,519323,14.23%,14.50%,
104/12/24,659,0,-565,94,509184,4378,5418,518980,14.22%,14.49%,
104/12/23,1971,0,-937,1034,508525,4378,5983,518886,14.20%,14.49%,
104/12/22,-1632,104,-3097,-4625,507357,4378,6920,518655,14.17%,14.49%,
104/12/21,2247,900,5749,8896,508989,4274,10017,523280,14.21%,14.61%,
104/12/18,3312,-18,-970,2324,506742,3374,4268,514384,14.15%,14.36%,
104/12/17,6332,0,1291,7623,503469,3392,5238,512099,14.06%,14.30%,
104/12/16,-1164,0,-568,-1732,497137,3392,3947,504476,13.88%,14.09%,
104/12/15,3861,0,1530,5391,498465,3392,4515,506372,13.92%,14.14%,
104/12/14,372,-4,130,498,497939,3392,2985,504316,13.90%,14.08%,
104/12/11,2305,0,-91,2214,497348,3396,2855,503599,13.89%,14.06%,
104/12/10,444,0,-134,310,495024,3396,2946,501366,13.82%,14.00%,
104/12/09,-284,0,-58,-342,495672,3396,3080,502148,13.84%,14.02%,
104/12/08,1785,0,-240,1545,495881,3396,3138,502415,13.85%,14.03%,
104/12/07,1073,0,225,1298,494078,3396,3378,500852,13.80%,13.99%,
104/12/04,3243,0,-888,2355,492972,3396,3153,499521,13.77%,13.95%,
104/12/03,3095,0,844,3939,489805,3396,4041,497242,13.68%,13.89%,
104/12/02,1691,0,20,1711,487010,3396,3197,493603,13.60%,13.78%,
104/12/01,647,0,173,820,485319,3396,3177,491892,13.55%,13.73%,
104/11/30,-2180,0,-250,-2430,484598,3396,3004,490998,13.53%,13.70%,
104/11/27,368,0,-194,174,486778,3396,3254,493428,13.59%,13.77%,
104/11/26,397,0,-386,11,486688,3396,3448,493532,13.59%,13.78%,
104/11/25,-82,0,304,222,486281,3396,3834,493511,13.58%,13.78%,
104/11/24,1856,0,-82,1774,485956,3396,3530,492882,13.57%,13.76%,
104/11/23,191,0,-239,-48,484099,3396,3612,491107,13.52%,13.71%,
104/11/20,986,0,441,1427,483709,3396,3851,490956,13.09%,13.29%,
104/11/19,758,0,-411,347,482723,3396,3410,489529,13.06%,13.24%,
104/11/18,1164,0,-245,919,481955,3396,3821,489172,13.04%,13.24%,
104/11/17,1677,0,-1,1676,480791,3396,4066,488253,13.01%,13.21%,
104/11/16,-2006,0,-217,-2223,479114,3396,4067,486577,12.96%,13.16%,
104/11/13,1420,0,-30,1390,479813,3396,4284,487493,12.98%,13.19%,
104/11/12,-2325,0,-108,-2433,478377,3396,4314,486087,12.94%,13.15%,
104/11/11,-1251,0,-26,-1277,480396,3396,4422,488214,13.00%,13.21%,
104/11/10,1440,0,-128,1312,481580,3396,4448,489424,13.03%,13.24%,
104/11/09,-499,0,-148,-647,480140,3396,4576,488112,12.99%,13.21%,
104/11/06,-1933,0,-11,-1944,480629,3396,4724,488749,13.00%,13.22%,
104/11/05,2699,0,-631,2068,482562,3396,4735,490693,13.05%,13.27%,
104/11/04,5197,6,336,5539,479863,3396,5366,488625,12.98%,13.22%,
104/11/03,-1307,0,-554,-1861,474666,3390,5030,483086,12.84%,13.07%,
104/11/02,2501,0,739,3240,476113,3390,5584,485087,12.88%,13.12%,
104/10/30,5283,0,-86,5197,473612,3390,4845,481847,12.81%,13.03%,
104/10/29,5975,0,22,5997,468329,3390,4931,476650,12.67%,12.90%,
104/10/28,1198,0,-1040,158,462355,3390,4909,470654,12.51%,12.73%,
104/10/27,422,0,-401,21,461156,3390,5949,470495,12.48%,12.73%,
104/10/26,1672,0,2170,3842,465483,3390,6350,475223,12.59%,12.85%,
104/10/23,1177,1329,800,3306,463812,3390,4180,471382,12.55%,12.75%,
104/10/22,1901,0,307,2208,462635,2061,3380,468076,12.52%,12.67%,
104/10/21,1661,0,-1279,382,460594,2061,3073,465728,12.46%,12.60%,
104/10/20,2864,0,-23,2841,458933,2061,4352,465346,12.42%,12.59%,
104/10/19,115,0,-900,-785,456176,2061,4375,462612,12.34%,12.51%,
104/10/16,-325,0,713,388,456061,2061,5275,463397,12.34%,12.54%,
104/10/15,-1903,0,-647,-2550,456386,2061,4562,463009,12.35%,12.53%,
104/10/14,-202,0,1487,1285,459362,2061,5209,466632,12.43%,12.63%,
104/10/13,2283,0,-277,2006,459564,2061,3722,465347,12.43%,12.59%,
104/10/12,1472,0,517,1989,458904,2061,3999,464964,12.41%,12.57%,
104/10/08,2584,511,55,3150,457422,2061,3482,462965,12.37%,12.52%,
104/10/07,-604,0,-160,-764,454838,1550,3427,459815,12.30%,12.43%,
104/10/06,295,0,-455,-160,455967,1550,3587,461104,12.34%,12.48%,
104/10/05,-514,675,497,658,455617,1550,4042,461209,12.33%,12.48%,
104/10/02,-75,277,1096,1298,456007,875,3545,460427,12.34%,12.46%,
104/10/01,-320,0,110,-210,456082,598,2449,459129,12.34%,12.42%,
104/09/30,-1325,0,-40,-1365,456402,598,2339,459339,12.35%,12.43%,
104/09/25,-1834,-1000,14,-2820,456104,5184,2379,463667,12.34%,12.54%,
104/09/24,-2439,0,-939,-3378,457898,6184,2365,466447,12.39%,12.62%,
104/09/23,-4732,0,-2141,-6873,459626,6184,3304,469114,12.43%,12.69%,
104/09/22,-1159,1,1184,26,464299,6184,5445,475928,12.56%,12.87%,
104/09/21,-6123,27,-2645,-8741,465458,6183,4261,475902,12.59%,12.87%,
104/09/18,2014,4,4204,6222,471777,6156,6906,484839,12.76%,13.11%,
104/09/17,2015,0,-200,1815,469763,6152,2702,478617,12.71%,12.95%,
104/09/16,-3011,0,-294,-3305,467748,6152,2902,476802,12.65%,12.90%,
104/09/15,-3642,-500,505,-3637,471595,6152,3196,480943,12.76%,13.01%,
104/09/14,-186,0,32,-154,475478,6652,2691,484821,12.86%,13.11%,
104/09/11,-2892,0,-155,-3047,475799,6652,2659,485110,12.87%,13.12%,
104/09/10,921,0,-116,805,478691,6652,2814,488157,12.95%,13.21%,
104/09/09,258,0,-303,-45,482949,6652,2930,492531,13.07%,13.33%,
104/09/08,1389,0,108,1497,482690,6652,3233,492575,13.06%,13.33%,
104/09/07,849,7,-177,679,481301,6652,3125,491078,13.02%,13.28%,
104/09/04,-95,-498,-754,-1347,480452,6645,3302,490399,13.00%,13.27%,
104/09/03,3688,0,1789,5477,480547,7143,4056,491746,13.00%,13.30%,
104/09/02,-5386,0,241,-5145,477277,7143,2267,486687,12.91%,13.16%,
104/09/01,-1457,-4,-201,-1662,482663,7143,2026,491832,13.06%,13.31%,
104/08/31,-80,-2,-54,-136,484251,7147,2227,493625,13.10%,13.35%,
104/08/28,-10384,-1,203,-10182,484331,7149,2281,493761,13.10%,13.36%,
104/08/27,-9928,0,-11,-9939,494855,7150,2078,504083,13.39%,13.64%,
104/08/26,-2099,1,-51,-2149,504783,7150,2089,514022,13.66%,13.91%,
104/08/25,-4528,3,-26,-4551,506882,7149,2140,516171,13.71%,13.96%,
104/08/24,-2448,0,-58,-2506,511392,7146,2166,520704,13.84%,14.09%,
104/08/21,-1790,651,107,-1032,513830,7146,2224,523200,13.90%,14.15%,
104/08/20,-1650,0,-29,-1679,515610,6495,2117,524222,13.95%,14.18%,
104/08/19,-4930,0,-305,-5235,516953,6495,2146,525594,13.99%,14.22%,
104/08/18,-6287,0,-88,-6375,521829,6495,2451,530775,14.12%,14.36%,
104/08/17,-2049,0,-359,-2408,528051,6495,2539,537085,14.29%,14.53%,
104/08/14,1680,0,-482,1198,530100,6495,2898,539493,14.34%,14.59%,
104/08/13,7,0,629,636,528266,6495,3380,538141,14.29%,14.56%,
104/08/12,-1896,-3,2,-1897,528249,6495,2751,537495,14.29%,14.54%,
104/08/11,-7128,0,-1145,-8273,530135,6498,2749,539382,14.34%,14.59%,
104/08/10,-131,0,757,626,533839,6498,3894,544231,14.44%,14.72%,
104/08/07,-404,1,179,-224,532141,6498,3137,541776,14.40%,14.66%,
104/08/06,-5205,0,-181,-5386,532535,6497,2958,541990,14.41%,14.67%,
104/08/05,-891,805,155,69,537450,6497,3139,547086,14.54%,14.80%,
104/08/04,-986,0,166,-820,538316,5692,2984,546992,14.56%,14.79%,
104/08/03,-568,1848,-316,964,538711,5692,2818,547221,14.57%,14.80%,
104/07/31,-4116,1700,-409,-2825,538950,3844,3134,545928,14.58%,14.77%,
104/07/30,7103,0,539,7642,542994,2144,3543,548681,14.69%,14.84%,
104/07/29,-1988,0,37,-1951,535858,2144,3004,541006,14.50%,14.64%,
104/07/28,835,0,417,1252,536791,2144,2967,541902,14.52%,14.66%,
104/07/27,-1776,0,211,-1565,535997,2144,2550,540691,14.50%,14.63%,
104/07/24,14,3,36,53,537740,2144,2339,542223,14.55%,14.67%,
104/07/23,1512,0,-209,1303,537712,2141,2303,542156,14.55%,14.67%,
104/07/22,234,-202,20,52,536151,2141,2512,540804,14.51%,14.64%,
104/07/21,-1947,7,52,-1888,535875,2343,2492,540710,14.50%,14.63%,
104/07/20,-383,500,-49,68,537777,2336,2440,542553,14.55%,14.68%,
104/07/17,-1752,71,-112,-1793,538160,1836,2489,542485,14.56%,14.68%,
104/07/16,826,0,-9,817,539912,1765,2601,544278,14.61%,14.73%,
104/07/15,-1438,0,-172,-1610,534496,1765,2610,538871,14.46%,14.58%,
104/07/14,-822,0,-80,-902,535934,1765,2782,540481,14.50%,14.62%,
104/07/13,-8907,0,-159,-9066,536746,1765,2862,541373,14.52%,14.65%,
104/07/09,-1858,-6270,-338,-8466,545653,1765,3021,550439,14.76%,14.89%,
104/07/08,1458,0,-261,1197,547801,8035,3359,559195,14.82%,15.13%,
104/07/07,-4916,-1000,-12,-5928,546282,8035,3620,557937,14.78%,15.10%,
104/07/06,-4522,0,-207,-4729,550418,9035,3632,563085,14.89%,15.23%,
104/07/03,-331,-400,220,-511,554772,9035,3839,567646,15.01%,15.36%,
104/07/02,-210,0,343,133,555103,9435,3619,568157,15.02%,15.37%,
104/07/01,1148,0,-10,1138,555154,9435,3276,567865,15.02%,15.36%,
104/06/30,2498,0,-24,2474,553826,9435,3286,566547,14.98%,15.32%,
104/06/29,-3517,0,-497,-4014,551115,10111,3310,564536,14.91%,15.27%,
104/06/26,1294,-79,-68,1147,554413,10111,3807,568331,15.00%,15.38%,
104/06/25,579,-550,174,203,552960,10190,3875,567025,14.96%,15.34%,
104/06/24,686,-691,-79,-84,552220,10740,3701,566661,14.94%,15.33%,
104/06/23,374,0,111,485,551375,11431,3780,566586,14.92%,15.33%,
104/06/22,-1226,18,70,-1138,551962,11431,3669,567062,14.93%,15.34%,
104/06/18,2305,266,-70,2501,552976,11413,3599,567988,14.96%,15.37%,
104/06/17,-2367,-500,53,-2814,550512,11147,3669,565328,14.89%,15.29%,
104/06/16,-319,-1500,-82,-1901,552718,11647,3616,567981,14.95%,15.36%,
104/06/15,-7682,0,-176,-7858,552878,13147,3698,569723,14.96%,15.42%,
104/06/12,3,0,456,459,560485,13147,3874,577506,15.17%,15.63%,
104/06/11,-2004,0,12,-1992,560754,13147,3418,577319,15.17%,15.62%,
104/06/10,476,1000,-278,1198,562499,13147,3406,579052,15.22%,15.67%,
104/06/09,-2530,-382,-528,-3440,562023,12147,3684,577854,15.21%,15.64%,
104/06/08,-913,-300,-1141,-2354,564995,12529,4212,581736,15.29%,15.74%,
104/06/05,-4284,-2,-359,-4645,565898,12829,5353,584080,15.31%,15.80%,
104/06/04,-3630,-164,-214,-4008,570141,12831,5712,588684,15.43%,15.93%,
104/06/03,-1531,0,-117,-1648,573732,12995,5926,592653,15.52%,16.03%,
104/06/02,-3872,200,-136,-3808,575241,12995,6043,594279,15.57%,16.09%,
104/06/01,-999,0,-279,-1278,579103,12795,6179,598077,15.67%,16.18%,
104/05/29,-765,0,131,-634,580102,12795,6458,599355,15.70%,16.22%,
104/05/28,1020,581,-46,1555,580867,12795,6327,599989,15.72%,16.24%,
104/05/27,392,0,29,421,579972,12214,6373,598559,15.69%,16.19%,
104/05/26,677,0,123,800,579672,12214,6344,598230,15.69%,16.19%,
104/05/25,-1687,500,127,-1060,578995,12214,6221,597430,15.67%,16.17%,
104/05/22,-608,0,68,-540,580682,11714,6094,598490,15.71%,16.19%,
104/05/21,-1854,0,-425,-2279,581267,11714,6026,599007,15.73%,16.21%,
104/05/20,2746,0,1103,3849,583030,11714,6451,601195,15.78%,16.27%,
104/05/19,-244,0,-40,-284,580446,11714,5348,597508,15.71%,16.17%,
104/05/18,-2767,0,-89,-2856,580602,11714,5388,597704,15.71%,16.17%,
104/05/15,-2665,0,-171,-2836,583271,11714,5477,600462,15.78%,16.25%,
104/05/14,-4111,3,555,-3553,585937,11714,5648,603299,15.85%,16.32%,
104/05/13,202,0,162,364,590409,11711,5093,607213,15.98%,16.43%,
104/05/12,-5849,-3500,-691,-10040,590207,11711,4931,606849,15.97%,16.42%,
104/05/11,1094,-4406,-1445,-4757,596217,15211,5622,617050,16.13%,16.69%,
104/05/08,2848,-240,-61,2547,595123,19617,7067,621807,16.10%,16.82%,
104/05/07,2295,0,77,2372,592718,19857,7128,619703,16.04%,16.77%,
104/05/06,3398,0,-148,3250,590394,19857,7051,617302,15.98%,16.71%,
104/05/05,-548,-3004,-625,-4177,586498,19857,7199,613554,15.87%,16.60%,
104/05/04,284,0,9,293,586880,22861,7824,617565,15.88%,16.71%,
104/04/30,-583,1498,-103,812,586559,22861,7815,617235,15.87%,16.70%,
104/04/29,1684,-6031,-1148,-5495,587041,21363,7918,616322,15.88%,16.67%,
104/04/28,2294,-5,173,2462,585621,27394,9066,622081,15.85%,16.84%,
104/04/27,-1286,0,460,-826,583288,27399,8893,619580,15.78%,16.76%,
104/04/24,3501,590,351,4442,584823,27399,8433,620655,15.82%,16.79%,
104/04/23,2188,1000,500,3688,581179,26809,8082,616070,15.73%,16.67%,
104/04/22,3070,-1613,354,1811,578323,25809,7582,611714,15.65%,16.55%,
104/04/21,-890,0,-715,-1605,574090,27422,7228,608740,15.53%,16.47%,
104/04/20,1874,-4,-534,1336,574878,27422,7943,610243,15.56%,16.52%,
104/04/17,-301,707,-258,148,573004,27426,8477,608907,15.50%,16.47%,
104/04/16,-1983,2976,814,1807,573305,26719,8735,608759,15.51%,16.47%,
104/04/15,-4548,1863,-598,-3283,575288,23743,7921,606952,15.57%,16.43%,
104/04/14,-3153,14463,1799,13109,579836,21880,8519,610235,15.69%,16.51%,
104/04/13,-1006,167,652,-187,582989,7417,6720,597126,15.77%,16.15%,
104/04/10,685,600,-769,516,583995,7250,6068,597313,15.80%,16.16%,
104/04/09,-1932,0,-33,-1965,583310,6650,6837,596797,15.78%,16.15%,
104/04/08,-1272,0,-664,-1936,585242,6650,6870,598762,15.84%,16.21%,
104/04/07,446,0,-168,278,586514,6650,7534,600698,15.87%,16.25%,
104/04/02,-117,-200,-269,-586,586068,6650,7702,600420,15.86%,16.25%,
104/04/01,-2324,0,-232,-2556,586162,6850,7971,600983,15.86%,16.26%,
104/03/31,-2512,0,-92,-2604,588486,6850,8203,603539,15.92%,16.33%,
104/03/30,-3467,0,10,-3457,591496,7117,8295,606908,16.01%,16.43%,
104/03/27,1603,-209,-851,543,594816,7117,8285,610218,16.10%,16.52%,
104/03/26,-1219,0,-2045,-3264,593137,7326,9136,609599,16.05%,16.50%,
104/03/25,-3608,-1,971,-2638,594110,7326,11181,612617,16.08%,16.58%,
104/03/24,-552,-3,-2312,-2867,597668,7327,10210,615205,16.17%,16.64%,
104/03/23,-2644,-502,3226,80,598380,7330,12522,618232,16.19%,16.73%,
104/03/20,-59,-2,-683,-744,600993,7832,9296,618121,16.26%,16.72%,
104/03/19,-725,910,-2313,-2128,600999,7834,9979,618812,16.26%,16.74%,
104/03/18,-907,-325,2775,1543,601724,6924,12292,620940,16.28%,16.80%,
104/03/17,-2478,0,-2272,-4750,602560,7249,9518,619327,16.30%,16.75%,
104/03/16,-516,-454,2819,1849,605244,7249,11790,624283,16.38%,16.90%,
104/03/13,3159,0,-3313,-154,605592,7703,8971,622266,16.39%,16.84%,
104/03/12,1397,-1,3037,4433,602423,7703,12284,622410,16.30%,16.84%,
104/03/11,-1550,0,38,-1512,601225,7704,9247,618176,16.27%,16.73%,
104/03/10,2590,0,-387,2203,602591,7704,9209,619504,16.31%,16.77%,
104/03/09,332,-9,261,584,600001,7704,9596,617301,16.24%,16.71%,
104/03/06,4505,348,142,4995,599811,7713,9335,616859,16.23%,16.69%,
104/03/05,2869,-6,7,2870,595269,7365,9193,611827,16.11%,16.56%,
104/03/04,165,-52,213,326,592375,7371,9186,608932,16.03%,16.48%,
104/03/03,2982,-4,-205,2773,592147,7423,8973,608543,16.02%,16.46%,
104/03/02,6094,0,303,6397,589219,7427,9178,605824,15.94%,16.39%,
104/02/26,3010,399,-723,2686,583140,7427,8875,599442,15.78%,16.22%,
104/02/25,1049,1904,1275,4228,580077,7028,9598,596703,15.70%,16.15%,
104/02/24,7685,0,186,7871,579442,5124,8323,592889,15.68%,16.04%,
104/02/13,455,-21,-1165,-731,571747,5124,8137,585008,15.47%,15.83%,
104/02/12,-202,0,-775,-977,571392,5145,9302,585839,15.46%,15.85%,
104/02/11,-511,835,-926,-602,571594,5145,10077,586816,15.47%,15.88%,
104/02/10,-554,0,-1830,-2384,572106,4310,11003,587419,15.48%,15.89%,
104/02/09,-713,-19,-827,-1559,576953,4310,12833,594096,15.61%,16.07%,
104/02/06,-2536,0,-1555,-4091,577620,4329,13660,595609,15.63%,16.12%,
104/02/05,3533,0,-7420,-3887,579775,4329,15215,599319,15.69%,16.22%,
104/02/04,9539,2721,12576,24836,576101,4329,22635,603065,15.59%,16.32%,
104/02/03,5296,0,886,6182,566670,1608,10059,578337,15.33%,15.65%,
104/02/02,1079,0,-613,466,561374,1608,9173,572155,15.19%,15.48%,
104/01/30,944,-13,230,1161,560482,1608,9786,571876,15.17%,15.48%,
104/01/29,-694,0,-175,-869,559521,1621,9556,570698,15.14%,15.44%,
104/01/28,258,0,-447,-189,560188,1621,9731,571540,15.16%,15.47%,
104/01/27,-311,0,652,341,559776,1621,10178,571575,15.15%,15.47%,
104/01/26,-413,0,112,-301,560357,1621,9526,571504,15.16%,15.46%,
104/01/23,-2368,-223,34,-2557,560982,1621,9414,572017,15.18%,15.48%,
104/01/22,-74,818,-173,571,563550,1844,9380,574774,15.25%,15.55%,
104/01/21,-2159,0,-99,-2258,563932,1026,9553,574511,15.26%,15.55%,
104/01/20,1969,0,-1327,642,566338,1026,9652,577016,15.32%,15.61%,
104/01/19,-2084,0,-1639,-3723,564740,1026,10979,576745,15.28%,15.60%,
104/01/16,-3589,0,-3478,-7067,566739,1026,12618,580383,15.34%,15.71%,
104/01/15,-2003,0,4390,2387,570736,1026,16096,587858,15.44%,15.90%,
104/01/14,4933,0,-637,4296,572320,1026,11706,585052,15.49%,15.83%,
104/01/13,-1230,0,-1412,-2642,567293,1026,12343,580662,15.35%,15.71%,
104/01/12,639,0,-2003,-1364,568468,1026,13755,583249,15.38%,15.78%,
104/01/09,-2353,0,810,-1543,567433,1026,15758,584217,15.35%,15.80%,
104/01/08,-2011,0,126,-1885,569713,1026,14948,585687,15.42%,15.85%,
104/01/07,2149,-5,-3567,-1423,571350,1026,14822,587198,15.46%,15.89%,
104/01/06,-596,223,-4928,-5301,568578,1031,18389,587998,15.38%,15.91%,
104/01/05,-1612,0,9008,7396,568751,808,23317,592876,15.39%,16.04%,
