日期,外資買賣超,投信買賣超,自營商買賣超,單日合計買賣超,外資估計持股,投信估計持股,自營商估計持股,單日合計估計持股,外資持股比重,三大法人持股比重,
107/03/31,11,0,21,32,903039,13962,9803,926804,9.47%,9.72%,
107/03/30,1312,-808,179,683,903028,13962,9782,926772,9.47%,9.72%,
107/03/29,735,0,15,750,901716,14770,9603,926089,9.46%,9.72%,
107/03/28,321,0,-201,120,900982,14770,9588,925340,9.45%,9.71%,
107/03/27,1248,-42,51,1257,901255,14770,9789,925814,9.46%,9.72%,
107/03/26,907,123,-3,1027,900444,14812,9738,924994,9.45%,9.71%,
107/03/23,1078,94,-341,831,893052,14689,9741,917482,9.37%,9.63%,
107/03/22,-1188,-8,-300,-1496,891974,14595,10082,916651,9.36%,9.62%,
107/03/21,-4687,-138,571,-4254,893162,14603,10382,918147,9.37%,9.63%,
107/03/20,-302,-73,-25,-400,897847,14741,9811,922399,9.42%,9.68%,
107/03/19,51,-6,17,62,898135,14814,9836,922785,9.42%,9.68%,
107/03/16,334,-1156,-75,-897,897952,14820,9819,922591,9.42%,9.68%,
107/03/15,-52,-28,23,-57,897292,15976,9894,923162,9.41%,9.68%,
107/03/14,-109,-69,287,109,897241,16004,9871,923116,9.41%,9.68%,
107/03/13,717,-25,-91,601,897351,16073,9584,923008,9.42%,9.69%,
107/03/12,452,-10,32,474,896633,16098,9675,922406,9.41%,9.68%,
107/03/09,-90,-3,0,-93,896181,16108,9643,921932,9.40%,9.67%,
107/03/08,-457,-27,-34,-518,896271,16111,9643,922025,9.40%,9.67%,
107/03/07,-322,-1,-164,-487,896728,16138,9677,922543,9.41%,9.68%,
107/03/06,897,0,-66,831,897050,16139,9841,923030,9.41%,9.68%,
107/03/05,-1222,10,-129,-1341,896153,16139,9907,922199,9.40%,9.67%,
107/03/02,-1631,6,-446,-2071,897375,16129,10036,923540,9.42%,9.69%,
107/03/01,-386,-76,38,-424,899005,16123,10482,925610,9.43%,9.71%,
107/02/27,553,-9,-213,331,899403,16199,10444,926046,9.44%,9.72%,
107/02/26,-294,-1,-89,-384,898815,16208,10657,925680,9.43%,9.71%,
107/02/23,623,-3,-18,602,899109,16209,10746,926064,9.43%,9.71%,
107/02/22,-37,-69,8,-98,898486,16212,10764,925462,9.43%,9.71%,
107/02/21,1267,-50,-40,1177,898546,16281,10756,925583,9.43%,9.71%,
107/02/12,-1857,-90,-56,-2003,897333,16331,10796,924460,9.41%,9.69%,
107/02/09,-1152,-20,19,-1153,898770,16421,10852,926043,9.43%,9.72%,
107/02/08,319,-194,9,134,899939,16441,10833,927213,9.44%,9.73%,
107/02/07,-3932,1920,-119,-2131,899653,16635,10824,927112,9.44%,9.73%,
107/02/06,-3353,505,-553,-3401,903635,14715,10943,929293,9.48%,9.75%,
107/02/05,1409,-250,-610,549,906989,14210,11496,932695,9.52%,9.79%,
107/02/02,-322,-154,56,-420,905579,14460,12106,932145,9.50%,9.78%,
107/02/01,567,-79,-68,420,905893,14614,12050,932557,9.50%,9.78%,
107/01/31,49,21,438,508,905295,14693,12118,932106,9.50%,9.78%,
107/01/30,-473,-64,-28,-565,905276,14672,11680,931628,9.50%,9.78%,
107/01/29,150,0,-394,-244,905813,14736,11708,932257,9.50%,9.78%,
107/01/26,170,-66,87,191,905643,14736,12102,932481,9.50%,9.78%,
107/01/25,984,-160,84,908,905473,14802,12015,932290,9.50%,9.78%,
107/01/24,-65,-17,-15,-97,904462,14962,11931,931355,9.49%,9.77%,
107/01/23,1355,-100,-119,1136,904662,14979,11946,931587,9.49%,9.77%,
107/01/22,917,-50,-103,764,903307,15079,12065,930451,9.48%,9.76%,
107/01/19,925,-103,-15,807,902390,15129,12168,929687,9.47%,9.76%,
107/01/18,2279,-221,-61,1997,901348,15232,12183,928763,9.46%,9.75%,
107/01/17,4856,0,-120,4736,899069,15453,12244,926766,9.43%,9.72%,
107/01/16,1128,-62,2,1068,894213,15453,12364,922030,9.38%,9.67%,
107/01/15,1140,-25,-648,467,893085,15515,12362,920962,9.37%,9.66%,
107/01/12,1916,0,-258,1658,891945,15540,13010,920495,9.36%,9.66%,
107/01/11,1584,0,-70,1514,890029,15540,13268,918837,9.34%,9.64%,
107/01/10,1220,39,237,1496,888445,15540,13338,917323,9.32%,9.62%,
107/01/09,-1146,77,98,-971,887225,15501,13101,915827,9.31%,9.61%,
107/01/08,754,-100,181,835,888371,15424,13003,916798,9.32%,9.62%,
107/01/05,756,39,36,831,887617,15524,12822,915963,9.31%,9.61%,
107/01/04,1586,-287,506,1805,886851,15485,12786,915122,9.30%,9.60%,
107/01/03,2195,269,468,2932,885265,15772,12280,913317,9.29%,9.58%,
107/01/02,1070,30,144,1244,883069,15503,11812,910384,9.27%,9.56%,
106/12/29,1721,0,-103,1618,882191,15473,11668,909332,9.26%,9.54%,
106/12/28,2139,25,104,2268,880480,15372,11771,907623,9.24%,9.52%,
106/12/27,1846,242,144,2232,878341,15347,11667,905355,9.22%,9.50%,
106/12/26,553,1,-45,509,876495,15105,11523,903123,9.20%,9.48%,
106/12/25,488,-183,146,451,875942,15104,11568,902614,9.19%,9.47%,
106/12/22,863,-22,7,848,875454,15287,11422,902163,9.19%,9.47%,
106/12/21,1167,0,65,1232,874622,15309,11415,901346,9.18%,9.46%,
106/12/20,695,100,65,860,873469,15309,11350,900128,9.16%,9.44%,
106/12/19,724,-32,-265,427,872192,15209,11285,898686,9.15%,9.43%,
106/12/18,746,108,345,1199,871458,15241,11550,898249,9.14%,9.42%,
106/12/15,-271,61,-9,-219,870739,15133,11205,897077,9.14%,9.42%,
106/12/14,276,32,176,484,870979,15072,11214,897265,9.14%,9.42%,
106/12/13,1220,340,523,2083,870621,15040,11038,896699,9.13%,9.40%,
106/12/12,581,20,0,601,869415,14700,10515,894630,9.12%,9.38%,
106/12/11,-97,3,105,11,868886,14680,10515,894081,9.12%,9.38%,
106/12/08,-244,-21,45,-220,869000,14677,10410,894087,9.12%,9.38%,
106/12/07,-146,0,24,-122,869348,14698,10365,894411,9.12%,9.38%,
106/12/06,-732,46,26,-660,869494,14698,10341,894533,9.12%,9.38%,
106/12/05,459,410,276,1145,870160,14652,10315,895127,9.13%,9.39%,
106/12/04,417,0,17,434,869589,14242,10039,893870,9.12%,9.37%,
106/12/01,-1,144,-10,133,869186,14242,10022,893450,9.12%,9.37%,
106/11/30,132,-108,-10,14,869192,14098,10032,893322,9.12%,9.37%,
106/11/29,-194,-52,0,-246,869059,14206,10042,893307,9.12%,9.37%,
106/11/28,383,-62,-30,291,869376,14258,10042,893676,9.12%,9.38%,
106/11/27,-488,-100,30,-558,868950,14320,10072,893342,9.12%,9.38%,
106/11/24,-48,-50,-11,-109,869676,14420,10042,894138,9.12%,9.38%,
106/11/23,211,-30,0,181,869724,14470,10053,894247,9.13%,9.39%,
106/11/22,919,40,0,959,869528,14500,10053,894081,9.12%,9.38%,
106/11/21,1530,-250,111,1391,868626,14460,10053,893139,9.11%,9.37%,
106/11/20,-624,30,110,-484,866919,14710,9942,891571,9.10%,9.36%,
106/11/17,-315,-67,80,-302,867476,14680,9832,891988,9.10%,9.36%,
106/11/16,-415,-162,180,-397,867709,14747,9752,892208,9.10%,9.36%,
106/11/15,-364,41,-5,-328,868085,14909,9572,892566,9.11%,9.37%,
106/11/14,-38,-13,-50,-101,868449,14868,9577,892894,9.11%,9.37%,
106/11/13,-73,29,3,-41,868507,14881,9627,893015,9.11%,9.37%,
106/11/10,-138,10,0,-128,868570,14852,9624,893046,9.11%,9.37%,
106/11/09,-1559,-7,2,-1564,868702,14842,9624,893168,9.11%,9.37%,
106/11/08,-75,48,-100,-127,870261,14849,9622,894732,9.13%,9.39%,
106/11/07,-346,30,0,-316,870336,14801,9722,894859,9.13%,9.39%,
106/11/06,-633,30,8,-595,870603,14771,9722,895096,9.13%,9.39%,
106/11/03,704,1,3,708,871236,14741,9714,895691,9.14%,9.40%,
106/11/02,217,0,0,217,870532,14740,9711,894983,9.13%,9.39%,
106/11/01,592,-8,-4,580,870315,14740,9711,894766,9.13%,9.39%,
106/10/31,282,0,40,322,869723,14748,9715,894186,9.13%,9.39%,
106/10/30,-229,0,-2,-231,869358,14748,9675,893781,9.12%,9.38%,
106/10/27,-184,-13,0,-197,869587,14748,9677,894012,9.12%,9.38%,
106/10/26,78,-214,0,-136,869741,14761,9677,894179,9.13%,9.39%,
106/10/25,372,-517,0,-145,869663,14975,9677,894315,9.12%,9.38%,
106/10/24,576,-63,0,513,869114,15492,9677,894283,9.12%,9.38%,
106/10/23,-487,-174,0,-661,868669,15555,9677,893901,9.11%,9.37%,
106/10/20,-1970,-121,4,-2087,869175,15729,9677,894581,9.12%,9.39%,
106/10/19,931,-86,109,954,871146,15850,9673,896669,9.14%,9.41%,
106/10/18,1150,-2,50,1198,870215,15936,9564,895715,9.13%,9.40%,
106/10/17,827,-32,0,795,869065,15938,9514,894517,9.12%,9.39%,
106/10/16,-223,-7,0,-230,868238,15970,9514,893722,9.11%,9.38%,
106/10/13,-320,-83,0,-403,868461,15977,9514,893952,9.11%,9.38%,
106/10/12,658,4,81,743,868781,16060,9514,894355,9.12%,9.39%,
106/10/11,764,4,-68,700,867973,16056,9433,893462,9.11%,9.38%,
106/10/06,749,61,50,860,867198,16052,9501,892751,9.10%,9.37%,
106/10/05,700,-18,0,682,866530,15991,9451,891972,9.09%,9.36%,
106/10/03,-401,15,38,-348,865810,16009,9451,891270,9.08%,9.35%,
106/10/02,167,16,56,239,866176,15994,9413,891583,9.09%,9.36%,
106/09/30,0,153,97,250,866009,15978,9357,891344,9.09%,9.36%,
106/09/29,-260,0,-50,-310,866009,16927,9260,892196,9.09%,9.36%,
106/09/28,-883,0,-88,-971,866286,16927,9310,892523,9.09%,9.37%,
106/09/27,331,337,-79,589,867303,16927,9398,893628,9.10%,9.38%,
106/09/26,-53,198,30,175,867024,16590,9477,893091,9.10%,9.37%,
106/09/25,438,0,3,441,866971,16392,9447,892810,9.10%,9.37%,
106/09/22,-171,0,-22,-193,866532,16392,9444,892368,9.09%,9.36%,
106/09/21,-270,-93,0,-363,866719,16392,9466,892577,9.09%,9.36%,
106/09/20,139,0,67,206,866989,16485,9466,892940,9.10%,9.37%,
106/09/19,-1288,14,15,-1259,866827,16485,9399,892711,9.09%,9.36%,
106/09/18,493,53,0,546,868100,16471,9384,893955,9.11%,9.38%,
106/09/15,-259,146,-48,-161,867587,16418,9384,893389,9.10%,9.37%,
106/09/14,-706,163,-8,-551,867846,16272,9432,893550,9.11%,9.38%,
106/09/13,-471,-251,10,-712,868538,16109,9440,894087,9.11%,9.38%,
106/09/12,27,2,2,31,868999,16360,9430,894789,9.12%,9.39%,
106/09/11,-358,0,31,-327,868972,16358,9428,894758,9.12%,9.39%,
106/09/08,99,-259,-66,-226,869330,16358,9397,895085,9.12%,9.39%,
106/09/07,-845,-69,-18,-932,869534,16617,9463,895614,9.12%,9.39%,
106/09/06,-1104,-204,-459,-1767,870336,16686,9481,896503,9.13%,9.40%,
106/09/05,366,-257,36,145,871256,16890,9940,898086,9.14%,9.42%,
106/09/04,679,39,0,718,870880,17147,9904,897931,9.14%,9.42%,
106/09/01,-320,35,0,-285,870201,17108,9904,897213,9.13%,9.41%,
106/08/31,-741,40,1,-700,871121,17073,9904,898098,9.14%,9.42%,
106/08/30,-103,0,-172,-275,871862,17033,9903,898798,9.15%,9.43%,
106/08/29,-126,-10,-64,-200,871965,17033,10075,899073,9.15%,9.43%,
106/08/28,122,14,-20,116,872081,17043,10139,899263,9.15%,9.44%,
106/08/25,20,-3,16,33,871959,17029,10159,899147,9.15%,9.44%,
106/08/24,998,282,-3,1277,871978,17032,10143,899153,9.15%,9.44%,
106/08/23,-1181,-2,-569,-1752,870980,16750,10146,897876,9.14%,9.42%,
106/08/22,-79,-14,0,-93,872161,16752,10715,899628,9.15%,9.44%,
106/08/21,-304,74,-81,-311,872230,16766,10715,899711,9.15%,9.44%,
106/08/18,-870,0,0,-870,872534,16692,10796,900022,9.15%,9.44%,
106/08/17,-635,30,-3,-608,873404,16692,10796,900892,9.16%,9.45%,
106/08/16,-2511,-17,-29,-2557,874039,16662,10799,901500,9.17%,9.46%,
106/08/15,-277,187,-50,-140,876529,16679,10828,904036,9.20%,9.49%,
106/08/14,259,38,50,347,876788,16492,10878,904158,9.20%,9.49%,
106/08/11,-169,148,-1,-22,876518,16454,10828,903800,9.20%,9.49%,
106/08/10,-1043,176,-40,-907,876688,16306,10829,903823,9.20%,9.48%,
106/08/09,-540,4,-385,-921,877730,16130,10869,904729,9.21%,9.49%,
106/08/08,-1717,53,-46,-1710,878260,16126,11254,905640,9.21%,9.50%,
106/08/07,742,253,-17,978,879915,16073,11300,907288,9.23%,9.52%,
106/08/04,315,321,-109,527,879157,15820,11317,906294,9.22%,9.50%,
106/08/03,-535,-398,-46,-979,878842,15499,11426,905767,9.22%,9.50%,
106/08/02,-65,-15,-1,-81,879375,15897,11472,906744,9.23%,9.52%,
106/08/01,-231,33,4,-194,879440,15912,11473,906825,9.23%,9.52%,
106/07/31,651,-1,-48,602,879671,15879,11469,907019,9.23%,9.52%,
106/07/28,-99,27,19,-53,878978,15880,11517,906375,9.22%,9.51%,
106/07/27,983,240,148,1371,879066,15853,11498,906417,9.22%,9.51%,
106/07/26,-2190,108,-466,-2548,877774,15613,11350,904737,9.21%,9.49%,
106/07/25,-1491,-38,-64,-1593,879315,15505,11816,906636,9.23%,9.52%,
106/07/24,-335,0,-169,-504,880590,15543,11880,908013,9.24%,9.53%,
106/07/21,-468,-114,-40,-622,880829,15543,12049,908421,9.24%,9.53%,
106/07/20,-529,69,-40,-500,881327,15657,12089,909073,9.25%,9.54%,
106/07/19,-418,-3,-17,-438,881856,15588,12129,909573,9.25%,9.54%,
106/07/18,-589,31,-37,-595,882273,15591,12146,910010,9.26%,9.55%,
106/07/17,931,0,-48,883,882822,15560,12183,910565,9.26%,9.55%,
106/07/14,-484,-168,-11,-663,881891,15560,12231,909682,9.25%,9.54%,
106/07/13,-484,21,-17,-480,882374,15728,12242,910344,9.26%,9.55%,
106/07/12,-371,42,-307,-636,882848,15707,12259,910814,9.26%,9.55%,
106/07/11,884,-81,482,1285,883180,15665,12566,911411,9.27%,9.57%,
106/07/10,-79,-11,-142,-232,882196,15746,12084,910026,9.26%,9.55%,
106/07/07,492,-171,0,321,882265,15757,12226,910248,9.26%,9.55%,
106/07/06,-1082,-250,-38,-1370,881773,15928,12226,909927,9.25%,9.55%,
106/07/05,-473,0,545,72,882856,16178,12264,911298,9.26%,9.56%,
106/07/04,-497,-13,-1,-511,883329,16178,11719,911226,9.27%,9.56%,
106/07/03,578,-5,-30,543,883777,16191,11720,911688,9.27%,9.56%,
106/06/30,1268,-105,4,1167,883200,16196,11750,911146,9.27%,9.56%,
106/06/29,-1206,-206,24,-1388,881932,15008,11746,908686,9.25%,9.53%,
106/06/28,1914,-215,-966,733,883158,15214,11722,910094,9.27%,9.55%,
106/06/27,-641,-38,688,9,881334,15429,12688,909451,9.25%,9.55%,
106/06/26,2500,-65,1154,3589,881975,15467,12000,909442,9.25%,9.54%,
106/06/23,-2137,-125,19,-2243,879897,15532,10846,906275,9.23%,9.51%,
106/06/22,281,-317,-20,-56,882256,15657,10827,908740,9.26%,9.54%,
106/06/21,1286,0,173,1459,880558,15974,10847,907379,9.24%,9.52%,
106/06/20,-318,176,163,21,879344,15974,10674,905992,9.23%,9.51%,
106/06/19,143,-20,108,231,879831,15798,10511,906140,9.23%,9.51%,
106/06/16,-0,-223,109,-114,879688,15818,10403,905909,9.23%,9.51%,
106/06/15,-379,0,-200,-579,880086,16041,10294,906421,9.23%,9.51%,
106/06/14,-211,56,-22,-177,880962,16041,10494,907497,9.24%,9.52%,
106/06/13,106,5,-99,12,881598,15985,10516,908099,9.25%,9.53%,
106/06/12,-280,0,38,-242,882086,15980,10615,908681,9.25%,9.53%,
106/06/09,-226,-14,1,-239,882392,15980,10577,908949,9.26%,9.54%,
106/06/08,515,-27,17,505,882618,15994,10576,909188,9.26%,9.54%,
106/06/07,348,-330,116,134,883543,16021,10559,910123,9.27%,9.55%,
106/06/06,37,-26,44,55,883195,16351,10443,909989,9.27%,9.55%,
106/06/05,589,-26,9,572,883364,16377,10399,910140,9.27%,9.55%,
106/06/03,21,-113,5,-87,882775,16403,10390,909568,9.26%,9.54%,
106/06/02,825,-187,-16,622,882754,16516,10385,909655,9.26%,9.54%,
106/06/01,129,-512,45,-338,882019,16703,10401,909123,9.25%,9.53%,
106/05/31,2788,-94,21,2715,881880,17215,10356,909451,9.25%,9.54%,
106/05/26,1468,-238,2,1232,878892,17309,10335,906536,9.22%,9.51%,
106/05/25,427,-108,26,345,877424,17547,10333,905304,9.21%,9.50%,
106/05/24,1430,0,-9,1421,876997,17655,10307,904959,9.20%,9.49%,
106/05/23,466,-428,146,184,875567,17655,10316,903538,9.19%,9.48%,
106/05/22,1878,-420,99,1557,875101,18083,10170,903354,9.18%,9.48%,
106/05/19,-230,0,0,-230,873223,18503,10071,901797,9.16%,9.46%,
106/05/18,-476,-40,1,-515,873453,18503,10071,902027,9.16%,9.46%,
106/05/17,-150,-171,22,-299,874259,18543,10070,902872,9.17%,9.47%,
106/05/16,5584,1078,-20,6642,874403,18714,10048,903165,9.17%,9.47%,
106/05/15,832,324,10,1166,868819,17636,10068,896523,9.12%,9.41%,
106/05/12,1441,216,0,1657,867987,17312,10058,895357,9.11%,9.40%,
106/05/11,320,264,10,594,866638,17096,10058,893792,9.09%,9.38%,
106/05/10,627,-386,-32,209,866318,16832,10048,893198,9.09%,9.37%,
106/05/09,-430,7,-3,-426,865691,17218,10080,892989,9.08%,9.37%,
106/05/08,201,-8,19,212,866121,17211,10083,893415,9.09%,9.38%,
106/05/05,-652,-144,-19,-815,865920,17219,10064,893203,9.09%,9.38%,
106/05/04,693,-49,-7,637,866372,17363,10083,893818,9.09%,9.38%,
106/05/03,-609,0,0,-609,865679,17412,10090,893181,9.08%,9.37%,
106/05/02,748,0,-12,736,866288,17412,10090,893790,9.09%,9.38%,
106/04/28,-832,-233,-2,-1067,865433,17412,10102,892947,9.08%,9.37%,
106/04/27,11,-28,0,-17,866266,17645,10104,894015,9.09%,9.38%,
106/04/26,461,-32,-1092,-663,866265,17673,10104,894042,9.09%,9.38%,
106/04/25,762,-145,-5,612,865804,17705,11196,894705,9.08%,9.38%,
106/04/24,191,-85,0,106,864998,17850,11201,894049,9.08%,9.38%,
106/04/21,139,-31,0,108,864778,17935,11201,893914,9.07%,9.38%,
106/04/20,-525,-826,9,-1342,864639,17966,11201,893806,9.07%,9.38%,
106/04/19,-1293,45,-67,-1315,865181,18792,11192,895165,9.08%,9.39%,
106/04/18,-98,0,22,-76,866474,18747,11259,896480,9.09%,9.40%,
106/04/17,615,-250,18,383,866562,18747,11237,896546,9.09%,9.40%,
106/04/14,-327,23,-36,-340,866107,18997,11219,896323,9.09%,9.41%,
106/04/13,712,-29,-28,655,866434,18974,11255,896663,9.09%,9.41%,
106/04/12,446,-75,-5,366,865722,19003,11283,896008,9.08%,9.40%,
106/04/11,-405,-57,-28,-490,865266,19078,11288,895632,9.08%,9.40%,
106/04/10,1613,79,-4,1688,865654,19135,11316,896105,9.08%,9.40%,
106/04/07,284,25,188,497,864025,19056,11320,894401,9.07%,9.39%,
106/04/06,27,122,23,172,863851,19031,11132,894014,9.06%,9.38%,
106/04/05,906,39,811,1756,863814,18909,11109,893832,9.06%,9.38%,
106/03/31,-62,143,-100,-19,862921,18870,10298,892089,9.05%,9.36%,
106/03/30,678,-19,0,659,863002,20119,10398,893519,9.05%,9.37%,
106/03/29,-438,64,364,-10,862324,20138,10398,892860,9.05%,9.37%,
106/03/28,1471,20,104,1595,862862,20074,10034,892970,9.05%,9.37%,
106/03/27,489,30,5,524,861391,20054,9930,891375,9.04%,9.35%,
106/03/24,445,35,-4,476,860962,20024,9925,890911,9.03%,9.34%,
106/03/23,23,-20,0,3,860517,19989,9929,890435,9.03%,9.34%,
106/03/22,108,60,14,182,860494,20009,9929,890432,9.03%,9.34%,
106/03/21,1701,-32,41,1710,860376,19949,9915,890240,9.03%,9.34%,
106/03/20,-103,-31,0,-134,858674,19981,9874,888529,9.01%,9.32%,
106/03/17,-389,119,2,-268,858777,20012,9874,888663,9.01%,9.32%,
106/03/16,440,-38,166,568,859156,19893,9872,888921,9.01%,9.32%,
106/03/15,-8,-422,0,-430,858686,19931,9706,888323,9.01%,9.32%,
106/03/14,2184,9,-5,2188,858695,20353,9706,888754,9.01%,9.33%,
106/03/13,457,-19,0,438,856478,20344,9711,886533,8.99%,9.31%,
106/03/10,-926,-429,14,-1341,856042,20363,9711,886116,8.98%,9.30%,
106/03/09,-1605,-87,-151,-1843,857028,20792,9697,887517,8.99%,9.31%,
106/03/08,-211,-156,-26,-393,858624,20879,9848,889351,9.01%,9.33%,
106/03/07,-576,150,5,-421,858818,21035,9874,889727,9.01%,9.33%,
106/03/06,248,81,0,329,859351,20885,9869,890105,9.02%,9.34%,
106/03/03,-57,-121,-12,-190,859103,20804,9869,889776,9.01%,9.33%,
106/03/02,-52,-459,20,-491,859160,20925,9881,889966,9.01%,9.33%,
106/03/01,-1075,-32,-37,-1144,859212,21384,9861,890457,9.01%,9.34%,
106/02/24,-343,15,25,-303,860288,21416,9898,891602,9.03%,9.36%,
106/02/23,257,1,104,362,860620,21401,9873,891894,9.03%,9.36%,
106/02/22,1549,-171,53,1431,860353,21400,9769,891522,9.03%,9.36%,
106/02/21,220,14,15,249,858804,21571,9716,890091,9.01%,9.34%,
106/02/20,60,0,-101,-41,858574,21557,9701,889832,9.01%,9.34%,
106/02/18,0,72,0,72,858493,21557,9802,889852,9.01%,9.34%,
106/02/17,-323,-1,56,-268,858493,21485,9802,889780,9.01%,9.34%,
106/02/16,-266,739,169,642,858806,21486,9746,890038,9.01%,9.34%,
106/02/15,436,175,-12,599,859063,20747,9577,889387,9.01%,9.33%,
106/02/14,-786,257,86,-443,858646,20572,9589,888807,9.01%,9.33%,
106/02/13,-329,443,-10,104,859433,20315,9503,889251,9.02%,9.33%,
106/02/10,143,120,-1,262,859761,19872,9513,889146,9.02%,9.33%,
106/02/09,-1523,68,-37,-1492,859618,19752,9514,888884,9.02%,9.33%,
106/02/08,-1184,5,-45,-1224,861142,19684,9551,890377,9.03%,9.34%,
106/02/07,-1918,-10,88,-1840,862326,19679,9596,891601,9.05%,9.36%,
106/02/06,667,-10,24,681,863985,19689,9508,893182,9.06%,9.37%,
106/02/03,-880,-156,-46,-1082,863319,19699,9484,892502,9.06%,9.37%,
106/02/02,-2679,-66,-4,-2749,864199,19855,9530,893584,9.07%,9.38%,
106/01/24,-237,-20,-90,-347,866633,19921,9534,896088,9.09%,9.40%,
106/01/23,-204,-404,155,-453,866846,19941,9624,896411,9.09%,9.40%,
106/01/20,-1446,-290,7,-1729,867038,20345,9469,896852,9.10%,9.41%,
106/01/19,-497,-853,11,-1339,868483,20635,9462,898580,9.11%,9.43%,
106/01/18,-256,-547,-18,-821,868980,21488,9451,899919,9.12%,9.44%,
106/01/17,161,-756,-24,-619,869191,22035,9469,900695,9.12%,9.45%,
106/01/16,-1217,-570,-226,-2013,869029,22791,9492,901312,9.12%,9.46%,
106/01/13,667,-19,-104,544,870246,23361,9718,903325,9.13%,9.48%,
106/01/12,1109,-25,-90,994,869584,23380,9822,902786,9.12%,9.47%,
106/01/11,448,20,5,473,868475,23405,9912,901792,9.11%,9.46%,
106/01/10,1135,-346,-583,206,868027,23385,9907,901319,9.11%,9.46%,
106/01/09,-264,86,-52,-230,866892,23731,10490,901113,9.10%,9.46%,
106/01/06,351,-522,24,-147,867157,23645,10542,901344,9.10%,9.46%,
106/01/05,148,-55,27,120,866805,24167,10518,901490,9.09%,9.45%,
106/01/04,-31,-70,160,59,866658,24222,10491,901371,9.09%,9.45%,
106/01/03,-730,0,339,-391,866688,24292,10331,901311,9.09%,9.45%,
105/12/30,1342,-319,-151,872,865858,24292,9992,900142,9.08%,9.44%,
105/12/29,-266,-292,-284,-842,864374,24611,10143,899128,9.07%,9.43%,
105/12/28,-12,-232,7,-237,864761,24903,10427,900091,9.07%,9.44%,
105/12/27,102,0,116,218,864763,25135,10420,900318,9.07%,9.44%,
105/12/26,247,-204,-116,-73,864706,25135,10304,900145,9.07%,9.44%,
105/12/23,262,-488,-11,-237,864309,25339,10420,900068,9.07%,9.45%,
105/12/22,-197,0,90,-107,864047,25827,10431,900305,9.07%,9.45%,
105/12/21,321,-631,67,-243,864343,25827,10341,900511,9.07%,9.45%,
105/12/20,346,-553,41,-166,864087,26458,10274,900819,9.07%,9.46%,
105/12/19,964,-61,-125,778,863483,27011,10233,900727,9.06%,9.45%,
105/12/16,486,0,-152,334,862519,27072,10358,899949,9.05%,9.44%,
105/12/15,662,-352,88,398,862032,27072,10510,899614,9.04%,9.43%,
105/12/14,491,-54,-65,372,861354,27424,10422,899200,9.04%,9.44%,
105/12/13,1179,0,-55,1124,861781,27478,10487,899746,9.04%,9.44%,
105/12/12,-276,-10,123,-163,860569,27478,10542,898589,9.03%,9.43%,
105/12/09,807,-20,-58,729,860460,27488,10419,898367,9.03%,9.43%,
105/12/08,1246,-50,-216,980,859613,27508,10477,897598,9.02%,9.42%,
105/12/07,-37,-285,78,-244,858326,27558,10693,896577,9.01%,9.41%,
105/12/06,977,-70,101,1008,858311,27843,10615,896769,9.01%,9.41%,
105/12/05,-774,-28,-26,-828,857251,27913,10514,895678,8.99%,9.39%,
105/12/02,360,-139,-23,198,857971,27941,10540,896452,9.00%,9.40%,
105/12/01,-640,-96,-52,-788,857552,28080,10563,896195,9.00%,9.41%,
105/11/30,2126,-181,-362,1583,858143,28176,10615,896934,9.00%,9.41%,
105/11/29,-970,-14,21,-963,855925,28357,10977,895259,8.98%,9.39%,
105/11/28,-157,-38,-10,-205,856895,28371,10956,896222,8.99%,9.40%,
105/11/25,-98,31,4,-63,857052,28409,10966,896427,8.99%,9.40%,
105/11/24,-506,69,3,-434,856977,28378,10962,896317,8.99%,9.40%,
105/11/23,-1014,157,28,-829,857483,28309,10959,896751,9.00%,9.41%,
105/11/22,32,552,109,693,858497,28152,10931,897580,9.01%,9.42%,
105/11/21,-834,-30,-111,-975,858565,27600,10822,896987,9.01%,9.41%,
105/11/18,-394,221,-4,-177,859389,27630,10933,897952,9.02%,9.42%,
105/11/17,-55,139,-195,-111,859783,27409,10937,898129,9.02%,9.42%,
105/11/16,-48,-1,355,306,859988,27270,11132,898390,9.02%,9.42%,
105/11/15,315,23,179,517,860311,27271,10777,898359,9.03%,9.43%,
105/11/14,-96,89,-191,-198,859774,27248,10598,897620,9.02%,9.42%,
105/11/11,-1609,-5,-65,-1679,859861,27159,10789,897809,9.02%,9.42%,
105/11/10,-170,655,435,920,861469,27164,10854,899487,9.04%,9.44%,
105/11/09,-771,522,-534,-783,861629,26509,10419,898557,9.04%,9.43%,
105/11/08,458,585,252,1295,862447,25987,10953,899387,9.05%,9.44%,
105/11/07,565,46,520,1131,862065,25402,10701,898168,9.04%,9.42%,
105/11/04,-208,16,15,-177,861500,25356,10181,897037,9.04%,9.41%,
105/11/03,-1,66,-182,-117,861708,25340,10166,897214,9.04%,9.41%,
105/11/02,86,9,-153,-58,862027,25274,10348,897649,9.04%,9.41%,
105/11/01,-842,-10,-197,-1049,861951,25265,10501,897717,9.04%,9.42%,
105/10/31,-769,284,-105,-590,862767,25275,10698,898740,9.05%,9.43%,
105/10/28,-261,59,106,-96,863497,24991,10803,899291,9.06%,9.44%,
105/10/27,-1290,40,37,-1213,863837,24932,10697,899466,9.06%,9.43%,
105/10/26,-624,224,-39,-439,865160,24892,10660,900712,9.08%,9.45%,
105/10/25,-1097,619,-209,-687,865672,24668,10699,901039,9.08%,9.45%,
105/10/24,-1500,72,307,-1121,867580,24049,10908,902537,9.10%,9.47%,
105/10/21,622,275,-218,679,869080,23977,10601,903658,9.12%,9.48%,
105/10/20,-334,1673,286,1625,866971,23702,10819,901492,9.10%,9.46%,
105/10/19,-400,544,33,177,867152,22029,10533,899714,9.10%,9.44%,
105/10/18,54,346,80,480,867558,21485,10500,899543,9.10%,9.44%,
105/10/17,1552,854,-729,1677,867428,21139,10420,898987,9.10%,9.43%,
105/10/14,1391,370,-9,1752,865831,20285,11149,897265,9.08%,9.41%,
105/10/13,1680,329,-40,1969,864415,19915,11158,895488,9.07%,9.40%,
105/10/12,-1318,0,309,-1009,862735,19586,11198,893519,9.05%,9.37%,
105/10/11,1325,616,-87,1854,864138,19586,10889,894613,9.07%,9.39%,
105/10/07,-934,136,212,-586,862775,18970,10976,892721,9.05%,9.36%,
105/10/06,168,99,206,473,863670,18834,10764,893268,9.06%,9.37%,
105/10/05,-182,60,-78,-200,863475,18735,10558,892768,9.06%,9.37%,
105/10/04,1602,-53,28,1577,863757,18675,10636,893068,9.06%,9.37%,
105/10/03,185,50,106,341,862146,18728,10608,891482,9.05%,9.36%,
105/09/30,-954,-24,50,-928,861961,18678,10502,891141,9.04%,9.35%,
105/09/29,-329,0,20,-309,862203,23158,10452,895813,9.05%,9.40%,
105/09/26,-170,0,-26,-196,862721,23158,10432,896311,9.05%,9.40%,
105/09/23,-484,-45,-59,-588,862877,23158,10458,896493,9.05%,9.40%,
105/09/22,-685,-26,-112,-823,863234,23203,10517,896954,9.06%,9.41%,
105/09/21,667,100,-229,538,863898,23229,10629,897756,9.06%,9.42%,
105/09/20,-800,0,42,-758,863216,23129,10858,897203,9.06%,9.42%,
105/09/19,600,0,14,614,864016,23129,10816,897961,9.07%,9.43%,
105/09/14,-1232,-17,90,-1159,863417,23129,10802,897348,9.06%,9.42%,
105/09/13,-1507,-2,4,-1505,864639,23146,10712,898497,9.07%,9.43%,
105/09/12,-2880,-14,-563,-3457,866110,23148,10708,899966,9.09%,9.45%,
105/09/10,-202,-38,-91,-331,868909,23162,11271,903342,9.12%,9.48%,
105/09/09,-606,4,-130,-732,869111,23200,11362,903673,9.12%,9.48%,
105/09/08,580,-11,-8,561,869717,23196,11492,904405,9.12%,9.48%,
105/09/07,-986,921,295,230,869028,23207,11500,903735,9.12%,9.48%,
105/09/06,-274,0,547,273,869987,22286,11205,903478,9.13%,9.48%,
105/09/05,197,123,28,348,870261,22286,10658,903205,9.13%,9.48%,
105/09/02,-261,-158,17,-402,869993,22163,10630,902786,9.13%,9.47%,
105/09/01,-772,30,-18,-760,870254,22321,10613,903188,9.13%,9.48%,
105/08/31,-279,71,-143,-351,871026,22291,10631,903948,9.14%,9.49%,
105/08/30,-301,7,30,-264,871433,22220,10774,904427,9.14%,9.49%,
105/08/29,-823,-126,20,-929,871717,22213,10744,904674,9.15%,9.50%,
105/08/26,61,-53,-101,-93,872514,22339,10724,905577,9.15%,9.50%,
105/08/25,211,-59,-5,147,872427,22392,10825,905644,9.15%,9.50%,
105/08/24,-635,-396,-63,-1094,872190,22451,10830,905471,9.15%,9.50%,
105/08/23,580,-453,-142,-15,873086,22847,10893,906826,9.16%,9.51%,
105/08/22,122,-20,18,120,872480,23300,11035,906815,9.15%,9.51%,
105/08/19,-94,-42,99,-37,872317,23320,11017,906654,9.15%,9.51%,
105/08/18,-385,-18,-54,-457,872385,23362,10918,906665,9.15%,9.51%,
105/08/17,2728,0,-189,2539,872738,23380,10972,907090,9.16%,9.52%,
105/08/16,297,-139,-72,86,869985,23380,11161,904526,9.13%,9.49%,
105/08/15,-563,364,150,-49,869636,23519,11233,904388,9.12%,9.48%,
105/08/12,2015,253,-22,2246,870182,23155,11083,904420,9.13%,9.49%,
105/08/11,-130,497,-261,106,868156,22902,11105,902163,9.11%,9.47%,
105/08/10,1823,145,-188,1780,868871,22405,11366,902642,9.12%,9.47%,
105/08/09,1534,-5,-292,1237,867024,22260,11554,900838,9.10%,9.45%,
105/08/08,189,-105,34,118,865453,22265,11846,899564,9.08%,9.44%,
105/08/05,-282,-6,65,-223,865187,22370,11812,899369,9.08%,9.44%,
105/08/04,96,4,-171,-71,865423,22376,11747,899546,9.08%,9.44%,
105/08/03,1564,-215,-73,1276,865278,22372,11918,899568,9.08%,9.44%,
105/08/02,395,-90,5,310,863668,22587,11991,898246,9.06%,9.42%,
105/08/01,-56,-5,3,-58,863470,22677,11986,898133,9.06%,9.42%,
105/07/29,-241,-20,173,-88,863675,22682,11983,898340,9.06%,9.42%,
105/07/28,778,-92,29,715,864080,22702,11810,898592,9.07%,9.43%,
105/07/27,1703,-726,99,1076,863252,22794,11781,897827,9.06%,9.42%,
105/07/26,926,-145,-1,780,861505,23520,11682,896707,9.04%,9.41%,
105/07/25,1134,11,-65,1080,859437,23665,11683,894785,9.02%,9.39%,
105/07/22,1032,-99,-15,918,857970,23654,11748,893372,9.00%,9.37%,
105/07/21,2497,-9,41,2529,857198,23753,11763,892714,8.99%,9.36%,
105/07/20,6165,-11,-470,5684,854537,23762,11722,890021,8.97%,9.34%,
105/07/19,4619,-475,374,4518,847945,23773,12192,883910,8.90%,9.28%,
105/07/18,-339,-230,22,-547,843387,24248,11818,879453,8.85%,9.23%,
105/07/15,553,-61,-94,398,843250,24478,11796,879524,8.85%,9.23%,
105/07/14,292,-2,-84,206,842531,24539,11890,878960,8.84%,9.22%,
105/07/13,1525,34,-59,1500,842179,24541,11974,878694,8.84%,9.22%,
105/07/12,3560,259,-286,3533,840650,24507,12033,877190,8.82%,9.20%,
105/07/11,-920,-374,-291,-1585,837090,24248,12319,873657,8.78%,9.16%,
105/07/07,307,-43,-420,-156,838010,24622,12610,875242,8.79%,9.18%,
105/07/06,-1794,60,-39,-1773,837703,24665,13030,875398,8.79%,9.19%,
105/07/05,-1895,-12,-484,-2391,838425,24605,13069,876099,8.80%,9.20%,
105/07/04,327,72,-595,-196,840320,24617,13553,878490,8.82%,9.22%,
105/07/01,-959,0,1655,696,839993,24545,14148,878686,8.81%,9.22%,
105/06/30,-1483,286,525,-672,841272,24545,12493,878310,8.83%,9.22%,
105/06/29,-1314,-281,182,-1413,842735,22733,11968,877436,8.84%,9.20%,
105/06/28,-1746,-446,139,-2053,844049,23014,11786,878849,8.86%,9.23%,
105/06/27,-660,-77,-9,-746,845795,23460,11647,880902,8.87%,9.24%,
105/06/24,-2702,-15,-62,-2779,846455,23537,11656,881648,8.88%,9.25%,
105/06/23,-739,0,47,-692,849157,23552,11718,884427,8.91%,9.28%,
105/06/22,-268,0,141,-127,849845,23552,11671,885068,8.92%,9.29%,
105/06/21,-27,-220,86,-161,850433,23552,11530,885515,8.92%,9.29%,
105/06/20,131,-943,207,-605,849904,23772,11444,885120,8.92%,9.29%,
105/06/17,1630,-4028,53,-2345,849773,24715,11237,885725,8.92%,9.30%,
105/06/16,-3136,-1259,-32,-4427,849094,28743,11184,889021,8.91%,9.33%,
105/06/15,-692,-1103,-2,-1797,852378,30002,11216,893596,8.94%,9.37%,
105/06/14,-1861,0,15,-1846,853200,31105,11218,895523,8.95%,9.39%,
105/06/13,-1348,-192,-52,-1592,854986,31105,11203,897294,8.97%,9.41%,
105/06/08,-3450,0,160,-3290,856431,31297,11255,898983,8.99%,9.44%,
105/06/07,-1310,114,82,-1114,859981,31297,11095,902373,9.02%,9.47%,
105/06/06,21,-34,-38,-51,861481,31183,11013,903677,9.04%,9.48%,
105/06/04,-94,-29,0,-123,861696,31217,11051,903964,9.04%,9.48%,
105/06/03,-1452,0,57,-1395,861887,31246,11051,904184,9.04%,9.48%,
105/06/02,500,317,41,858,863575,31246,10994,905815,9.06%,9.50%,
105/06/01,-489,-189,130,-548,863173,30929,10953,905055,9.06%,9.50%,
105/05/31,-491,-1363,25,-1829,863744,31118,10823,905685,9.06%,9.50%,
105/05/30,414,-25,-25,364,864811,32481,10798,908090,9.07%,9.52%,
105/05/27,171,5,20,196,864364,32506,10823,907693,9.07%,9.52%,
105/05/26,-1229,76,95,-1058,864012,32501,10803,907316,9.07%,9.52%,
105/05/25,-355,62,165,-128,865231,32425,10708,908364,9.08%,9.53%,
105/05/24,-1232,19,49,-1164,865392,32363,10543,908298,9.08%,9.53%,
105/05/23,-769,0,250,-519,866549,32344,10494,909387,9.09%,9.54%,
105/05/20,-2442,236,-15,-2221,867229,32344,10244,909817,9.10%,9.55%,
105/05/19,-1677,-256,-40,-1973,868306,32108,10259,910673,9.11%,9.55%,
105/05/18,-1021,13,6,-1002,869983,32364,10299,912646,9.13%,9.58%,
105/05/17,-100,-300,39,-361,871004,32351,10293,913648,9.14%,9.59%,
105/05/16,-976,0,93,-883,871211,32651,10254,914116,9.14%,9.59%,
105/05/13,-3476,-314,-167,-3957,872259,32651,10161,915071,9.15%,9.60%,
105/05/12,443,150,-394,199,875417,32965,10328,918710,9.18%,9.63%,
105/05/11,-2305,-182,-380,-2867,874644,32815,10722,918181,9.18%,9.64%,
105/05/10,-727,-162,-407,-1296,876841,32997,11102,920940,9.20%,9.66%,
105/05/09,-431,0,-553,-984,877758,33159,11509,922426,9.21%,9.68%,
105/05/06,-1355,187,-124,-1292,878027,33159,12062,923248,9.21%,9.68%,
105/05/05,-1567,0,-294,-1861,879445,32972,12186,924603,9.23%,9.70%,
105/05/04,-1195,-125,-23,-1343,881284,32972,12480,926736,9.25%,9.73%,
105/05/03,-1192,-94,4,-1282,882479,33097,12503,928079,9.26%,9.74%,
105/04/29,-506,-84,34,-556,883369,33191,12499,929059,9.27%,9.75%,
105/04/28,1394,100,-203,1291,883417,33275,12465,929157,9.27%,9.75%,
105/04/27,967,-47,20,940,882022,33175,12668,927865,9.25%,9.73%,
105/04/26,1084,-207,-102,775,881148,33222,12648,927018,9.24%,9.72%,
105/04/25,991,-73,-211,707,880064,33429,12750,926243,9.23%,9.71%,
105/04/22,1569,-97,-190,1282,879063,33502,12961,925526,9.22%,9.71%,
105/04/21,1657,-70,-59,1528,877494,33599,13151,924244,9.21%,9.70%,
105/04/20,2157,-149,333,2341,875838,33669,13210,922717,9.19%,9.68%,
105/04/19,1964,5,-62,1907,873643,33818,12877,920338,9.17%,9.66%,
105/04/18,-49,180,181,312,871679,33813,12939,918431,9.15%,9.64%,
105/04/15,2530,129,43,2702,871728,33633,12758,918119,9.15%,9.64%,
105/04/14,894,350,-101,1143,869198,33504,12715,915417,9.12%,9.61%,
105/04/13,2313,253,-216,2350,868304,33154,12816,914274,9.11%,9.59%,
105/04/12,2624,-16,-814,1794,865991,32901,13032,911924,9.09%,9.57%,
105/04/11,348,0,19,367,863367,32917,13846,910130,9.06%,9.55%,
105/04/08,307,-82,-84,141,863034,32917,13827,909778,9.05%,9.54%,
105/04/07,586,-737,-120,-271,862544,32999,13911,909454,9.05%,9.54%,
105/04/06,1262,-96,-76,1090,861958,33736,14031,909725,9.04%,9.54%,
105/04/01,1309,56,64,1429,860695,33832,14107,908634,9.03%,9.53%,
105/03/31,1347,-15,50,1382,859135,33776,14043,906954,9.01%,9.51%,
105/03/30,3271,67,-279,3059,857704,34815,13993,906512,9.00%,9.51%,
105/03/29,1629,-1,-415,1213,854294,34748,14272,903314,8.96%,9.47%,
105/03/28,567,-135,207,639,852665,34749,14687,902101,8.95%,9.47%,
105/03/25,317,-17,38,338,851885,34884,14480,901249,8.94%,9.46%,
105/03/24,1459,-513,113,1059,851568,34901,14442,900911,8.93%,9.45%,
105/03/23,248,-90,360,518,849933,35414,14329,899676,8.92%,9.44%,
105/03/22,2926,3,-95,2834,849664,35504,13969,899137,8.91%,9.43%,
105/03/21,302,125,-76,351,846526,35501,14064,896091,8.88%,9.40%,
105/03/18,3733,23,-399,3357,846209,35376,14140,895725,8.88%,9.40%,
105/03/17,2576,-173,151,2554,842252,35353,14539,892144,8.84%,9.36%,
105/03/16,1182,1048,185,2415,839584,35526,14388,889498,8.81%,9.33%,
105/03/15,1864,-645,-39,1180,838490,34478,14203,887171,8.80%,9.31%,
105/03/14,-360,864,-108,396,836552,35123,14242,885917,8.78%,9.30%,
105/03/11,1882,205,130,2217,836911,34259,14350,885520,8.78%,9.29%,
105/03/10,-563,-11,230,-344,834960,34054,14221,883235,8.76%,9.27%,
105/03/09,2704,-10,-61,2633,835512,34065,13991,883568,8.77%,9.27%,
105/03/08,293,984,271,1548,832712,34075,14052,880839,8.74%,9.25%,
105/03/07,404,1067,406,1877,832403,33091,13781,879275,8.73%,9.22%,
105/03/04,1488,526,234,2248,831989,32024,13375,877388,8.73%,9.21%,
105/03/03,-487,120,127,-240,830417,31498,13141,875056,8.71%,9.18%,
105/03/02,-959,4,150,-805,830874,31378,13014,875266,8.72%,9.19%,
105/03/01,-343,0,386,43,831735,31374,12864,875973,8.73%,9.19%,
105/02/26,949,300,97,1346,832004,31374,12478,875856,8.73%,9.19%,
105/02/25,584,0,14,598,830956,31074,12381,874411,8.72%,9.18%,
105/02/24,2037,-101,453,2389,830266,31074,12367,873707,8.71%,9.17%,
105/02/23,1147,-119,65,1093,828238,31175,11914,871327,8.69%,9.14%,
105/02/22,422,60,14,496,827205,31294,11849,870348,8.68%,9.13%,
105/02/19,494,228,89,811,826695,31234,11835,869764,8.67%,9.12%,
105/02/18,3112,100,97,3309,826200,31006,11746,868952,8.67%,9.12%,
105/02/17,594,-244,-21,329,823064,30906,11649,865619,8.64%,9.09%,
105/02/16,365,0,155,520,822471,31150,11670,865291,8.63%,9.08%,
105/02/15,-372,137,30,-205,822036,31150,11515,864701,8.62%,9.07%,
105/02/03,-632,0,120,-512,822408,31013,11485,864906,8.63%,9.08%,
105/02/02,1104,80,278,1462,823111,31013,11365,865489,8.64%,9.08%,
105/02/01,2113,88,-125,2076,821997,30933,11087,864017,8.62%,9.06%,
105/01/30,200,444,-62,582,819828,30845,11212,861885,8.60%,9.04%,
105/01/29,3438,88,362,3888,819628,30401,11274,861303,8.60%,9.04%,
105/01/28,1193,0,0,1193,816235,30313,10912,857460,8.56%,8.99%,
105/01/27,1736,0,10,1746,814832,30313,10912,856057,8.55%,8.98%,
105/01/26,1309,0,40,1349,813303,30313,10902,854518,8.53%,8.96%,
105/01/25,2205,-2,187,2390,811994,30313,10862,853169,8.52%,8.95%,
105/01/22,1122,173,48,1343,809789,30315,10675,850779,8.50%,8.93%,
105/01/21,1118,665,0,1783,808527,30142,10627,849296,8.48%,8.91%,
105/01/20,1185,281,-64,1402,807409,29477,10627,847513,8.47%,8.89%,
105/01/19,228,410,28,666,806036,29196,10691,845923,8.46%,8.88%,
105/01/18,1510,-126,92,1476,805866,28786,10663,845315,8.45%,8.86%,
105/01/15,1054,328,-41,1341,804426,28912,10571,843909,8.44%,8.85%,
105/01/14,3166,-22,-4,3140,803372,28584,10612,842568,8.43%,8.84%,
105/01/13,3926,787,-214,4499,800184,28606,10616,839406,8.40%,8.81%,
105/01/12,-377,516,66,205,796257,27819,10830,834906,8.35%,8.76%,
105/01/11,-871,596,-21,-296,796836,27303,10764,834903,8.36%,8.76%,
105/01/08,-1000,161,17,-822,797666,26707,10785,835158,8.37%,8.76%,
105/01/07,-2821,119,126,-2576,798779,26546,10768,836093,8.38%,8.77%,
105/01/06,259,-27,17,249,801785,26427,10642,838854,8.41%,8.80%,
105/01/05,-566,62,169,-335,801527,26454,10625,838606,8.41%,8.80%,
105/01/04,-678,204,-11,-485,802093,26392,10456,838941,8.42%,8.81%,
104/12/31,488,42,25,555,803161,26188,10467,839816,8.43%,8.81%,
104/12/30,-293,-18,13,-298,802931,25954,10442,839327,8.42%,8.80%,
104/12/29,1266,-14,22,1274,803724,25972,10429,840125,8.43%,8.81%,
104/12/28,575,254,22,851,802685,25986,10407,839078,8.42%,8.80%,
104/12/25,-245,1189,6,950,801002,25732,10385,837119,8.40%,8.78%,
104/12/24,1572,1070,0,2642,801217,24543,10379,836139,8.41%,8.78%,
104/12/23,361,65,0,426,799762,23473,10379,833614,8.39%,8.75%,
104/12/22,466,0,0,466,799391,23408,10379,833178,8.39%,8.74%,
104/12/21,118,0,-18,100,799151,23408,10379,832938,8.38%,8.73%,
104/12/18,578,-113,-11,454,799017,23408,10397,832822,8.38%,8.73%,
104/12/17,1015,54,0,1069,798417,23521,10408,832346,8.38%,8.74%,
104/12/16,2548,158,-40,2666,797842,23467,10408,831717,8.37%,8.73%,
104/12/15,821,114,6,941,795294,23309,10448,829051,8.34%,8.69%,
104/12/14,922,36,0,958,794463,23195,10442,828100,8.33%,8.68%,
104/12/11,139,0,5,144,793339,23159,10442,826940,8.32%,8.67%,
104/12/10,331,0,0,331,793283,23159,10437,826879,8.32%,8.67%,
104/12/09,382,125,7,514,792953,23159,10437,826549,8.32%,8.67%,
104/12/08,1459,-883,-32,544,792836,23034,10430,826300,8.32%,8.67%,
104/12/07,1543,0,-1,1542,791377,23917,10462,825756,8.30%,8.66%,
104/12/04,-1490,81,6,-1403,790048,23917,10463,824428,8.29%,8.65%,
104/12/03,1023,-590,-1,432,791538,23836,10457,825831,8.30%,8.66%,
104/12/02,1797,0,19,1816,790589,24426,10458,825473,8.29%,8.66%,
104/12/01,-1570,0,79,-1491,789293,24426,10439,824158,8.28%,8.65%,
104/11/30,915,60,44,1019,790863,24426,10360,825649,8.30%,8.67%,
104/11/27,767,-113,-40,614,789349,24366,10316,824031,8.28%,8.64%,
104/11/26,771,1100,-94,1777,788582,24479,10356,823417,8.27%,8.64%,
104/11/25,901,849,0,1750,788125,23379,10450,821954,8.27%,8.63%,
104/11/24,970,0,-62,908,787059,22530,10450,820039,8.26%,8.61%,
104/11/23,539,120,-434,225,785775,22530,10512,818817,8.24%,8.59%,
104/11/20,594,37,-2,629,785236,22410,10946,818592,8.24%,8.59%,
104/11/19,843,87,27,957,784642,22373,10948,817963,8.23%,8.58%,
104/11/18,-595,296,191,-108,783799,22286,10921,817006,8.22%,8.57%,
104/11/17,677,0,40,717,784394,21990,10730,817114,8.23%,8.57%,
104/11/16,-125,0,-27,-152,783856,21990,10690,816536,8.22%,8.56%,
104/11/13,-406,50,-7,-363,783981,21990,10717,816688,8.22%,8.56%,
104/11/12,-674,153,346,-175,784480,21940,10724,817144,8.23%,8.57%,
104/11/11,-2597,92,65,-2440,784811,21787,10378,816976,8.23%,8.57%,
104/11/10,-1227,-35,2,-1260,787444,21695,10313,819452,8.26%,8.60%,
104/11/09,-689,12,0,-677,788404,21730,10311,820445,8.27%,8.61%,
104/11/06,-638,-83,-74,-795,789093,21718,10311,821122,8.28%,8.62%,
104/11/05,-297,23,67,-207,789732,21801,10385,821918,8.29%,8.63%,
104/11/04,2387,106,147,2640,790029,21778,10318,822125,8.29%,8.63%,
104/11/03,1282,-491,152,943,787632,21672,10171,819475,8.26%,8.59%,
104/11/02,254,140,28,422,786432,22163,10019,818614,8.25%,8.59%,
104/10/30,736,-96,34,674,786164,22023,9991,818178,8.25%,8.59%,
104/10/29,296,-500,98,-106,785537,22119,9957,817613,8.24%,8.58%,
104/10/28,102,0,2,104,785240,22619,9859,817718,8.24%,8.58%,
104/10/27,825,65,5,895,785453,22619,9857,817929,8.24%,8.58%,
104/10/26,640,0,-83,557,784580,22554,9852,816986,8.23%,8.57%,
104/10/23,2447,-29,0,2418,783900,22554,9935,816389,8.22%,8.56%,
104/10/22,797,0,2,799,781276,22583,9935,813794,8.20%,8.54%,
104/10/21,717,0,8,725,780461,22583,9933,812977,8.19%,8.53%,
104/10/20,914,70,0,984,779370,22583,9925,811878,8.18%,8.52%,
104/10/19,1720,-110,30,1640,778342,22513,9925,810780,8.17%,8.51%,
104/10/16,1018,-248,-24,746,776390,22623,9895,808908,8.15%,8.49%,
104/10/15,2162,0,-91,2071,775372,22871,9919,808162,8.13%,8.47%,
104/10/14,1985,0,-27,1958,773210,22871,10010,806091,8.11%,8.46%,
104/10/13,1515,0,-199,1316,771225,22871,10037,804133,8.09%,8.44%,
104/10/12,3536,0,-55,3481,769710,22871,10236,802817,8.08%,8.43%,
104/10/08,782,976,-77,1681,766174,22871,10291,799336,8.04%,8.39%,
104/10/07,1655,40,-105,1590,765392,21895,10368,797655,8.03%,8.37%,
104/10/06,954,-12,39,981,763688,21855,10473,796016,8.01%,8.35%,
104/10/05,688,0,88,776,762697,21867,10434,794998,8.00%,8.34%,
104/10/02,233,77,98,408,762009,21867,10346,794222,7.99%,8.33%,
104/10/01,1210,56,-134,1132,761901,21790,10248,793939,7.99%,8.33%,
104/09/30,1406,2,-302,1106,760882,21734,10382,792998,7.98%,8.32%,
104/09/25,505,0,20,525,759473,30616,10684,800773,7.97%,8.40%,
104/09/24,187,0,35,222,758746,30616,10664,800026,7.96%,8.39%,
104/09/23,-20,0,2,-18,758551,30616,10629,799796,7.96%,8.39%,
104/09/22,1529,10,0,1539,758188,30616,10627,799431,7.95%,8.38%,
104/09/21,1867,105,45,2017,756658,30606,10627,797891,7.94%,8.37%,
104/09/18,-11,-139,22,-128,754791,30501,10582,795874,7.92%,8.35%,
104/09/17,3678,273,-61,3890,754835,30640,10560,796035,7.92%,8.35%,
104/09/16,1124,-19,1,1106,751193,30367,10621,792181,7.88%,8.31%,
104/09/15,735,175,12,922,750564,30386,10620,791570,7.87%,8.30%,
104/09/14,1289,2,-102,1189,749757,30211,10608,790576,7.87%,8.30%,
104/09/11,507,4,1,512,748497,30209,10710,789416,7.85%,8.28%,
104/09/10,1476,0,7,1483,748018,30205,10709,788932,7.85%,8.28%,
104/09/09,1785,104,118,2007,746769,30205,10702,787676,7.83%,8.26%,
104/09/08,51,4,32,87,744993,30101,10584,785678,7.82%,8.25%,
104/09/07,44,153,1,198,744942,30097,10552,785591,7.82%,8.25%,
104/09/04,694,-5,-63,626,744728,29944,10551,785223,7.81%,8.24%,
104/09/03,-275,149,-28,-154,743366,29949,10614,783929,7.80%,8.23%,
104/09/02,-943,206,-28,-765,743898,29800,10642,784340,7.80%,8.22%,
104/09/01,140,165,-224,81,744830,29594,10670,785094,7.81%,8.23%,
104/08/31,-36,-62,-181,-279,744505,29429,10894,784828,7.81%,8.23%,
104/08/28,-178,504,-140,186,744174,29491,11075,784740,7.81%,8.24%,
104/08/27,-3193,1,-194,-3386,744468,28987,11215,784670,7.81%,8.23%,
104/08/26,-128,87,-68,-109,749086,28986,11409,789481,7.86%,8.28%,
104/08/25,-499,8,-10,-501,749245,28899,11477,789621,7.86%,8.28%,
104/08/24,-4045,-151,-20,-4216,749479,28891,11487,789857,7.86%,8.28%,
104/08/21,-1760,-30,-68,-1858,752108,29042,11507,792657,7.89%,8.32%,
104/08/20,-1338,-89,-60,-1487,753783,29072,11575,794430,7.91%,8.34%,
104/08/19,-1563,-11,-45,-1619,754803,29161,11635,795599,7.92%,8.35%,
104/08/18,-143,0,-311,-454,756365,29172,11680,797217,7.94%,8.37%,
104/08/17,-42,1,4,-37,756508,29172,11991,797671,7.94%,8.37%,
104/08/14,7,36,-26,17,755697,29171,11987,796855,7.93%,8.36%,
104/08/13,914,3,16,933,754021,29135,12013,795169,7.91%,8.34%,
104/08/12,1051,70,379,1500,753347,29132,11997,794476,7.90%,8.33%,
104/08/11,-1791,1,-625,-2415,752487,29062,11618,793167,7.89%,8.32%,
104/08/10,-727,-1,47,-681,754073,29061,12243,795377,7.91%,8.34%,
104/08/07,59,33,-43,49,754334,29062,12196,795592,7.91%,8.34%,
104/08/06,-544,23,2,-519,754265,29029,12239,795533,7.91%,8.34%,
104/08/05,199,21,291,511,755039,29006,12237,796282,7.92%,8.35%,
104/08/04,703,-190,672,1185,754861,28985,11946,795792,7.92%,8.35%,
104/08/03,-591,-2,-291,-884,754060,29175,11274,794509,7.91%,8.33%,
104/07/31,175,2,-267,-90,753857,29177,11565,794599,7.91%,8.34%,
104/07/30,45,-35,-2,8,753671,29175,11832,794678,7.91%,8.34%,
104/07/29,-33,12,12,-9,753314,29210,11834,794358,7.90%,8.33%,
104/07/28,183,36,457,676,752575,29198,11822,793595,7.90%,8.33%,
104/07/27,703,0,286,989,752128,29162,11365,792655,7.89%,8.32%,
104/07/24,1220,39,0,1259,751425,29162,11079,791666,7.88%,8.30%,
104/07/23,783,-22,11,772,750013,29123,11079,790215,7.87%,8.29%,
104/07/22,1303,-94,128,1337,749139,29145,11068,789352,7.86%,8.28%,
104/07/21,844,-105,-50,689,747836,29239,10940,788015,7.85%,8.27%,
104/07/20,123,0,26,149,746992,29344,10990,787326,7.84%,8.26%,
104/07/17,1677,-7,20,1690,746859,29344,10964,787167,7.84%,8.26%,
104/07/16,578,-491,31,118,745375,29351,10944,785670,7.82%,8.24%,
104/07/15,511,-362,53,202,744826,29842,10913,785581,7.81%,8.24%,
104/07/14,1086,-51,-227,808,744142,30204,10860,785206,7.81%,8.24%,
104/07/13,246,-600,-92,-446,742994,30255,11087,784336,7.79%,8.22%,
104/07/09,898,-32,89,955,742445,30855,11179,784479,7.79%,8.23%,
104/07/08,-519,-137,339,-317,741353,30887,11090,783330,7.78%,8.22%,
104/07/07,900,-370,113,643,741822,31024,10751,783597,7.78%,8.22%,
104/07/06,-91,-400,42,-449,740891,31394,10638,782923,7.77%,8.21%,
104/07/03,-262,-420,46,-636,740982,31794,10596,783372,7.77%,8.21%,
104/07/02,271,0,-44,227,741255,32214,10550,784019,7.78%,8.23%,
104/07/01,-139,-3,348,206,740984,32214,10594,783792,7.77%,8.22%,
104/06/30,1282,0,-265,1017,741319,32217,10246,783782,7.78%,8.23%,
104/06/29,-906,-13,-167,-1086,740038,21406,10511,771955,7.76%,8.10%,
104/06/26,555,-54,49,550,741651,21419,10678,773748,7.78%,8.12%,
104/06/25,2407,48,151,2606,743206,21473,10629,775308,7.80%,8.14%,
104/06/24,326,-15,86,397,742657,21425,10478,774560,7.79%,8.12%,
104/06/23,-329,19,69,-241,744848,21440,10392,776680,7.81%,8.14%,
104/06/22,1453,7,61,1521,746665,21421,10323,778409,7.83%,8.16%,
104/06/18,-472,-104,53,-523,745676,21414,10262,777352,7.82%,8.15%,
104/06/17,-3968,6,76,-3886,746193,21518,10209,777920,7.83%,8.16%,
104/06/16,957,0,75,1032,750114,21512,10133,781759,7.87%,8.20%,
104/06/15,-833,0,24,-809,749167,21512,10058,780737,7.86%,8.19%,
104/06/12,-964,18,13,-933,751007,21512,10034,782553,7.88%,8.21%,
104/06/11,-920,18,-13,-915,752473,21494,10021,783988,7.89%,8.22%,
104/06/10,-934,0,154,-780,753478,21476,10034,784988,7.90%,8.23%,
104/06/09,276,0,70,346,754472,21476,9880,785828,7.92%,8.25%,
104/06/08,-2,-100,156,54,754345,21476,9810,785631,7.91%,8.24%,
104/06/05,-2971,485,-406,-2892,754449,21576,9654,785679,7.91%,8.24%,
104/06/04,-777,2,-14,-789,757420,21091,10060,788571,7.95%,8.28%,
104/06/03,-1575,14,-60,-1621,757799,21089,10074,788962,7.95%,8.28%,
104/06/02,-48,270,32,254,759364,21075,10134,790573,7.97%,8.30%,
104/06/01,-82,0,62,-20,759402,20805,10102,790309,7.97%,8.29%,
104/05/29,-289,-88,17,-360,759470,20805,10040,790315,7.97%,8.29%,
104/05/28,-224,-136,-41,-401,759782,20893,10023,790698,7.97%,8.29%,
104/05/27,-1172,2,-135,-1305,760012,21029,10064,791105,7.97%,8.30%,
104/05/26,-289,191,0,-98,761337,21027,10199,792563,7.99%,8.32%,
104/05/25,-1595,80,-50,-1565,761610,20836,10199,792645,7.99%,8.32%,
104/05/22,-357,-99,-53,-509,763191,20756,10249,794196,8.01%,8.34%,
104/05/21,-1941,1165,-377,-1153,763529,20855,10302,794686,8.01%,8.34%,
104/05/20,-1437,-267,-321,-2025,765434,19690,10679,795803,8.03%,8.35%,
104/05/19,282,49,-51,280,766692,19957,11000,797649,8.04%,8.36%,
104/05/18,647,-120,-77,450,766366,19908,11051,797325,8.04%,8.36%,
104/05/15,-777,-96,-450,-1323,765813,20028,11128,796969,8.03%,8.36%,
104/05/14,-537,-34,-655,-1226,766635,20124,11578,798337,8.04%,8.37%,
104/05/13,51,34,-5,80,767172,20158,12233,799563,8.05%,8.39%,
104/05/12,2102,84,11,2197,767114,20124,12238,799476,8.05%,8.39%,
104/05/11,1827,-39,-313,1475,765026,20040,12227,797293,8.03%,8.37%,
104/05/08,427,31,118,576,763199,20079,12540,795818,8.01%,8.35%,
104/05/07,1385,78,-496,967,762762,20048,12422,795232,8.00%,8.34%,
104/05/06,1819,8,60,1887,761377,19970,12918,794265,7.99%,8.34%,
104/05/05,1522,35,140,1697,759588,19962,12858,792408,7.97%,8.31%,
104/05/04,615,0,113,728,758128,19927,12718,790773,7.95%,8.29%,
104/04/30,1667,21,-128,1560,757513,19927,12605,790045,7.95%,8.29%,
104/04/29,3129,46,684,3859,755811,19906,12733,788450,7.93%,8.27%,
104/04/28,2299,-2,86,2383,752692,19860,12049,784601,7.90%,8.23%,
104/04/27,3144,46,-384,2806,750393,19862,11963,782218,7.87%,8.20%,
104/04/24,4060,188,13,4261,747240,19816,12347,779403,7.84%,8.18%,
104/04/23,2647,309,383,3339,743180,19628,12334,775142,7.80%,8.14%,
104/04/22,3621,474,-123,3972,740533,19319,11951,771803,7.77%,8.10%,
104/04/21,1388,86,119,1593,736912,18845,12074,767831,7.73%,8.05%,
104/04/20,891,171,74,1136,735619,18759,11955,766333,7.72%,8.04%,
104/04/17,703,36,-12,727,734728,18588,11881,765197,7.71%,8.03%,
104/04/16,1204,72,49,1325,734023,18552,11893,764468,7.70%,8.02%,
104/04/15,-1850,-1,-32,-1883,732756,18480,11844,763080,7.69%,8.01%,
104/04/14,-1104,-1,-10,-1115,734606,18481,11876,764963,7.71%,8.03%,
104/04/13,294,550,288,1132,735714,18482,11886,766082,7.72%,8.04%,
104/04/10,1316,100,76,1492,735484,17932,11598,765014,7.72%,8.03%,
104/04/09,-238,0,429,191,734124,17832,11522,763478,7.70%,8.01%,
104/04/08,1338,50,641,2029,734362,17832,11093,763287,7.70%,8.00%,
104/04/07,2721,111,693,3525,732932,17782,10452,761166,7.69%,7.99%,
104/04/02,734,0,-8,726,730245,17671,9759,757675,7.66%,7.95%,
104/04/01,-282,0,-61,-343,729510,17671,9767,756948,7.65%,7.94%,
104/03/31,141,-250,-3,-112,730408,17671,9828,757907,7.66%,7.95%,
104/03/30,1393,0,57,1450,730252,18968,9831,759051,7.66%,7.96%,
104/03/27,1887,-102,-162,1623,728859,18968,9774,757601,7.65%,7.95%,
104/03/26,1380,0,302,1682,726985,19070,9936,755991,7.63%,7.93%,
104/03/25,35,-3,106,138,725592,19070,9634,754296,7.61%,7.91%,
104/03/24,166,-8,-55,103,725557,19073,9528,754158,7.61%,7.91%,
104/03/23,-607,-3,-33,-643,725349,19081,9583,754013,7.61%,7.91%,
104/03/20,-275,-17,-3,-295,725842,19084,9616,754542,7.61%,7.91%,
104/03/19,1614,-4,-14,1596,725798,19101,9619,754518,7.61%,7.91%,
104/03/18,1091,0,-16,1075,724139,19105,9633,752877,7.60%,7.90%,
104/03/17,231,0,-13,218,722861,19105,9649,751615,7.58%,7.88%,
104/03/16,-239,7,257,25,722522,19105,9662,751289,7.58%,7.88%,
104/03/13,-361,0,-50,-411,722725,19098,9405,751228,7.58%,7.88%,
104/03/12,303,-2,-12,289,723026,19098,9455,751579,7.59%,7.89%,
104/03/11,-1084,-2,-22,-1108,722694,19100,9467,751261,7.58%,7.88%,
104/03/10,716,-97,-87,532,723781,19102,9489,752372,7.59%,7.89%,
104/03/09,-380,433,9,62,723332,19199,9576,752107,7.59%,7.89%,
104/03/06,165,20,17,202,723778,18766,9567,752111,7.59%,7.89%,
104/03/05,114,-9,-93,12,723415,18746,9550,751711,7.59%,7.89%,
104/03/04,1055,-34,31,1052,723291,18755,9643,751689,7.59%,7.89%,
104/03/03,72,-3,9,78,722188,18789,9612,750589,7.58%,7.88%,
104/03/02,-286,196,117,27,722129,18792,9604,750525,7.58%,7.88%,
104/02/26,-485,-47,7,-525,722415,18596,9487,750498,7.58%,7.87%,
104/02/25,216,-18,-36,162,722931,18643,9480,751054,7.58%,7.88%,
104/02/24,1091,0,-24,1067,722564,18661,9516,750741,7.58%,7.88%,
104/02/13,77,468,-169,376,721201,18661,9540,749402,7.57%,7.87%,
104/02/12,246,1059,-46,1259,721953,18193,9709,749855,7.57%,7.86%,
104/02/11,1151,50,-28,1173,721669,17134,9755,748558,7.57%,7.85%,
104/02/10,758,0,257,1015,720506,17084,9783,747373,7.56%,7.84%,
104/02/09,-593,100,20,-473,719735,17084,9526,746345,7.55%,7.83%,
104/02/06,89,-2,-21,66,720610,16984,9506,747100,7.56%,7.84%,
104/02/05,471,0,-21,450,720561,16986,9527,747074,7.56%,7.84%,
104/02/04,1831,-1,31,1861,720228,16986,9548,746762,7.56%,7.84%,
104/02/03,1414,0,0,1414,718392,16987,9517,744896,7.54%,7.82%,
104/02/02,894,100,14,1008,717036,16987,9517,743540,7.52%,7.80%,
104/01/30,-86,-21,-2,-109,715949,16887,9503,742339,7.51%,7.79%,
104/01/29,-1058,0,62,-996,716013,16908,9505,742426,7.51%,7.79%,
104/01/28,365,0,0,365,717022,16908,9443,743373,7.52%,7.80%,
104/01/27,78,0,0,78,716555,16908,9443,742906,7.52%,7.80%,
104/01/26,-1366,0,0,-1366,716402,16908,9443,742753,7.52%,7.80%,
104/01/23,41,0,-50,-9,717321,16908,9443,743672,7.53%,7.81%,
104/01/22,-582,-19,42,-559,717136,16908,9493,743537,7.52%,7.80%,
104/01/21,354,0,-77,277,717645,16927,9451,744023,7.53%,7.81%,
104/01/20,-124,0,-165,-289,717482,16927,9528,743937,7.53%,7.81%,
104/01/19,-327,317,-101,-111,717266,16927,9693,743886,7.52%,7.80%,
104/01/16,-1937,0,-94,-2031,717583,16610,9794,743987,7.53%,7.81%,
104/01/15,-657,0,98,-559,719519,16610,9888,746017,7.55%,7.83%,
104/01/14,-1362,0,-38,-1400,720197,16610,9790,746597,7.56%,7.84%,
104/01/13,567,-1,277,843,721475,16610,9828,747913,7.57%,7.85%,
104/01/12,-387,0,-161,-548,720908,16611,9551,747070,7.56%,7.83%,
104/01/09,-282,0,48,-234,721248,16611,9712,747571,7.57%,7.85%,
104/01/08,161,0,32,193,721605,16611,9664,747880,7.57%,7.85%,
104/01/07,-1719,-2,-25,-1746,721581,16611,9632,747824,7.57%,7.85%,
104/01/06,-1371,0,-171,-1542,723250,16613,9657,749520,7.59%,7.87%,
104/01/05,-1004,0,-190,-1194,724027,16613,9828,750468,7.60%,7.88%,
