日期,外資買賣超,投信買賣超,自營商買賣超,單日合計買賣超,外資估計持股,投信估計持股,自營商估計持股,單日合計估計持股,外資持股比重,三大法人持股比重,
107/03/31,0,100,-24,76,384128,5930,8891,398949,63.12%,65.56%,
107/03/30,189,-1,-272,-84,384128,5830,8915,398873,63.12%,65.54%,
107/03/29,-192,-80,-41,-313,383939,5831,9187,398957,63.09%,65.56%,
107/03/28,-1053,0,-167,-1220,384131,5911,9228,399270,63.12%,65.61%,
107/03/27,-59,-70,-71,-200,385443,5911,9395,400749,63.34%,65.86%,
107/03/26,104,-29,-64,11,385517,5981,9466,400964,63.35%,65.89%,
107/03/23,-84,-5,-126,-215,385412,6010,9530,400952,63.33%,65.88%,
107/03/22,3714,-152,-192,3370,385450,6015,9656,401121,63.34%,65.92%,
107/03/21,-271,-11,-275,-557,381701,6167,9848,397716,62.72%,65.35%,
107/03/20,255,-15,-9,231,381971,6178,10123,398272,62.77%,65.45%,
107/03/19,-147,101,-104,-150,381716,6193,10132,398041,62.72%,65.40%,
107/03/16,2281,-516,-24,1741,381853,6092,10236,398181,62.75%,65.43%,
107/03/15,247,284,-70,461,379630,6609,10260,396499,62.38%,65.15%,
107/03/14,2210,32,-13,2229,379393,6325,10330,396048,62.34%,65.08%,
107/03/13,585,-11,202,776,377173,6293,10343,393809,61.98%,64.71%,
107/03/12,1000,-54,6,952,376620,6304,10141,393065,61.89%,64.59%,
107/03/09,362,15,-34,343,376104,6358,10135,392597,61.80%,64.51%,
107/03/08,334,-161,519,692,375768,6343,10169,392280,61.75%,64.46%,
107/03/07,1036,249,88,1373,375461,6504,9650,391615,61.70%,64.35%,
107/03/06,476,88,27,591,374455,6255,9562,390272,61.53%,64.13%,
107/03/05,320,-53,88,355,373946,6167,9535,389648,61.45%,64.03%,
107/03/02,-561,-45,91,-515,373802,6220,9447,389469,61.42%,63.99%,
107/03/01,66,-5,-5,56,374292,6265,9356,389913,61.50%,64.07%,
107/02/27,461,-8,-89,364,374196,6270,9361,389827,61.49%,64.06%,
107/02/26,130,-1,-36,93,373627,6278,9450,389355,61.40%,63.98%,
107/02/23,428,-61,-12,355,373539,6279,9486,389304,61.38%,63.97%,
107/02/22,-861,-2,-84,-947,372956,6340,9498,388794,61.28%,63.88%,
107/02/21,270,38,-93,215,373722,6342,9582,389646,61.41%,64.03%,
107/02/12,-577,6,-42,-613,373435,6304,9675,389414,61.36%,63.99%,
107/02/09,165,191,-193,163,374050,6298,9717,390065,61.46%,64.09%,
107/02/08,302,7,-256,53,374154,6107,9910,390171,61.48%,64.11%,
107/02/07,-2850,496,-40,-2394,373636,6100,10166,389902,61.40%,64.07%,
107/02/06,-993,163,-198,-1028,375682,5604,10206,391492,61.73%,64.33%,
107/02/05,-1428,42,-288,-1674,376614,5441,10404,392459,61.89%,64.49%,
107/02/02,2188,-154,215,2249,377922,5399,10692,394013,62.10%,64.74%,
107/02/01,1704,-10,-18,1676,375734,5553,10477,391764,61.74%,64.37%,
107/01/31,2270,-241,354,2383,374030,5563,10495,390088,61.46%,64.10%,
107/01/30,272,0,-275,-3,371787,5804,10141,387732,61.09%,63.71%,
107/01/29,987,-210,-181,596,371537,5804,10416,387757,61.05%,63.72%,
107/01/26,729,-404,258,583,370550,6014,10597,387161,60.89%,63.62%,
107/01/25,989,-540,-85,364,369819,6418,10339,386576,60.77%,63.52%,
107/01/24,420,-512,-145,-237,368830,6958,10424,386212,60.61%,63.47%,
107/01/23,-330,-80,17,-393,368433,7470,10569,386472,60.54%,63.50%,
107/01/22,-600,11,-71,-660,368753,7550,10552,386855,60.59%,63.56%,
107/01/19,-603,-135,-167,-905,369353,7539,10623,387515,60.69%,63.67%,
107/01/18,-32,579,225,772,369870,7674,10790,388334,60.78%,63.81%,
107/01/17,-289,63,-106,-332,369875,7095,10565,387535,60.78%,63.68%,
107/01/16,566,1579,554,2699,370033,7032,10671,387736,60.80%,63.71%,
107/01/15,-58,1087,736,1765,369465,5453,10117,385035,60.71%,63.27%,
107/01/12,125,15,178,318,369523,4366,9381,383270,60.72%,62.98%,
107/01/11,51,0,8,59,369398,4351,9203,382952,60.70%,62.93%,
107/01/10,71,42,-24,89,369347,4351,9195,382893,60.69%,62.92%,
107/01/09,-3,0,125,122,369277,4309,9219,382805,60.68%,62.90%,
107/01/08,-15,607,-132,460,369280,4309,9094,382683,60.68%,62.88%,
107/01/05,929,64,146,1139,369249,3702,9226,382177,60.68%,62.80%,
107/01/04,172,25,82,279,368320,3638,9080,381038,60.52%,62.61%,
107/01/03,-320,26,26,-268,368148,3613,8998,380759,60.49%,62.56%,
107/01/02,98,0,8,106,368468,3587,8972,381027,60.55%,62.61%,
106/12/29,-106,-3,-21,-130,368420,3587,8964,380971,60.54%,62.60%,
106/12/28,182,8,8,198,368526,3729,8985,381240,60.56%,62.65%,
106/12/27,-52,9,1,-42,368344,3721,8977,381042,60.53%,62.62%,
106/12/26,-26,-87,3,-110,368396,3712,8976,381084,60.54%,62.63%,
106/12/25,18,0,1,19,368422,3800,8973,381195,60.54%,62.64%,
106/12/22,185,305,-14,476,368404,3800,8972,381176,60.54%,62.64%,
106/12/21,-155,0,-37,-192,368169,3495,8986,380650,60.50%,62.55%,
106/12/20,-107,-4,-52,-163,368324,3495,9023,380842,60.52%,62.58%,
106/12/19,-119,494,-7,368,368431,3499,9075,381005,60.54%,62.61%,
106/12/18,-58,-2,5,-55,368550,3005,9082,380637,60.56%,62.55%,
106/12/15,-519,67,-69,-521,368608,3007,9077,380692,60.57%,62.56%,
106/12/14,731,-25,4,710,369127,2940,9146,381213,60.66%,62.65%,
106/12/13,-125,16,36,-73,368396,2965,9142,380503,60.54%,62.53%,
106/12/12,-83,101,-9,9,368521,2949,9106,380576,60.56%,62.54%,
106/12/11,487,-6,-58,423,368605,2848,9115,380568,60.57%,62.54%,
106/12/08,135,0,14,149,368118,2854,9173,380145,60.49%,62.47%,
106/12/07,193,0,-110,83,367983,2854,9159,379996,60.47%,62.44%,
106/12/06,-279,-60,38,-301,367789,2854,9269,379912,60.44%,62.43%,
106/12/05,132,156,-31,257,368069,2914,9231,380214,60.48%,62.48%,
106/12/04,-634,0,-42,-676,367937,2758,9262,379957,60.46%,62.44%,
106/12/01,144,-2,22,164,368571,2758,9304,380633,60.56%,62.54%,
106/11/30,-480,-248,128,-600,368476,2760,9282,380518,60.55%,62.53%,
106/11/29,30,-3,-25,2,368956,3008,9154,381118,60.63%,62.63%,
106/11/28,-5,-1,13,7,368926,3011,9179,381116,60.62%,62.62%,
106/11/27,214,-116,-25,73,368914,3012,9166,381092,60.62%,62.62%,
106/11/24,-347,0,-13,-360,368700,3128,9191,381019,60.59%,62.61%,
106/11/23,552,0,138,690,369047,3128,9204,381379,60.64%,62.67%,
106/11/22,941,-132,-52,757,368494,3128,9066,380688,60.55%,62.55%,
106/11/21,213,-17,40,236,367553,3260,9118,379931,60.40%,62.43%,
106/11/20,119,-48,29,100,367340,3277,9078,379695,60.36%,62.39%,
106/11/17,-316,-3,1,-318,367221,3325,9049,379595,60.34%,62.37%,
106/11/16,310,0,10,320,367538,3328,9048,379914,60.39%,62.42%,
106/11/15,-188,0,-50,-238,367271,3328,9038,379637,60.35%,62.38%,
106/11/14,83,-1,20,102,367449,3328,9088,379865,60.38%,62.42%,
106/11/13,-254,-2,92,-164,367783,3329,9068,380180,60.43%,62.47%,
106/11/10,1504,0,124,1628,368027,3331,8976,380334,60.47%,62.49%,
106/11/09,590,115,-154,551,366670,3331,8852,378853,60.25%,62.25%,
106/11/08,1058,30,-104,984,366118,3216,9006,378340,60.16%,62.17%,
106/11/07,-347,0,21,-326,365072,3186,9110,377368,59.99%,62.01%,
106/11/06,-821,-39,20,-840,365371,3186,9089,377646,60.04%,62.06%,
106/11/03,-47,0,-26,-73,366056,3225,9069,378350,60.15%,62.17%,
106/11/02,-17,-1,-5,-23,366101,3225,9095,378421,60.16%,62.18%,
106/11/01,141,-8,-26,107,366095,3225,9100,378420,60.16%,62.19%,
106/10/31,-554,0,32,-522,365954,3233,9126,378313,60.13%,62.16%,
106/10/30,-509,0,52,-457,366507,3233,9094,378834,60.23%,62.26%,
106/10/27,-88,-14,-37,-139,367016,3233,9042,379291,60.31%,62.33%,
106/10/26,-259,0,-16,-275,367105,3247,9079,379431,60.32%,62.35%,
106/10/25,-282,65,38,-179,367364,3247,9095,379706,60.37%,62.40%,
106/10/24,167,0,-30,137,367229,3182,9057,379468,60.34%,62.35%,
106/10/23,8,0,-21,-13,367093,3182,9087,379362,60.32%,62.34%,
106/10/20,545,0,6,551,367075,3182,9108,379365,60.32%,62.34%,
106/10/19,-9,-3,-14,-26,366530,3182,9102,378814,60.23%,62.25%,
106/10/18,-293,-6,-62,-361,366537,3185,9116,378838,60.23%,62.25%,
106/10/17,-688,15,8,-665,366830,3191,9178,379199,60.28%,62.31%,
106/10/16,57,-1,-1,55,367518,3176,9170,379864,60.39%,62.42%,
106/10/13,65,0,13,78,367456,3177,9171,379804,60.38%,62.41%,
106/10/12,-175,19,3,-153,367381,3177,9158,379716,60.37%,62.40%,
106/10/11,-124,-1,7,-118,367551,3158,9155,379864,60.40%,62.42%,
106/10/06,-391,0,32,-359,367712,3159,9148,380019,60.42%,62.44%,
106/10/05,-137,25,-15,-127,368103,3159,9116,380378,60.49%,62.51%,
106/10/03,-400,21,-19,-398,368246,3134,9131,380511,60.51%,62.53%,
106/10/02,-62,-10,61,-11,368606,3113,9150,380869,60.57%,62.59%,
106/09/30,2,0,6,8,368630,3123,9089,380842,60.57%,62.58%,
106/09/29,112,0,84,196,368628,2569,9083,380280,60.57%,62.48%,
106/09/28,-78,-3,8,-73,368506,2569,8999,380074,60.55%,62.45%,
106/09/27,168,-11,18,175,368716,2572,8991,380279,60.59%,62.49%,
106/09/26,28,0,69,97,368538,2583,8973,380094,60.56%,62.46%,
106/09/25,-979,10,6,-963,368510,2583,8904,379997,60.55%,62.44%,
106/09/22,-196,0,-20,-216,369489,2573,8898,380960,60.72%,62.61%,
106/09/21,289,0,-17,272,369686,2573,8918,381177,60.75%,62.64%,
106/09/20,-407,0,-157,-564,369397,2573,8935,380905,60.70%,62.59%,
106/09/19,363,0,40,403,369804,2573,9092,381469,60.77%,62.69%,
106/09/18,184,0,-6,178,369431,2573,9052,381056,60.71%,62.62%,
106/09/15,-282,-1,148,-135,369238,2573,9058,380869,60.67%,62.58%,
106/09/14,465,0,121,586,369602,2574,8910,381086,60.73%,62.62%,
106/09/13,145,9,-28,126,369126,2574,8789,380489,60.66%,62.53%,
106/09/12,-98,0,-6,-104,368961,2565,8817,380343,60.63%,62.50%,
106/09/11,287,0,-4,283,369049,2565,8823,380437,60.64%,62.51%,
106/09/08,1129,-2,-14,1113,368752,2565,8827,380144,60.59%,62.46%,
106/09/07,146,0,13,159,367607,2567,8841,379015,60.41%,62.28%,
106/09/06,20,0,-43,-23,367446,2567,8828,378841,60.38%,62.25%,
106/09/05,32,0,-29,3,367410,2567,8871,378848,60.37%,62.25%,
106/09/04,418,0,-25,393,367358,2567,8900,378825,60.36%,62.24%,
106/09/01,-255,39,-45,-261,366928,2567,8925,378420,60.29%,62.18%,
106/08/31,1172,100,-29,1243,367183,2528,8970,378681,60.34%,62.23%,
106/08/30,-843,0,223,-620,366011,2428,8999,377438,60.14%,62.02%,
106/08/29,-470,0,0,-470,366855,2428,8776,378059,60.28%,62.12%,
106/08/28,-153,3,95,-55,367325,2428,8776,378529,60.36%,62.20%,
106/08/25,-231,1,4,-226,367478,2425,8681,378584,60.38%,62.21%,
106/08/24,22,-22,-17,-17,367709,2424,8677,378810,60.42%,62.24%,
106/08/23,-142,7,-47,-182,367687,2446,8694,378827,60.42%,62.25%,
106/08/22,76,12,0,88,368347,2439,8741,379527,60.53%,62.37%,
106/08/21,-373,0,1,-372,368262,2427,8741,379430,60.51%,62.35%,
106/08/18,-146,0,-23,-169,368699,2427,8740,379866,60.59%,62.43%,
106/08/17,24,124,-33,115,368823,2427,8763,380013,60.61%,62.45%,
106/08/16,-2,30,-18,10,368740,2303,8796,379839,60.59%,62.41%,
106/08/15,165,0,-11,154,368619,2273,8814,379706,60.57%,62.39%,
106/08/14,27,0,43,70,368332,2273,8825,379430,60.53%,62.35%,
106/08/11,-444,0,19,-425,368354,2273,8782,379409,60.53%,62.35%,
106/08/10,-34,4,-27,-57,368798,2273,8763,379834,60.60%,62.41%,
106/08/09,-474,6,-38,-506,368832,2269,8790,379891,60.61%,62.43%,
106/08/08,-1645,-1,-203,-1849,369337,2263,8828,380428,60.69%,62.51%,
106/08/07,-542,4,17,-521,370986,2264,9031,382281,60.96%,62.82%,
106/08/04,306,-20,-60,226,371528,2260,9014,382802,61.05%,62.90%,
106/08/03,510,-386,27,151,371222,2280,9074,382576,61.00%,62.87%,
106/08/02,-521,-987,30,-1478,370712,2666,9047,382425,60.92%,62.84%,
106/08/01,-437,-3,25,-415,371275,3653,9017,383945,61.01%,63.09%,
106/07/31,-437,-61,85,-413,371921,3656,8992,384569,61.11%,63.19%,
106/07/28,-2860,-304,-338,-3502,372326,3717,8907,384950,61.18%,63.25%,
106/07/27,-2011,-300,40,-2271,375026,4021,9245,388292,61.62%,63.80%,
106/07/26,427,-69,-40,318,376581,4321,9205,390107,61.88%,64.10%,
106/07/25,-251,55,-22,-218,376154,4390,9245,389789,61.81%,64.05%,
106/07/24,1434,0,-22,1412,376405,4335,9267,390007,61.85%,64.09%,
106/07/21,181,-319,-50,-188,374971,4335,9289,388595,61.62%,63.86%,
106/07/20,243,-469,126,-100,374790,4654,9339,388783,61.59%,63.89%,
106/07/19,-429,0,35,-394,374546,5123,9213,388882,61.55%,63.91%,
106/07/18,166,2,-50,118,374975,5123,9178,389276,61.62%,63.97%,
106/07/17,221,0,43,264,374805,5121,9228,389154,61.59%,63.95%,
106/07/14,159,-26,-57,76,374584,5121,9185,388890,61.55%,63.90%,
106/07/13,1267,-301,21,987,374415,5147,9242,388804,61.52%,63.88%,
106/07/12,570,-411,-72,87,373148,5448,9221,387817,61.32%,63.73%,
106/07/11,852,0,-246,606,372579,5859,9293,387731,61.22%,63.71%,
106/07/10,-544,-1,227,-318,371727,5859,9539,387125,61.08%,63.61%,
106/07/07,-384,-7,-40,-431,372271,5860,9312,387443,61.17%,63.66%,
106/07/06,-663,-5,47,-621,372655,5867,9352,387874,61.24%,63.74%,
106/07/05,-68,-2,19,-51,373388,5872,9305,388565,61.36%,63.85%,
106/07/04,-609,-1,-39,-649,373571,5874,9286,388731,61.39%,63.88%,
106/07/03,22,-60,130,92,374180,5875,9325,389380,61.49%,63.99%,
106/06/30,-405,-47,26,-426,374158,5935,9195,389288,61.48%,63.97%,
106/06/29,837,-18,49,868,374563,6119,9169,389851,61.55%,64.06%,
106/06/28,487,-15,84,556,373726,6137,9120,388983,61.41%,63.92%,
106/06/27,127,-262,101,-34,373239,6152,9036,388427,61.33%,63.83%,
106/06/26,638,-26,12,624,373112,6414,8935,388461,61.31%,63.83%,
106/06/23,-29,-1,77,47,372594,6440,8923,387957,61.23%,63.75%,
106/06/22,-62,-6,141,73,372623,6441,8846,387910,61.23%,63.74%,
106/06/21,-243,-48,190,-101,372685,6447,8705,387837,61.24%,63.73%,
106/06/20,-382,-2,58,-326,372928,6495,8515,387938,61.28%,63.75%,
106/06/19,-434,25,118,-291,373380,6496,8457,388333,61.35%,63.81%,
106/06/16,228,-585,146,-211,374010,6471,8339,388820,61.46%,63.89%,
106/06/15,247,-243,94,98,373782,7056,8193,389031,61.42%,63.93%,
106/06/14,-367,0,81,-286,373535,7299,8099,388933,61.38%,63.91%,
106/06/13,-545,0,283,-262,373800,7299,8018,389117,61.42%,63.94%,
106/06/12,-527,100,155,-272,374134,7299,7735,389168,61.48%,63.95%,
106/06/09,423,-1,169,591,374757,7199,7580,389536,61.58%,64.01%,
106/06/08,289,111,280,680,374253,7200,7411,388864,61.50%,63.90%,
106/06/07,330,78,194,602,374088,7089,7131,388308,61.47%,63.81%,
106/06/06,-275,13,126,-136,373857,7011,6937,387805,61.43%,63.72%,
106/06/05,254,34,43,331,374122,6998,6811,387931,61.48%,63.75%,
106/06/03,0,-21,76,55,373868,6964,6768,387600,61.43%,63.69%,
106/06/02,143,22,107,272,373868,6985,6692,387545,61.43%,63.68%,
106/06/01,11,0,83,94,373800,6963,6585,387348,61.42%,63.65%,
106/05/31,111,0,47,158,373779,6963,6502,387244,61.42%,63.63%,
106/05/26,-463,-3,200,-266,373682,6963,6455,387100,61.40%,63.61%,
106/05/25,511,100,96,707,374200,6966,6255,387421,61.49%,63.66%,
106/05/24,-1527,0,115,-1412,373649,6866,6159,386674,61.40%,63.54%,
106/05/23,595,250,-83,762,375086,6866,6044,387996,61.63%,63.75%,
106/05/22,856,70,120,1046,374480,6616,6127,387223,61.54%,63.63%,
106/05/19,-248,162,33,-53,373624,6546,6007,386177,61.39%,63.45%,
106/05/18,-240,-1,-1,-242,373872,6384,5974,386230,61.44%,63.47%,
106/05/17,742,-11,82,813,374107,6385,5975,386467,61.47%,63.50%,
106/05/16,486,70,28,584,373340,6396,5893,385629,61.35%,63.37%,
106/05/15,672,24,23,719,372759,6326,5865,384950,61.25%,63.25%,
106/05/12,450,0,-32,418,372117,6302,5842,384261,61.15%,63.15%,
106/05/11,-125,418,-55,238,371657,6302,5874,383833,61.07%,63.07%,
106/05/10,-476,424,102,50,371772,5884,5929,383585,61.09%,63.03%,
106/05/09,868,275,15,1158,372198,5460,5827,383485,61.16%,63.01%,
106/05/08,3768,942,430,5140,371320,5185,5812,382317,61.02%,62.83%,
106/05/05,2022,414,273,2709,367422,4243,5382,377047,60.38%,61.96%,
106/05/04,1619,324,96,2039,365366,3829,5109,374304,60.04%,61.51%,
106/05/03,187,90,0,277,363747,3505,5013,372265,59.77%,61.17%,
106/05/02,957,0,-7,950,363560,3415,5013,371988,59.74%,61.13%,
106/04/28,402,0,-13,389,362603,3415,5020,371038,59.58%,60.97%,
106/04/27,-237,-8,-16,-261,362201,3415,5033,370649,59.52%,60.91%,
106/04/26,555,0,-20,535,362438,3423,5049,370910,59.56%,60.95%,
106/04/25,448,0,-8,440,361883,3423,5069,370375,59.47%,60.87%,
106/04/24,-209,0,12,-197,361425,3423,5077,369925,59.39%,60.79%,
106/04/21,122,0,20,142,361634,3423,5065,370122,59.42%,60.81%,
106/04/20,206,1,35,242,361512,3423,5045,369980,59.40%,60.79%,
106/04/19,-1208,1,11,-1196,361305,3422,5010,369737,59.37%,60.76%,
106/04/18,-241,0,-6,-247,362458,3422,4999,370879,59.56%,60.94%,
106/04/17,-51,0,88,37,362699,3422,5005,371126,59.60%,60.98%,
106/04/14,-117,-2,-7,-126,362750,3422,4917,371089,59.61%,60.98%,
106/04/13,130,0,52,182,362867,3424,4924,371215,59.63%,61.00%,
106/04/12,-163,-7,-5,-175,362737,3424,4872,371033,59.61%,60.97%,
106/04/11,129,0,13,142,362900,3431,4876,371207,59.63%,61.00%,
106/04/10,140,0,0,140,362771,3431,4863,371065,59.61%,60.97%,
106/04/07,205,0,-16,189,362631,3431,4863,370925,59.59%,60.95%,
106/04/06,-360,9,0,-351,362426,3431,4879,370736,59.55%,60.92%,
106/04/05,-663,1,3,-659,362787,3422,4879,371088,59.61%,60.97%,
106/03/31,202,2,9,213,363450,3421,4876,371747,59.72%,61.08%,
106/03/30,338,-13,-18,307,363248,2719,4867,370834,59.69%,60.94%,
106/03/29,236,24,-40,220,362910,2732,4885,370527,59.63%,60.88%,
106/03/28,228,0,70,298,362674,2708,4925,370307,59.60%,60.85%,
106/03/27,373,0,5,378,362446,2708,4855,370009,59.56%,60.80%,
106/03/24,199,-27,-31,141,362074,2708,4850,369632,59.50%,60.74%,
106/03/23,769,0,19,788,361875,2735,4881,369491,59.46%,60.71%,
106/03/22,-259,0,-1,-260,361105,2735,4862,368702,59.34%,60.59%,
106/03/21,895,56,-150,801,361364,2735,4863,368962,59.38%,60.63%,
106/03/20,373,29,81,483,360469,2679,5013,368161,59.23%,60.49%,
106/03/17,343,34,6,383,360116,2650,4932,367698,59.17%,60.42%,
106/03/16,92,0,-20,72,359773,2616,4926,367315,59.12%,60.36%,
106/03/15,29,11,-134,-94,359681,2616,4946,367243,59.10%,60.34%,
106/03/14,62,0,36,98,359652,2605,5080,367337,59.10%,60.36%,
106/03/13,-913,100,-7,-820,359590,2605,5044,367239,59.09%,60.35%,
106/03/10,-394,-3,-7,-404,360503,2505,5051,368059,59.24%,60.48%,
106/03/09,-311,0,-18,-329,360928,2508,5058,368494,59.31%,60.55%,
106/03/08,-100,0,3,-97,361239,2508,5076,368823,59.36%,60.61%,
106/03/07,180,0,-23,157,361340,2508,5073,368921,59.38%,60.63%,
106/03/06,175,0,15,190,361160,2508,5096,368764,59.35%,60.60%,
106/03/03,35,0,16,51,360934,2508,5081,368523,59.31%,60.56%,
106/03/02,-245,-24,-69,-338,360899,2508,5065,368472,59.30%,60.54%,
106/03/01,823,-4,20,839,361172,2532,5134,368838,59.35%,60.61%,
106/02/24,-1656,69,55,-1532,360349,2536,5114,367999,59.21%,60.47%,
106/02/23,-246,-190,8,-428,362005,2467,5059,369531,59.49%,60.73%,
106/02/22,130,-20,-3,107,362375,2657,5051,370083,59.55%,60.82%,
106/02/21,210,0,-25,185,362235,2677,5054,369966,59.52%,60.79%,
106/02/20,-270,7,-19,-282,362025,2677,5079,369781,59.49%,60.76%,
106/02/18,0,0,-5,-5,362295,2670,5098,370063,59.53%,60.81%,
106/02/17,405,0,-20,385,362295,2670,5103,370068,59.53%,60.81%,
106/02/16,-246,-54,-74,-374,361869,2670,5123,369662,59.46%,60.74%,
106/02/15,559,0,56,615,362098,2724,5197,370019,59.50%,60.80%,
106/02/14,577,190,-56,711,361529,2724,5141,369394,59.41%,60.70%,
106/02/13,769,0,51,820,360952,2534,5197,368683,59.31%,60.58%,
106/02/10,100,50,-17,133,360183,2534,5146,367863,59.19%,60.45%,
106/02/09,-375,195,-50,-230,360084,2484,5163,367731,59.17%,60.43%,
106/02/08,1496,69,-147,1418,360417,2289,5213,367919,59.22%,60.45%,
106/02/07,653,0,-38,615,358908,2220,5360,366488,58.98%,60.23%,
106/02/06,1335,0,283,1618,358337,2220,5398,365955,58.88%,60.13%,
106/02/03,142,4,6,152,356993,2220,5115,364328,58.66%,59.87%,
106/02/02,-62,0,-5,-67,357708,2216,5109,365033,58.78%,59.98%,
106/01/24,238,0,-49,189,357770,2216,5114,365100,58.79%,59.99%,
106/01/23,756,-4,-13,739,357652,2216,5163,365031,58.77%,59.98%,
106/01/20,-111,0,13,-98,356896,2220,5176,364292,58.65%,59.87%,
106/01/19,-443,-14,13,-444,357007,2220,5163,364390,58.66%,59.87%,
106/01/18,251,0,25,276,357213,2234,5150,364597,58.70%,59.91%,
106/01/17,55,0,6,61,356662,2234,5125,364021,58.61%,59.82%,
106/01/16,141,0,-8,133,356365,2234,5119,363718,58.56%,59.77%,
106/01/13,487,0,-61,426,356010,2234,5127,363371,58.50%,59.71%,
106/01/12,576,0,-3,573,355477,2234,5188,362899,58.41%,59.63%,
106/01/11,633,-20,-30,583,354891,2234,5191,362316,58.32%,59.54%,
106/01/10,472,0,31,503,354245,2254,5221,361720,58.21%,59.44%,
106/01/09,-722,0,-12,-734,353773,2254,5190,361217,58.13%,59.35%,
106/01/06,582,-4,5,583,354481,2254,5202,361937,58.25%,59.48%,
106/01/05,1090,1,-12,1079,353879,2258,5197,361334,58.15%,59.38%,
106/01/04,252,0,8,260,352778,2257,5209,360244,57.97%,59.20%,
106/01/03,162,0,7,169,352526,2257,5201,359984,57.93%,59.16%,
105/12/30,89,0,-23,66,352364,2257,5194,359815,57.90%,59.12%,
105/12/29,14,-40,6,-20,352267,2257,5217,359741,57.88%,59.11%,
105/12/28,267,0,-18,249,352252,2297,5211,359760,57.88%,59.11%,
105/12/27,-368,0,9,-359,351985,2297,5229,359511,57.84%,59.08%,
105/12/26,17,-100,20,-63,352353,2297,5220,359870,57.90%,59.14%,
105/12/23,-485,0,-9,-494,352336,2397,5200,359933,57.90%,59.15%,
105/12/22,-488,-51,-3,-542,352821,2397,5209,360427,57.98%,59.23%,
105/12/21,-1159,0,97,-1062,353329,2448,5212,360989,58.06%,59.32%,
105/12/20,-47,-15,35,-27,354739,2448,5115,362302,58.29%,59.53%,
105/12/19,-1346,0,-73,-1419,354735,2463,5080,362278,58.29%,59.53%,
105/12/16,-443,-60,132,-371,356071,2463,5153,363687,58.51%,59.76%,
105/12/15,-157,0,27,-130,356714,2523,5021,364258,58.62%,59.86%,
105/12/14,273,-15,-4,254,357000,2523,4994,364517,58.66%,59.90%,
105/12/13,-223,-1,31,-193,356812,2538,4998,364348,58.63%,59.87%,
105/12/12,-258,0,-122,-380,356959,2539,4967,364465,58.66%,59.89%,
105/12/09,-16,0,22,6,357217,2539,5089,364845,58.70%,59.95%,
105/12/08,-458,-30,-17,-505,357233,2539,5067,364839,58.70%,59.95%,
105/12/07,169,67,15,251,357690,2569,5084,365343,58.78%,60.04%,
105/12/06,66,-25,-13,28,357512,2502,5069,365083,58.75%,59.99%,
105/12/05,-116,0,21,-95,357464,2527,5082,365073,58.74%,59.99%,
105/12/02,103,-115,-41,-53,357580,2527,5061,365168,58.76%,60.01%,
105/12/01,554,-16,51,589,357523,2642,5102,365267,58.75%,60.02%,
105/11/30,-541,0,-32,-573,356969,2658,5051,364678,58.66%,59.93%,
105/11/29,-302,3,23,-276,357645,2658,5083,365386,58.77%,60.04%,
105/11/28,357,-10,17,364,357947,2654,5060,365661,58.82%,60.09%,
105/11/25,-28,-18,-22,-68,357456,2664,5043,365163,58.74%,60.01%,
105/11/24,53,-8,32,77,357484,2682,5065,365231,58.74%,60.01%,
105/11/23,-521,0,-93,-614,357431,2690,5033,365154,58.73%,60.00%,
105/11/22,303,0,-9,294,357811,2690,5126,365627,58.80%,60.08%,
105/11/21,-100,0,-5,-105,358081,2690,5135,365906,58.84%,60.13%,
105/11/18,-297,0,15,-282,358170,2690,5140,366000,58.86%,60.15%,
105/11/17,73,-41,-48,-16,358388,2690,5125,366203,58.89%,60.17%,
105/11/16,123,0,30,153,358298,2731,5173,366202,58.88%,60.18%,
105/11/15,-1342,0,58,-1284,358118,2731,5143,365992,58.85%,60.14%,
105/11/14,-468,-136,80,-524,359390,2731,5085,367206,59.06%,60.34%,
105/11/11,-1194,0,149,-1045,359848,2867,5005,367720,59.13%,60.42%,
105/11/10,-636,-50,43,-643,360792,2867,4856,368515,59.29%,60.56%,
105/11/09,-2828,0,58,-2770,361418,2917,4813,369148,59.39%,60.66%,
105/11/08,142,0,-8,134,365144,2917,4755,372816,60.00%,61.26%,
105/11/07,-267,-4,44,-227,364992,2917,4763,372672,59.98%,61.24%,
105/11/04,260,-260,22,22,365247,2921,4719,372887,60.02%,61.28%,
105/11/03,737,-107,18,648,364974,3181,4697,372852,59.97%,61.26%,
105/11/02,447,0,-1,446,364314,3288,4679,372281,59.86%,61.17%,
105/11/01,-53,0,-4,-57,364017,3288,4680,371985,59.82%,61.13%,
105/10/31,292,0,10,302,364069,3288,4684,372041,59.82%,61.13%,
105/10/28,477,0,-36,441,363768,3288,4674,371730,59.77%,61.08%,
105/10/27,513,10,-31,492,363071,3288,4710,371069,59.66%,60.97%,
105/10/26,739,0,47,786,362617,3278,4741,370636,59.59%,60.91%,
105/10/25,273,-4,9,278,361878,3278,4694,369850,59.46%,60.77%,
105/10/24,312,-12,10,310,361595,3282,4685,369562,59.42%,60.73%,
105/10/21,900,-18,48,930,361283,3294,4675,369252,59.37%,60.68%,
105/10/20,1631,-18,-9,1604,360373,3312,4627,368312,59.22%,60.52%,
105/10/19,2158,0,21,2179,358687,3330,4636,366653,58.94%,60.25%,
105/10/18,1201,28,-85,1144,356512,3330,4615,364457,58.58%,59.89%,
105/10/17,1069,0,119,1188,355271,3302,4700,363273,58.38%,59.70%,
105/10/14,1504,0,1,1505,354181,3302,4581,362064,58.20%,59.50%,
105/10/13,1476,-1,59,1534,352707,3302,4580,360589,57.96%,59.26%,
105/10/12,-65,0,311,246,351247,3303,4521,359071,57.72%,59.01%,
105/10/11,3403,0,-18,3385,351210,3303,4210,358723,57.71%,58.94%,
105/10/07,961,0,-118,843,347968,3303,4228,355499,57.18%,58.42%,
105/10/06,400,0,135,535,346989,3303,4346,354638,57.02%,58.28%,
105/10/05,46,0,-11,35,346500,3303,4211,354014,56.94%,58.17%,
105/10/04,-430,0,-14,-444,346235,3303,4222,353760,56.89%,58.13%,
105/10/03,-584,0,-7,-591,346655,3303,4236,354194,56.96%,58.20%,
105/09/30,-75,0,84,9,347239,3303,4243,354785,57.06%,58.30%,
105/09/29,-272,8,-840,-1104,347206,4019,4159,355384,57.05%,58.39%,
105/09/26,-310,0,-83,-393,347483,4011,4999,356493,57.10%,58.58%,
105/09/23,-118,-78,-83,-279,347779,4011,5082,356872,57.15%,58.64%,
105/09/22,-587,0,-163,-750,347873,4089,5165,357127,57.16%,58.68%,
105/09/21,-858,22,74,-762,348404,4089,5328,357821,57.25%,58.80%,
105/09/20,-2337,57,28,-2252,349140,4067,5254,358461,57.37%,58.90%,
105/09/19,-261,0,102,-159,351467,4010,5226,360703,57.75%,59.27%,
105/09/14,-659,792,10,143,351703,4010,5124,360837,57.79%,59.29%,
105/09/13,-46,-5,402,351,352336,3218,5114,360668,57.90%,59.27%,
105/09/12,-813,0,602,-211,352948,3223,4712,360883,58.00%,59.30%,
105/09/10,-355,-137,-51,-543,353742,3223,4110,361075,58.13%,59.34%,
105/09/09,111,61,-37,135,354097,3360,4161,361618,58.19%,59.43%,
105/09/08,1065,-68,-28,969,353951,3299,4198,361448,58.16%,59.39%,
105/09/07,-724,44,104,-576,352867,3367,4226,360460,57.98%,59.23%,
105/09/06,468,0,-69,399,353600,3323,4122,361045,58.10%,59.32%,
105/09/05,-602,-12,70,-544,353096,3323,4191,360610,58.02%,59.25%,
105/09/02,-130,0,11,-119,353688,3335,4121,361144,58.12%,59.35%,
105/09/01,563,-472,-21,70,353789,3335,4110,361234,58.14%,59.36%,
105/08/31,24,0,-6,18,353305,3807,4131,361243,58.06%,59.36%,
105/08/30,-40,4,-35,-71,353246,3807,4137,361190,58.05%,59.36%,
105/08/29,56,-20,-38,-2,353276,3803,4172,361251,58.05%,59.36%,
105/08/26,185,1,-107,79,353280,3823,4210,361313,58.05%,59.37%,
105/08/25,-434,2,131,-301,353086,3822,4317,361225,58.02%,59.36%,
105/08/24,-518,-41,-74,-633,353550,3820,4186,361556,58.10%,59.42%,
105/08/23,195,-6,142,331,354172,3861,4260,362293,58.20%,59.53%,
105/08/22,122,0,-5,117,353972,3867,4118,361957,58.17%,59.48%,
105/08/19,-136,0,-19,-155,354030,3867,4123,362020,58.17%,59.48%,
105/08/18,-362,-1,-32,-395,354133,3867,4142,362142,58.19%,59.51%,
105/08/17,724,2,-113,613,354495,3868,4174,362537,58.25%,59.57%,
105/08/16,-1,-38,42,3,353770,3866,4287,361923,58.13%,59.47%,
105/08/15,-1098,6,19,-1073,353561,3904,4245,361710,58.10%,59.44%,
105/08/12,-385,4,5,-376,354659,3898,4226,362783,58.28%,59.62%,
105/08/11,-467,-10,-30,-507,354932,3894,4221,363047,58.32%,59.65%,
105/08/10,685,-61,27,651,355399,3904,4251,363554,58.40%,59.74%,
105/08/09,86,-207,-54,-175,354555,3965,4224,362744,58.26%,59.61%,
105/08/08,-812,-34,-10,-856,354705,4172,4278,363155,58.29%,59.68%,
105/08/05,662,-30,-7,625,355461,4206,4288,363955,58.41%,59.81%,
105/08/04,-346,-25,49,-322,354812,4236,4295,363343,58.30%,59.70%,
105/08/03,-622,-50,-120,-792,355161,4261,4246,363668,58.36%,59.76%,
105/08/02,-609,-56,-14,-679,355783,4311,4366,364460,58.46%,59.89%,
105/08/01,778,-193,-183,402,356349,4367,4380,365096,58.56%,60.00%,
105/07/29,-823,-182,-79,-1084,355448,4560,4563,364571,58.41%,59.91%,
105/07/28,1835,38,-334,1539,356261,4742,4642,365645,58.54%,60.08%,
105/07/27,2212,-92,52,2172,354212,4704,4976,363892,58.20%,59.79%,
105/07/26,1216,-63,254,1407,351435,4796,4924,361155,57.75%,59.35%,
105/07/25,-778,-12,-63,-853,350200,4859,4670,359729,57.55%,59.12%,
105/07/22,-401,-3,88,-316,351051,4871,4733,360655,57.69%,59.27%,
105/07/21,1551,-4,-175,1372,351400,4874,4645,360919,57.74%,59.30%,
105/07/20,552,-3,-158,391,349818,4878,4820,359516,57.48%,59.07%,
105/07/19,386,-130,104,360,349480,4881,4978,359339,57.43%,59.05%,
105/07/18,134,-285,-260,-411,348931,5011,4874,358816,57.34%,58.96%,
105/07/15,925,-7,201,1119,348766,5296,5134,359196,57.31%,59.02%,
105/07/14,-2057,-15,35,-2037,347810,5303,4933,358046,57.15%,58.83%,
105/07/13,-1150,-68,-160,-1378,349715,5318,4898,359931,57.47%,59.15%,
105/07/12,1749,918,-975,1692,350865,5386,5058,361309,57.65%,59.37%,
105/07/11,1740,80,936,2756,349483,4468,6033,359984,57.43%,59.16%,
105/07/07,795,0,127,922,347798,4388,5097,357283,57.15%,58.71%,
105/07/06,-1466,10,-78,-1534,347003,4388,4970,356361,57.02%,58.56%,
105/07/05,-1111,16,59,-1036,348469,4378,5048,357895,57.26%,58.81%,
105/07/04,-1544,0,-56,-1600,349580,4362,4989,358931,57.44%,58.98%,
105/07/01,-506,121,2,-383,351124,4362,5045,360531,57.70%,59.25%,
105/06/30,2229,117,-1029,1317,351630,4241,5043,360914,57.78%,59.31%,
105/06/29,379,-65,-199,115,349853,4009,6072,359934,57.49%,59.15%,
105/06/28,-738,-164,-85,-987,349454,4074,6271,359799,57.42%,59.12%,
105/06/27,-948,-2,35,-915,350192,4238,6356,360786,57.54%,59.28%,
105/06/24,-1086,4,219,-863,351140,4240,6321,361701,57.70%,59.44%,
105/06/23,-81,106,-139,-114,352226,4236,6102,362564,57.88%,59.58%,
105/06/22,919,0,-167,752,352307,4130,6241,362678,57.89%,59.59%,
105/06/21,1870,0,-380,1490,351389,4130,6408,361927,57.74%,59.47%,
105/06/20,-250,-27,-127,-404,349519,4130,6788,360437,57.43%,59.22%,
105/06/17,1612,112,91,1815,349768,4157,6915,360840,57.47%,59.29%,
105/06/16,-47,-12,-31,-90,348196,4045,6824,359065,57.22%,59.01%,
105/06/15,-48,-22,10,-60,348244,4057,6855,359156,57.22%,59.01%,
105/06/14,136,0,4,140,348428,4079,6845,359352,57.25%,59.05%,
105/06/13,-353,171,40,-142,348196,4079,6841,359116,57.22%,59.01%,
105/06/08,403,0,-10,393,348838,3908,6801,359547,57.32%,59.08%,
105/06/07,456,81,-10,527,348825,3908,6811,359544,57.32%,59.08%,
105/06/06,-307,0,31,-276,347780,3827,6821,358428,57.15%,58.90%,
105/06/04,24,34,10,68,348087,3827,6790,358704,57.20%,58.94%,
105/06/03,-2501,69,-154,-2586,348063,3793,6780,358636,57.19%,58.93%,
105/06/02,-203,-18,-204,-425,350697,3724,6934,361355,57.63%,59.38%,
105/06/01,-742,80,114,-548,350900,3742,7138,361780,57.66%,59.45%,
105/05/31,-2401,90,22,-2289,351642,3662,7024,362328,57.78%,59.54%,
105/05/30,-1087,0,-31,-1118,353970,3572,7002,364544,58.16%,59.90%,
105/05/27,-1246,0,-10,-1256,355216,3572,7033,365821,58.37%,60.11%,
105/05/26,1457,31,-34,1454,356653,3572,7043,367268,58.61%,60.35%,
105/05/25,-1753,353,-288,-1688,355141,3541,7077,365759,58.36%,60.10%,
105/05/24,1552,20,77,1649,356301,3188,7365,366854,58.55%,60.28%,
105/05/23,-1294,100,245,-949,354683,3168,7288,365139,58.28%,60.00%,
105/05/20,-1218,41,84,-1093,355968,3068,7043,366079,58.49%,60.15%,
105/05/19,-573,0,67,-506,357096,3027,6959,367082,58.68%,60.32%,
105/05/18,-1012,0,23,-989,357646,3027,6892,367565,58.77%,60.40%,
105/05/17,-1447,0,129,-1318,358658,3027,6869,368554,58.94%,60.57%,
105/05/16,-220,0,145,-75,360164,3027,6740,369931,59.18%,60.79%,
105/05/13,-3340,40,316,-2984,360384,3027,6595,370006,59.22%,60.80%,
105/05/12,-911,-4,131,-784,363474,2987,6279,372740,59.73%,61.25%,
105/05/11,-1719,19,57,-1643,364385,2991,6148,373524,59.88%,61.38%,
105/05/10,-1040,70,-24,-994,366102,2972,6091,375165,60.16%,61.65%,
105/05/09,-356,100,147,-109,366672,2902,6115,375689,60.25%,61.73%,
105/05/06,-1073,0,336,-737,366981,2802,5968,375751,60.30%,61.74%,
105/05/05,-370,0,92,-278,368112,2802,5632,376546,60.49%,61.88%,
105/05/04,-969,0,154,-815,368522,2802,5540,376864,60.56%,61.93%,
105/05/03,-1634,-2,101,-1535,369440,2802,5386,377628,60.71%,62.06%,
105/04/29,209,-1,52,260,370971,2804,5285,379060,60.96%,62.29%,
105/04/28,-1035,57,21,-957,370882,2805,5233,378920,60.94%,62.26%,
105/04/27,-954,-43,236,-761,371882,2748,5212,379842,61.11%,62.42%,
105/04/26,-683,-5,18,-670,372777,2791,4976,380544,61.26%,62.54%,
105/04/25,382,219,-97,504,373450,2796,4958,381204,61.37%,62.64%,
105/04/22,1527,0,53,1580,373002,2577,5055,380634,61.29%,62.54%,
105/04/21,216,17,-109,124,371439,2577,5002,379018,61.04%,62.29%,
105/04/20,-1631,7,225,-1399,371486,2560,5111,379157,61.04%,62.30%,
105/04/19,-6642,-110,18,-6734,373493,2553,4886,380932,61.37%,62.59%,
105/04/18,-517,-2,97,-422,380126,2663,4868,387657,62.46%,63.70%,
105/04/15,-896,-9,-67,-972,380593,2665,4771,388029,62.54%,63.76%,
105/04/14,-1564,-31,149,-1446,381417,2674,4838,388929,62.68%,63.91%,
105/04/13,-2203,4,-49,-2248,382880,2705,4689,390274,62.92%,64.14%,
105/04/12,-764,-3,-18,-785,385169,2701,4738,392608,63.29%,64.51%,
105/04/11,5,-5,-8,-8,385365,2704,4756,392825,63.32%,64.55%,
105/04/08,-544,-28,35,-537,385360,2709,4764,392833,63.32%,64.55%,
105/04/07,56,-83,70,43,385880,2737,4729,393346,63.41%,64.64%,
105/04/06,-1033,-3,80,-956,385844,2820,4659,393323,63.40%,64.63%,
105/04/01,-650,-108,7,-751,386877,2823,4579,394279,63.57%,64.79%,
105/03/31,1881,11,-156,1736,387494,2931,4572,394997,63.67%,64.90%,
105/03/30,1251,25,11,1287,385613,2209,4728,392550,63.36%,64.50%,
105/03/29,2009,64,-96,1977,384176,2184,4717,391077,63.13%,64.26%,
105/03/28,301,-100,-32,169,382086,2120,4813,389019,62.79%,63.93%,
105/03/25,201,-360,-11,-170,381785,2220,4845,388850,62.74%,63.90%,
105/03/24,-1156,-145,119,-1182,381800,2580,4856,389236,62.74%,63.96%,
105/03/23,-876,-456,75,-1257,382956,2725,4737,390418,62.93%,64.16%,
105/03/22,-2670,-217,-128,-3015,383832,3181,4662,391675,63.07%,64.36%,
105/03/21,1740,56,-106,1690,386492,3398,4790,394680,63.51%,64.86%,
105/03/18,1347,-443,-32,872,384536,3342,4896,392774,63.19%,64.54%,
105/03/17,26,65,31,122,383189,3785,4928,391902,62.97%,64.40%,
105/03/16,132,-310,116,-62,383163,3720,4897,391780,62.96%,64.38%,
105/03/15,-1175,-236,-63,-1474,383031,4030,4781,391842,62.94%,64.39%,
105/03/14,976,0,62,1038,384206,4266,4844,393316,63.13%,64.63%,
105/03/11,642,-3,11,650,383230,4266,4782,392278,62.97%,64.46%,
105/03/10,722,-2,13,733,382588,4269,4771,391628,62.87%,64.36%,
105/03/09,-208,-32,-50,-290,381806,4271,4758,390835,62.74%,64.22%,
105/03/08,16,-55,-5,-44,382216,4303,4808,391327,62.81%,64.31%,
105/03/07,826,-47,11,790,382201,4358,4813,391372,62.80%,64.31%,
105/03/04,286,0,-3,283,381375,4405,4802,390582,62.67%,64.18%,
105/03/03,357,256,-63,550,381493,4405,4805,390703,62.69%,64.20%,
105/03/02,-623,-1,-124,-748,381325,4149,4868,390342,62.66%,64.14%,
105/03/01,-1342,-24,122,-1244,381680,4150,4992,390822,62.72%,64.22%,
105/02/26,965,0,35,1000,383022,4174,4870,392066,62.94%,64.43%,
105/02/25,620,0,77,697,382058,4174,4835,391067,62.78%,64.26%,
105/02/24,223,-40,-28,155,381682,4174,4758,390614,62.72%,64.19%,
105/02/23,366,-40,20,346,381459,4214,4786,390459,62.68%,64.16%,
105/02/22,95,-26,23,92,381196,4254,4766,390216,62.64%,64.12%,
105/02/19,470,0,-95,375,381087,4280,4743,390110,62.62%,64.10%,
105/02/18,-507,4,84,-419,380616,4280,4838,389734,62.54%,64.04%,
105/02/17,-488,322,34,-132,381409,4276,4754,390439,62.67%,64.15%,
105/02/16,-720,0,91,-629,381897,3954,4720,390571,62.75%,64.18%,
105/02/15,1703,-21,69,1751,382607,3954,4629,391190,62.87%,64.28%,
105/02/03,768,-193,-136,439,380791,3975,4560,389326,62.57%,63.97%,
105/02/02,838,-38,-68,732,380453,4168,4696,389317,62.52%,63.98%,
105/02/01,603,50,-27,626,379332,4206,4764,388302,62.33%,63.80%,
105/01/30,92,100,39,231,378276,4156,4791,387223,62.16%,63.63%,
105/01/29,1763,377,55,2195,378184,4056,4752,386992,62.14%,63.59%,
105/01/28,1267,89,102,1458,376421,3679,4697,384797,61.85%,63.23%,
105/01/27,-202,0,81,-121,375185,3590,4595,383370,61.65%,63.00%,
105/01/26,421,8,-68,361,375377,3590,4514,383481,61.68%,63.01%,
105/01/25,326,78,-21,383,374931,3582,4582,383095,61.61%,62.95%,
105/01/22,-24,0,101,77,374615,3504,4603,382722,61.56%,62.89%,
105/01/21,-1283,-9,-25,-1317,374630,3504,4502,382636,61.56%,62.88%,
105/01/20,-11,-24,-96,-131,375923,3513,4527,383963,61.77%,63.09%,
105/01/19,-309,-1,-107,-417,375888,3537,4623,384048,61.77%,63.11%,
105/01/18,526,0,189,715,376770,3538,4730,385038,61.91%,63.27%,
105/01/15,-125,102,-71,-94,376140,3538,4541,384219,61.81%,63.14%,
105/01/14,-925,-25,81,-869,376251,3436,4612,384299,61.83%,63.15%,
105/01/13,-136,0,59,-77,377175,3461,4531,385167,61.98%,63.29%,
105/01/12,-206,-40,-17,-263,377357,3461,4472,385290,62.01%,63.31%,
105/01/11,-1265,46,-38,-1257,377552,3501,4489,385542,62.04%,63.35%,
105/01/08,-493,74,77,-342,378817,3455,4527,386799,62.25%,63.56%,
105/01/07,-832,-22,30,-824,379428,3381,4450,387259,62.35%,63.64%,
105/01/06,-550,-450,17,-983,380260,3403,4420,388083,62.49%,63.78%,
105/01/05,-630,-400,-14,-1044,380810,3853,4403,389066,62.58%,63.94%,
105/01/04,-728,-18,-60,-806,381913,4253,4417,390583,62.76%,64.18%,
104/12/31,-22,-25,0,-47,382531,4271,4477,391279,62.86%,64.30%,
104/12/30,154,-142,2,14,382144,3989,4477,390610,62.79%,64.18%,
104/12/29,183,-131,-98,-46,381980,4131,4475,390586,62.77%,64.18%,
104/12/28,504,57,-6,555,381212,4262,4573,390047,62.64%,64.09%,
104/12/25,86,21,-97,10,380698,4205,4579,389482,62.56%,64.00%,
104/12/24,217,0,-5,212,380563,4184,4676,389423,62.54%,64.00%,
104/12/23,208,0,-49,159,380336,4184,4681,389201,62.50%,63.96%,
104/12/22,513,0,-263,250,380231,4184,4730,389145,62.48%,63.94%,
104/12/21,28,-220,166,-26,379842,4184,4993,389019,62.42%,63.93%,
104/12/18,-167,112,-17,-72,379804,4404,4827,389035,62.41%,63.93%,
104/12/17,841,259,281,1381,380027,4292,4844,389163,62.45%,63.95%,
104/12/16,-65,19,-64,-110,379314,4033,4563,387910,62.33%,63.74%,
104/12/15,167,-20,14,161,379379,4014,4627,388020,62.34%,63.76%,
104/12/14,-63,-1,-1,-65,379112,4034,4613,387759,62.30%,63.72%,
104/12/11,-154,-369,-205,-728,379175,4035,4614,387824,62.31%,63.73%,
104/12/10,-1655,-86,130,-1611,379319,4404,4819,388542,62.33%,63.85%,
104/12/09,-1290,0,-56,-1346,380964,4490,4689,390143,62.60%,64.11%,
104/12/08,-3510,10,-19,-3519,382042,4490,4745,391277,62.78%,64.30%,
104/12/07,695,9,-26,678,385270,4480,4764,394514,63.31%,64.83%,
104/12/04,-407,0,-357,-764,384616,4471,4790,393877,63.20%,64.72%,
104/12/03,309,201,203,713,384926,4471,5147,394544,63.25%,64.83%,
104/12/02,2495,0,181,2676,384606,4270,4944,393820,63.20%,64.71%,
104/12/01,1347,-162,253,1438,382111,4270,4763,391144,62.79%,64.27%,
104/11/30,-94,0,-41,-135,381274,4432,4510,390216,62.65%,64.12%,
104/11/27,-93,0,-108,-201,381368,4432,4551,390351,62.67%,64.15%,
104/11/26,1172,0,17,1189,381704,4432,4659,390795,62.72%,64.21%,
104/11/25,102,32,-414,-280,380532,4432,4642,389606,62.53%,64.02%,
104/11/24,987,158,198,1343,380431,4400,5056,389887,62.51%,64.06%,
104/11/23,-279,-390,290,-379,379434,4242,4858,388534,62.35%,63.85%,
104/11/20,-162,-414,-119,-695,379713,4632,4568,388913,62.40%,63.91%,
104/11/19,-86,-165,90,-161,379880,5046,4687,389613,62.42%,64.02%,
104/11/18,-219,-100,-21,-340,379966,5211,4597,389774,62.44%,64.05%,
104/11/17,-1072,-55,-59,-1186,380084,5311,4618,390013,62.46%,64.09%,
104/11/16,-212,0,-11,-223,381156,5366,4677,391199,62.63%,64.28%,
104/11/13,-392,0,108,-284,381292,5366,4688,391346,62.65%,64.30%,
104/11/12,606,-180,-14,412,381542,5366,4580,391488,62.70%,64.33%,
104/11/11,-571,0,-150,-721,380936,5546,4594,391076,62.60%,64.27%,
104/11/10,-762,-200,284,-678,381507,5546,4744,391797,62.69%,64.38%,
104/11/09,-1129,-9,34,-1104,381759,5746,4460,391965,62.73%,64.41%,
104/11/06,-1310,-23,-142,-1475,382889,5755,4426,393070,62.92%,64.59%,
104/11/05,1565,267,-127,1705,384099,5778,4568,394445,63.12%,64.82%,
104/11/04,4027,409,455,4891,382534,5511,4695,392740,62.86%,64.54%,
104/11/03,1408,-470,29,967,378497,5102,4240,387839,62.20%,63.74%,
104/11/02,-974,73,213,-688,377090,5572,4211,386873,61.96%,63.57%,
104/10/30,-279,0,-46,-325,378064,5499,3998,387561,62.12%,63.68%,
104/10/29,-546,0,13,-533,378343,5499,4044,387886,62.17%,63.74%,
104/10/28,229,-340,-33,-144,378828,5499,4031,388358,62.25%,63.82%,
104/10/27,46,0,-26,20,378584,5839,4064,388487,62.21%,63.84%,
104/10/26,1017,0,55,1072,378498,5839,4090,388427,62.20%,63.83%,
104/10/23,2672,-56,28,2644,377469,5839,4035,387343,62.03%,63.65%,
104/10/22,743,-177,-95,471,375178,5895,4007,385080,61.65%,63.28%,
104/10/21,-320,0,167,-153,374435,6072,4102,384609,61.53%,63.20%,
104/10/20,566,0,-8,558,375273,6072,3935,385280,61.67%,63.31%,
104/10/19,214,-100,-10,104,374607,6072,3943,384622,61.56%,63.21%,
104/10/16,963,1,-64,900,374393,6172,3953,384518,61.52%,63.18%,
104/10/15,1796,-138,1,1659,373510,6171,4017,383698,61.38%,63.05%,
104/10/14,1004,-196,-19,789,371636,6309,4016,381961,61.07%,62.77%,
104/10/13,2960,-150,-227,2583,370476,6505,4035,381016,60.88%,62.61%,
104/10/12,1745,0,295,2040,367311,6655,4262,378228,60.36%,62.15%,
104/10/08,2485,0,79,2564,365566,6655,3967,376188,60.07%,61.82%,
104/10/07,239,-439,-26,-226,363081,6655,3888,373624,59.66%,61.39%,
104/10/06,322,-56,-54,212,362816,7094,3914,373824,59.62%,61.43%,
104/10/05,-64,1,-162,-225,362464,7150,3968,373582,59.56%,61.39%,
104/10/02,393,5,-138,260,362528,7149,4130,373807,59.57%,61.42%,
104/10/01,170,1,348,519,362134,7144,4268,373546,59.51%,61.39%,
104/09/30,-1655,-924,30,-2549,361964,7143,3920,373027,59.48%,61.30%,
104/09/25,-460,0,30,-430,364108,9531,3890,377529,59.83%,62.04%,
104/09/24,-681,-57,-21,-759,364644,9531,3860,378035,59.92%,62.12%,
104/09/23,412,-135,-47,230,365321,9588,3881,378790,60.03%,62.24%,
104/09/22,306,-10,-2,294,364909,9723,3928,378560,59.96%,62.20%,
104/09/21,-1665,-238,-19,-1922,364603,9733,3930,378266,59.91%,62.16%,
104/09/18,-338,-186,-164,-688,365750,9971,3949,379670,60.10%,62.39%,
104/09/17,-1498,0,180,-1318,366337,10157,4113,380607,60.20%,62.55%,
104/09/16,-418,-62,-5,-485,367835,10157,3933,381925,60.44%,62.76%,
104/09/15,223,1,-162,62,368004,10219,3938,382161,60.47%,62.80%,
104/09/14,-342,1,54,-287,367781,10218,4100,382099,60.43%,62.78%,
104/09/11,247,47,-60,234,368123,10217,4046,382386,60.49%,62.83%,
104/09/10,783,40,-274,549,367876,10170,4106,382152,60.45%,62.80%,
104/09/09,1169,786,111,2066,367061,10130,4380,381571,60.32%,62.70%,
104/09/08,334,43,-24,353,365891,9344,4269,379504,60.12%,62.36%,
104/09/07,1020,4,-311,713,365557,9301,4293,379151,60.07%,62.30%,
104/09/04,124,54,156,334,364537,9297,4604,378438,59.90%,62.18%,
104/09/03,29,-83,21,-33,364131,9243,4448,377822,59.83%,62.08%,
104/09/02,-280,0,83,-197,364101,9326,4427,377854,59.83%,62.09%,
104/09/01,10,-28,-54,-72,364370,9326,4344,378040,59.87%,62.12%,
104/08/31,687,-2,15,700,364150,9354,4398,377902,59.84%,62.10%,
104/08/28,376,49,34,459,363464,9356,4383,377203,59.72%,61.98%,
104/08/27,-800,154,84,-562,363269,9307,4349,376925,59.69%,61.93%,
104/08/26,2,-117,37,-78,367888,9153,4265,381306,60.45%,62.66%,
104/08/25,614,-38,116,692,368081,9270,4228,381579,60.48%,62.70%,
104/08/24,329,6,145,480,367442,9308,4112,380862,60.38%,62.59%,
104/08/21,-59,-125,6,-178,366569,9302,3967,379838,60.24%,62.42%,
104/08/20,831,-35,121,917,366854,9427,3961,380242,60.28%,62.48%,
104/08/19,227,0,55,282,366408,9462,3840,379710,60.21%,62.40%,
104/08/18,842,0,29,871,366286,9462,3785,379533,60.19%,62.37%,
104/08/17,-153,0,-15,-168,365444,9462,3756,378662,60.05%,62.22%,
104/08/14,-1422,115,-194,-1501,365635,9462,3771,378868,60.08%,62.25%,
104/08/13,11,32,166,209,366351,9347,3965,379663,60.20%,62.39%,
104/08/12,138,-233,29,-66,365890,9315,3799,379004,60.12%,62.28%,
104/08/11,-245,597,-189,163,365261,9548,3770,378579,60.02%,62.21%,
104/08/10,229,255,280,764,364200,8951,3959,377110,59.85%,61.97%,
104/08/07,-1829,208,-325,-1946,363350,8696,3679,375725,59.71%,61.74%,
104/08/06,2815,107,12,2934,364812,8488,4004,377304,59.95%,62.00%,
104/08/05,-302,55,148,-99,361997,8381,3992,374370,59.48%,61.51%,
104/08/04,-986,-10,50,-946,362228,8326,3844,374398,59.52%,61.52%,
104/08/03,-487,-100,-267,-854,363281,8336,3794,375411,59.69%,61.68%,
104/07/31,805,0,41,846,363814,8436,4061,376311,59.78%,61.83%,
104/07/30,558,-267,90,381,364765,8436,4020,377221,59.94%,61.99%,
104/07/29,-2237,354,-55,-1938,364660,8703,3930,377293,59.92%,62.00%,
104/07/28,458,-423,189,224,366263,8349,3985,378597,60.18%,62.21%,
104/07/27,399,59,66,524,365586,8772,3796,378154,60.07%,62.14%,
104/07/24,-210,174,-162,-198,364292,8713,3730,376735,59.86%,61.90%,
104/07/23,-62,191,43,172,364329,8539,3892,376760,59.87%,61.91%,
104/07/22,186,0,-51,135,364273,8348,3849,376470,59.86%,61.86%,
104/07/21,-298,-2,5,-295,364332,8348,3900,376580,59.87%,61.88%,
104/07/20,-458,25,-148,-581,364570,8350,3895,376815,59.91%,61.92%,
104/07/17,1352,-61,-25,1266,363341,8325,4043,375709,59.70%,61.73%,
104/07/16,1594,0,130,1724,361965,8386,4068,374419,59.48%,61.53%,
104/07/15,2429,199,88,2716,360588,8386,3938,372912,59.25%,61.28%,
104/07/14,-1617,-250,-127,-1994,358159,8187,3850,370196,58.85%,60.83%,
104/07/13,-438,-5,395,-48,359650,8437,3977,372064,59.10%,61.14%,
104/07/09,-805,-8,118,-695,359989,8442,3582,372013,59.15%,61.13%,
104/07/08,-1367,0,-217,-1584,360738,8450,3464,372652,59.28%,61.24%,
104/07/07,-1167,-170,25,-1312,362234,8450,3681,374365,59.52%,61.51%,
104/07/06,-921,-170,44,-1047,363391,8620,3656,375667,59.71%,61.73%,
104/07/03,-856,-5,0,-861,364212,8790,3612,376614,59.85%,61.89%,
104/07/02,-268,2,-2,-268,365267,8795,3612,377674,60.02%,62.06%,
104/07/01,-637,-15,-335,-987,365535,8793,3614,377942,60.07%,62.11%,
104/06/30,-558,387,5,-166,366159,8808,3949,378916,60.17%,62.27%,
104/06/29,-896,0,-29,-925,366516,7575,3944,378035,60.23%,62.12%,
104/06/26,-94,0,28,-66,367470,7575,3973,379018,60.38%,62.28%,
104/06/25,-546,-24,21,-549,368412,7575,3945,379932,60.54%,62.43%,
104/06/24,-685,0,6,-679,369055,7599,3924,380578,60.64%,62.53%,
104/06/23,-1268,0,-17,-1285,369808,7599,3918,381325,60.77%,62.66%,
104/06/22,808,14,171,993,371355,7599,3935,382889,61.02%,62.92%,
104/06/18,60,-243,11,-172,370578,7585,3764,381927,60.89%,62.76%,
104/06/17,-1663,18,164,-1481,370518,7828,3753,382099,60.88%,62.78%,
104/06/16,-1208,0,-154,-1362,372273,7810,3589,383672,61.17%,63.04%,
104/06/15,-837,-212,-59,-1108,373275,7810,3743,384828,61.34%,63.24%,
104/06/12,107,-169,1,-61,374621,8022,3802,386445,61.56%,63.50%,
104/06/11,-1732,-100,169,-1663,374721,8191,3801,386713,61.57%,63.54%,
104/06/10,95,-268,108,-65,376675,8291,3632,388598,61.90%,63.86%,
104/06/09,-869,-379,-68,-1316,376519,8559,3524,388602,61.87%,63.86%,
104/06/08,-135,-307,139,-303,377087,8938,3592,389617,61.96%,64.02%,
104/06/05,-253,-716,-120,-1089,377697,9245,3453,390395,62.06%,64.15%,
104/06/04,413,-109,-2,302,377934,9961,3573,391468,62.10%,64.32%,
104/06/03,490,11,-103,398,377522,10070,3575,391167,62.04%,64.28%,
104/06/02,-392,-32,17,-407,377082,10059,3678,390819,61.96%,64.22%,
104/06/01,738,0,-378,360,377464,10091,3661,391216,62.03%,64.29%,
104/05/29,1379,179,161,1719,376622,10091,4039,390752,61.89%,64.21%,
104/05/28,287,-1,-139,147,375914,9912,3878,389704,61.77%,64.04%,
104/05/27,-1374,-74,40,-1408,375916,9913,4017,389846,61.77%,64.06%,
104/05/26,2382,20,512,2914,377280,9987,3977,391244,62.00%,64.29%,
104/05/25,3,-5,-59,-61,374624,9967,3465,388056,61.56%,63.77%,
104/05/22,382,88,-27,443,374611,9972,3524,388107,61.56%,63.78%,
104/05/21,-619,-46,-87,-752,374235,9884,3551,387670,61.50%,63.71%,
104/05/20,1011,0,-210,801,374756,9930,3638,388324,61.58%,63.81%,
104/05/19,185,23,159,367,373700,9930,3848,387478,61.41%,63.67%,
104/05/18,-270,20,-56,-306,373459,9907,3689,387055,61.37%,63.60%,
104/05/15,707,0,47,754,373610,9887,3745,387242,61.39%,63.63%,
104/05/14,-933,0,-203,-1136,372893,9887,3698,386478,61.27%,63.50%,
104/05/13,2960,114,35,3109,373573,9887,3901,387361,61.39%,63.66%,
104/05/12,-2703,17,198,-2488,370328,9773,3866,383967,60.85%,63.09%,
104/05/11,945,50,-157,838,373031,9756,3668,386455,61.30%,63.51%,
104/05/08,14,80,-2,92,372088,9706,3825,385619,61.14%,63.36%,
104/05/07,-2364,33,-123,-2454,372074,9626,3827,385527,61.14%,63.35%,
104/05/06,-3039,0,342,-2697,374546,9593,3950,388089,61.55%,63.78%,
104/05/05,-2893,-531,71,-3353,377190,9593,3608,390391,61.98%,64.15%,
104/05/04,279,170,-405,44,379850,10124,3537,393511,62.42%,64.66%,
104/04/30,-1156,-19,431,-744,379571,9954,3942,393467,62.37%,64.65%,
104/04/29,-288,0,-12,-300,380727,9973,3511,394211,62.56%,64.78%,
104/04/28,-518,219,-7,-306,381015,9973,3523,394511,62.61%,64.83%,
104/04/27,631,60,-96,595,381523,9754,3530,394807,62.69%,64.87%,
104/04/24,2141,5,-268,1878,380891,9694,3626,394211,62.59%,64.78%,
104/04/23,3000,-203,329,3126,378750,9689,3894,392333,62.24%,64.47%,
104/04/22,-3165,-466,-79,-3710,375761,9892,3565,389218,61.75%,63.96%,
104/04/21,-592,-98,-158,-848,379105,10358,3644,393107,62.30%,64.60%,
104/04/20,-326,19,-67,-374,379687,10456,3802,393945,62.39%,64.73%,
104/04/17,-255,-20,-11,-286,380011,10437,3869,394317,62.44%,64.79%,
104/04/16,-597,92,120,-385,380266,10457,3880,394603,62.49%,64.85%,
104/04/15,-1000,-42,-246,-1288,380863,10365,3760,394988,62.58%,64.90%,
104/04/14,-660,360,-69,-369,381863,10407,4006,396276,62.75%,65.12%,
104/04/13,1094,0,186,1280,382523,10047,4075,396645,62.86%,65.18%,
104/04/10,237,-158,10,89,381439,10047,3889,395375,62.68%,64.97%,
104/04/09,-3091,-309,310,-3090,381198,10205,3879,395282,62.64%,64.95%,
104/04/08,-1907,-105,-191,-2203,384289,10514,3569,398372,63.15%,65.46%,
104/04/07,1103,0,-59,1044,386186,10619,3760,400565,63.46%,65.82%,
104/04/02,576,10,-3,583,385082,10619,3819,399520,63.28%,65.65%,
104/04/01,-158,-60,-107,-325,384506,10609,3822,398937,63.18%,65.55%,
104/03/31,759,-38,188,909,384665,10669,3929,399263,63.21%,65.61%,
104/03/30,-13,-38,200,149,383906,11697,3741,399344,63.08%,65.62%,
104/03/27,-3184,-315,97,-3402,383918,11735,3541,399194,63.09%,65.60%,
104/03/26,-223,-904,-217,-1344,387102,12050,3444,402596,63.61%,66.16%,
104/03/25,-2367,-107,-372,-2846,387591,12954,3661,404206,63.69%,66.42%,
104/03/24,-241,-466,34,-673,389958,13061,4033,407052,64.08%,66.89%,
104/03/23,141,-605,-205,-669,389933,13527,3999,407459,64.07%,66.95%,
104/03/20,391,-452,-145,-206,389792,14132,4204,408128,64.05%,67.06%,
104/03/19,561,-380,167,348,389401,14584,4349,408334,63.99%,67.10%,
104/03/18,654,-682,152,124,388865,14964,4182,408011,63.90%,67.05%,
104/03/17,2474,-593,-631,1250,388591,15646,4030,408267,63.85%,67.08%,
104/03/16,1055,-752,-13,290,386117,16239,4661,407017,63.45%,66.88%,
104/03/13,-167,-279,-124,-570,385062,16991,4674,406727,63.27%,66.83%,
104/03/12,-963,-81,17,-1027,384849,17270,4798,406917,63.24%,66.87%,
104/03/11,-1792,232,-77,-1637,385811,17351,4781,407943,63.40%,67.04%,
104/03/10,-1503,-38,182,-1359,387603,17119,4858,409580,63.69%,67.30%,
104/03/09,-477,-202,-47,-726,389091,17157,4676,410924,63.94%,67.53%,
104/03/06,155,-321,72,-94,389398,17359,4723,411480,63.99%,67.62%,
104/03/05,-67,-157,-88,-312,389244,17680,4651,411575,63.96%,67.63%,
104/03/04,-884,-17,280,-621,389311,17837,4739,411887,63.97%,67.68%,
104/03/03,-420,-492,-110,-1022,390185,17854,4459,412498,64.12%,67.79%,
104/03/02,203,-323,509,389,390605,18346,4569,413520,64.19%,67.96%,
104/02/26,-747,-295,-25,-1067,390401,18669,4059,413129,64.15%,67.89%,
104/02/25,-1869,-120,-73,-2062,391148,18964,4084,414196,64.27%,68.06%,
104/02/24,-1878,-213,-58,-2149,393053,19084,4157,416294,64.59%,68.41%,
104/02/13,666,-101,-57,508,394931,19297,4215,418443,64.90%,68.76%,
104/02/12,382,-753,-125,-496,394259,19398,4272,417929,64.79%,68.68%,
104/02/11,1869,162,81,2112,393847,20151,4397,418395,64.72%,68.75%,
104/02/10,85,-8,-220,-143,391978,19989,4316,416283,64.41%,68.40%,
104/02/09,1238,78,76,1392,391888,19997,4536,416421,64.40%,68.43%,
104/02/06,-3620,-167,-177,-3964,390651,19919,4460,415030,64.19%,68.20%,
104/02/05,-1611,-133,-80,-1824,394271,20086,4637,418994,64.79%,68.85%,
104/02/04,2332,89,-116,2305,395882,20219,4717,420818,65.05%,69.15%,
104/02/03,-302,-597,95,-804,393550,20130,4833,418513,64.67%,68.77%,
104/02/02,-995,-920,47,-1868,393852,20727,4738,419317,64.72%,68.90%,
104/01/30,-2406,-407,79,-2734,394846,21647,4691,421184,64.88%,69.21%,
104/01/29,-2754,-1574,226,-4102,397252,22054,4612,423918,65.28%,69.66%,
104/01/28,97,-521,255,-169,400006,23628,4386,428020,65.73%,70.33%,
104/01/27,-1662,-1332,397,-2597,399909,24149,4131,428189,65.71%,70.36%,
104/01/26,685,-80,-85,520,401805,25481,3734,431020,66.03%,70.83%,
104/01/23,3684,-409,-239,3036,401120,25561,3819,430500,65.91%,70.74%,
104/01/22,2613,-137,-21,2455,397297,25970,4058,427325,65.28%,70.21%,
104/01/21,370,-254,79,195,394599,26107,4079,424785,64.84%,69.80%,
104/01/20,245,58,15,318,394242,26361,4000,424603,64.78%,69.77%,
104/01/19,300,19,65,384,393997,26303,3985,424285,64.74%,69.72%,
104/01/16,487,99,-82,504,393672,26284,3921,423877,64.69%,69.65%,
104/01/15,840,-42,-39,759,393185,26185,4003,423373,64.61%,69.57%,
104/01/14,1218,82,47,1347,392345,26227,4042,422614,64.47%,69.44%,
104/01/13,209,82,-72,219,391128,26145,3995,421268,64.27%,69.22%,
104/01/12,-285,33,-210,-462,390938,26063,4067,421068,64.24%,69.19%,
104/01/09,-547,507,230,190,391248,26030,4277,421555,64.29%,69.27%,
104/01/08,925,45,39,1009,391776,25523,4047,421346,64.38%,69.24%,
104/01/07,432,-195,-229,8,390826,25478,4008,420312,64.22%,69.07%,
104/01/06,-422,-271,-97,-790,390394,25673,4237,420304,64.15%,69.07%,
104/01/05,-1234,-16,-212,-1462,390826,25944,4334,421104,64.22%,69.20%,
