日期,外資買賣超,投信買賣超,自營商買賣超,單日合計買賣超,外資估計持股,投信估計持股,自營商估計持股,單日合計估計持股,外資持股比重,三大法人持股比重,
107/03/31,0,0,0,0,6641,0,41,6682,3.89%,3.91%,
107/03/30,1,0,3,4,6641,0,41,6682,3.89%,3.91%,
107/03/29,1,0,1,2,6640,0,38,6678,3.89%,3.91%,
107/03/28,0,0,0,0,6639,0,37,6676,3.89%,3.91%,
107/03/27,0,0,0,0,6639,0,37,6676,3.89%,3.91%,
107/03/26,0,0,-3,-3,6639,0,37,6676,3.89%,3.91%,
107/03/23,-10,0,0,-10,6639,0,40,6679,3.89%,3.91%,
107/03/22,-7,0,0,-7,6649,0,40,6689,3.89%,3.91%,
107/03/21,-4,0,0,-4,6656,0,40,6696,3.90%,3.92%,
107/03/20,-3,0,0,-3,6660,0,40,6700,3.90%,3.92%,
107/03/19,-4,0,0,-4,6663,0,40,6703,3.90%,3.92%,
107/03/16,1,0,0,1,6667,0,40,6707,3.91%,3.93%,
107/03/15,0,0,0,0,6666,0,40,6706,3.90%,3.92%,
107/03/14,1,0,0,1,6666,0,40,6706,3.90%,3.92%,
107/03/13,14,0,1,15,6665,0,40,6705,3.90%,3.92%,
107/03/12,-9,0,3,-6,6651,0,39,6690,3.90%,3.92%,
107/03/09,0,0,1,1,6660,0,36,6696,3.90%,3.92%,
107/03/08,0,0,0,0,6660,0,35,6695,3.90%,3.92%,
107/03/07,-9,0,0,-9,6661,0,35,6696,3.90%,3.92%,
107/03/06,0,0,0,0,6670,0,35,6705,3.91%,3.93%,
107/03/05,-6,0,0,-6,6670,0,35,6705,3.91%,3.93%,
107/03/02,-2,0,0,-2,6676,0,35,6711,3.91%,3.93%,
107/03/01,-23,0,0,-23,6675,0,35,6710,3.91%,3.93%,
107/02/27,-6,0,0,-6,6698,0,35,6733,3.92%,3.94%,
107/02/26,-181,0,0,-181,6704,0,35,6739,3.93%,3.95%,
107/02/23,-18,0,1,-17,6885,0,35,6920,4.03%,4.05%,
107/02/22,0,0,-1,-1,6903,0,34,6937,4.04%,4.06%,
107/02/21,-4,0,0,-4,6903,0,35,6938,4.04%,4.06%,
107/02/12,-13,0,0,-13,6907,0,35,6942,4.05%,4.07%,
107/02/09,-9,0,0,-9,6916,0,35,6951,4.05%,4.07%,
107/02/08,0,0,1,1,6925,0,35,6960,4.06%,4.08%,
107/02/07,1091,0,-7,1084,6925,0,34,6959,4.06%,4.08%,
107/02/06,-147,0,-1,-148,5831,0,41,5872,3.41%,3.43%,
107/02/05,-3,0,0,-3,5978,0,42,6020,3.50%,3.52%,
107/02/02,-1,0,0,-1,5981,0,42,6023,3.50%,3.52%,
107/02/01,0,0,-1,-1,5982,0,42,6024,3.50%,3.52%,
107/01/31,0,0,0,0,5982,0,43,6025,3.50%,3.53%,
107/01/30,-2,0,3,1,5982,0,43,6025,3.50%,3.53%,
107/01/29,0,0,0,0,5984,0,40,6024,3.50%,3.52%,
107/01/26,0,0,-1,-1,5984,0,40,6024,3.50%,3.52%,
107/01/25,15,0,-2,13,5984,0,41,6025,3.50%,3.52%,
107/01/24,4,0,-1,3,5969,0,43,6012,3.50%,3.53%,
107/01/23,6,0,0,6,5965,0,44,6009,3.49%,3.52%,
107/01/22,-83,0,0,-83,5959,0,44,6003,3.49%,3.52%,
107/01/19,-3,0,0,-3,6042,0,44,6086,3.54%,3.57%,
107/01/18,-12,0,1,-11,6045,0,44,6089,3.54%,3.57%,
107/01/17,23,0,-1,22,6057,0,43,6100,3.55%,3.58%,
107/01/16,8,0,3,11,6034,0,44,6078,3.51%,3.54%,
107/01/15,0,0,0,0,6026,0,41,6067,3.51%,3.53%,
107/01/12,-10,0,1,-9,6026,0,41,6067,3.51%,3.53%,
107/01/11,0,0,0,0,6036,0,40,6076,3.51%,3.53%,
107/01/10,-30,0,-1,-31,6036,0,40,6076,3.51%,3.53%,
107/01/09,-1,0,1,0,6066,0,41,6107,3.53%,3.55%,
107/01/08,-4,0,-1,-5,6067,0,40,6107,3.53%,3.55%,
107/01/05,-1,0,0,-1,6071,0,41,6112,3.53%,3.55%,
107/01/04,0,0,0,0,6072,0,41,6113,3.53%,3.55%,
107/01/03,0,0,0,0,6072,0,41,6113,3.53%,3.55%,
107/01/02,0,0,5,5,6072,0,41,6113,3.53%,3.55%,
106/12/29,10,0,0,10,6072,0,36,6108,3.53%,3.55%,
106/12/28,1,0,0,1,6062,0,36,6098,3.53%,3.55%,
106/12/27,0,0,0,0,6061,0,36,6097,3.53%,3.55%,
106/12/26,0,0,0,0,6061,0,36,6097,3.53%,3.55%,
106/12/25,0,0,0,0,6061,0,36,6097,3.53%,3.55%,
106/12/22,0,0,0,0,6061,0,36,6097,3.53%,3.55%,
106/12/21,0,0,1,1,6061,0,36,6097,3.53%,3.55%,
106/12/20,0,0,1,1,6061,0,35,6096,3.53%,3.55%,
106/12/19,0,0,-1,-1,6061,0,34,6095,3.53%,3.55%,
106/12/18,-3,0,-1,-4,6061,0,35,6096,3.53%,3.55%,
106/12/15,-2,0,1,-1,6064,0,36,6100,3.53%,3.55%,
106/12/14,0,0,0,0,6066,0,35,6101,3.53%,3.55%,
106/12/13,-7,0,-2,-9,6066,0,35,6101,3.53%,3.55%,
106/12/12,0,0,2,2,6073,0,37,6110,3.54%,3.56%,
106/12/11,-3,0,-1,-4,6073,0,35,6108,3.54%,3.56%,
106/12/08,-33,0,0,-33,6076,0,36,6112,3.54%,3.56%,
106/12/07,67,0,-1,66,6109,0,36,6145,3.56%,3.58%,
106/12/06,-6,0,0,-6,6042,0,37,6079,3.52%,3.54%,
106/12/05,340,0,0,340,6048,0,37,6085,3.52%,3.54%,
106/12/04,-1,0,1,0,5708,0,37,5745,3.32%,3.34%,
106/12/01,-4,0,1,-3,5709,0,36,5745,3.32%,3.34%,
106/11/30,0,0,0,0,5713,0,35,5748,3.33%,3.35%,
106/11/29,-7,0,0,-7,5713,0,35,5748,3.33%,3.35%,
106/11/28,-45,0,1,-44,5720,0,35,5755,3.33%,3.35%,
106/11/27,-7,0,0,-7,5765,0,34,5799,3.36%,3.38%,
106/11/24,-3,0,-2,-5,5772,0,34,5806,3.36%,3.38%,
106/11/23,7,0,0,7,5775,0,36,5811,3.36%,3.38%,
106/11/22,9,0,0,9,5768,0,36,5804,3.36%,3.38%,
106/11/21,11,0,0,11,5759,0,36,5795,3.35%,3.37%,
106/11/20,206,0,1,207,5748,0,36,5784,3.35%,3.37%,
106/11/17,-2,0,0,-2,5542,0,35,5577,3.23%,3.25%,
106/11/16,-1,0,0,-1,5544,0,35,5579,3.23%,3.25%,
106/11/15,5,0,0,5,5545,0,35,5580,3.23%,3.25%,
106/11/14,-4,0,0,-4,5540,0,35,5575,3.22%,3.24%,
106/11/13,0,0,0,0,5544,0,35,5579,3.23%,3.25%,
106/11/10,-4,0,0,-4,5544,0,35,5579,3.23%,3.25%,
106/11/09,-56,0,0,-56,5548,0,35,5583,3.23%,3.25%,
106/11/08,0,0,1,1,5604,0,35,5639,3.26%,3.28%,
106/11/07,-1,0,0,-1,5604,0,34,5638,3.26%,3.28%,
106/11/06,-17,0,0,-17,5605,0,34,5639,3.26%,3.28%,
106/11/03,47,0,0,47,5622,0,34,5656,3.27%,3.29%,
106/11/02,2,0,-1,1,5575,0,34,5609,3.25%,3.27%,
106/11/01,1,0,0,1,5573,0,35,5608,3.24%,3.26%,
106/10/31,0,0,0,0,5572,0,35,5607,3.24%,3.26%,
106/10/30,0,0,0,0,5572,0,35,5607,3.24%,3.26%,
106/10/27,-2,0,0,-2,5572,0,35,5607,3.24%,3.26%,
106/10/26,1,0,-7,-6,5574,0,35,5609,3.24%,3.26%,
106/10/25,-2,0,0,-2,5573,0,42,5615,3.24%,3.26%,
106/10/24,0,0,0,0,5575,0,42,5617,3.25%,3.27%,
106/10/23,0,0,0,0,5575,0,42,5617,3.25%,3.27%,
106/10/20,2,0,0,2,5575,0,42,5617,3.25%,3.27%,
106/10/19,1,0,6,7,5573,0,42,5615,3.24%,3.26%,
106/10/18,1,0,0,1,5572,0,36,5608,3.24%,3.26%,
106/10/17,0,0,0,0,5571,0,36,5607,3.24%,3.26%,
106/10/16,10,0,0,10,5571,0,36,5607,3.24%,3.26%,
106/10/13,0,0,0,0,5561,0,36,5597,3.24%,3.26%,
106/10/12,5,0,0,5,5561,0,36,5597,3.24%,3.26%,
106/10/11,0,0,0,0,5556,0,36,5592,3.23%,3.25%,
106/10/06,0,0,0,0,5556,0,36,5592,3.23%,3.25%,
106/10/05,0,0,0,0,5556,0,36,5592,3.23%,3.25%,
106/10/03,0,0,0,0,5556,0,36,5592,3.23%,3.25%,
106/10/02,-9,0,0,-9,5556,0,36,5592,3.23%,3.25%,
106/09/30,0,0,0,0,5565,0,36,5601,3.24%,3.26%,
106/09/29,0,0,0,0,5565,0,36,5601,3.24%,3.26%,
106/09/28,-2,0,0,-2,5565,0,36,5601,3.24%,3.26%,
106/09/27,2,0,0,2,5567,0,36,5603,3.24%,3.26%,
106/09/26,1,0,0,1,5565,0,36,5601,3.24%,3.26%,
106/09/25,-4,0,0,-4,5564,0,36,5600,3.24%,3.26%,
106/09/22,48,0,-1,47,5568,0,36,5604,3.24%,3.26%,
106/09/21,0,0,0,0,5520,0,37,5557,3.21%,3.23%,
106/09/20,21,0,0,21,5520,0,37,5557,3.21%,3.23%,
106/09/19,33,0,1,34,5499,0,37,5536,3.20%,3.22%,
106/09/18,2,0,0,2,5466,0,36,5502,3.18%,3.20%,
106/09/15,0,0,0,0,5464,0,36,5500,3.18%,3.20%,
106/09/14,0,0,0,0,5464,0,36,5500,3.18%,3.20%,
106/09/13,0,0,2,2,5464,0,36,5500,3.18%,3.20%,
106/09/12,-81,0,0,-81,5464,0,34,5498,3.18%,3.20%,
106/09/11,0,0,0,0,5545,0,34,5579,3.23%,3.25%,
106/09/08,-6,0,0,-6,5545,0,34,5579,3.23%,3.25%,
106/09/07,0,0,-3,-3,5551,0,34,5585,3.23%,3.25%,
106/09/06,20,0,-4,16,5551,0,37,5588,3.23%,3.25%,
106/09/05,16,0,0,16,5531,0,41,5572,3.22%,3.24%,
106/09/04,10,0,0,10,5515,0,41,5556,3.21%,3.23%,
106/09/01,-4,0,0,-4,5505,0,41,5546,3.20%,3.22%,
106/08/31,-47,0,-6,-53,5509,0,41,5550,3.21%,3.23%,
106/08/30,0,0,0,0,5556,0,47,5603,3.23%,3.26%,
106/08/29,0,0,0,0,5556,0,47,5603,3.23%,3.26%,
106/08/28,-4,0,0,-4,5556,0,47,5603,3.23%,3.26%,
106/08/25,0,0,0,0,5560,0,47,5607,3.24%,3.27%,
106/08/24,2,0,-1,1,5560,0,47,5607,3.24%,3.27%,
106/08/23,6,0,0,6,5558,0,48,5606,3.24%,3.27%,
106/08/22,0,0,0,0,5552,0,48,5600,3.23%,3.26%,
106/08/21,0,0,0,0,5552,0,48,5600,3.23%,3.26%,
106/08/18,-2,0,2,0,5552,0,48,5600,3.23%,3.26%,
106/08/17,392,0,0,392,5554,0,46,5600,3.23%,3.26%,
106/08/16,-6,0,0,-6,5162,0,46,5208,3.00%,3.03%,
106/08/15,40,0,0,40,5168,0,46,5214,3.01%,3.04%,
106/08/14,31,0,-3,28,5128,0,46,5174,2.98%,3.01%,
106/08/11,27,0,0,27,5097,0,49,5146,2.97%,3.00%,
106/08/10,-2,0,0,-2,5070,0,49,5119,2.95%,2.98%,
106/08/09,0,0,-1,-1,5072,0,49,5121,2.95%,2.98%,
106/08/08,-1,0,-14,-15,5072,0,50,5122,2.95%,2.98%,
106/08/07,-4,0,15,11,5075,0,64,5139,2.95%,2.99%,
106/08/04,-1,0,0,-1,5079,0,49,5128,2.96%,2.99%,
106/08/03,0,0,0,0,5080,0,49,5129,2.96%,2.99%,
106/08/02,2,0,-1,1,5098,0,49,5147,2.97%,3.00%,
106/08/01,10,0,0,10,5096,0,50,5146,2.97%,3.00%,
106/07/31,11,0,0,11,5086,0,50,5136,2.96%,2.99%,
106/07/28,12,0,0,12,5075,0,50,5125,2.95%,2.98%,
106/07/27,13,0,1,14,5063,0,50,5113,2.95%,2.98%,
106/07/26,13,0,0,13,5050,0,49,5099,2.94%,2.97%,
106/07/25,12,0,0,12,5037,0,49,5086,2.93%,2.96%,
106/07/24,13,0,0,13,5025,0,49,5074,2.92%,2.95%,
106/07/21,11,0,0,11,5012,0,49,5061,2.92%,2.95%,
106/07/20,13,0,0,13,5001,0,49,5050,2.91%,2.94%,
106/07/19,14,0,-2,12,4988,0,49,5037,2.90%,2.93%,
106/07/18,14,0,0,14,4974,0,51,5025,2.89%,2.92%,
106/07/17,5,0,0,5,4960,0,51,5011,2.89%,2.92%,
106/07/14,8,0,0,8,4955,0,51,5006,2.88%,2.91%,
106/07/13,10,0,-10,0,4947,0,51,4998,2.88%,2.91%,
106/07/12,7,0,-5,2,4937,0,61,4998,2.87%,2.91%,
106/07/11,73,0,2,75,4930,0,66,4996,2.87%,2.91%,
106/07/10,6,0,0,6,4857,0,64,4921,2.83%,2.87%,
106/07/07,17,0,0,17,4851,0,64,4915,2.82%,2.86%,
106/07/06,2,0,0,2,4834,0,64,4898,2.81%,2.85%,
106/07/05,-3,0,-1,-4,4832,0,64,4896,2.81%,2.85%,
106/07/04,2,0,0,2,4835,0,65,4900,2.81%,2.85%,
106/07/03,14,0,-2,12,4833,0,65,4898,2.81%,2.85%,
106/06/30,0,0,0,0,4819,0,67,4886,2.80%,2.84%,
106/06/29,-8,0,-1,-9,4819,0,67,4886,2.80%,2.84%,
106/06/28,24,0,0,24,4827,0,68,4895,2.81%,2.85%,
106/06/27,1,0,2,3,4803,0,68,4871,2.80%,2.84%,
106/06/26,-6,0,10,4,4802,0,66,4868,2.79%,2.83%,
106/06/23,-7,0,0,-7,4808,0,56,4864,2.80%,2.83%,
106/06/22,0,0,3,3,4815,0,56,4871,2.80%,2.83%,
106/06/21,16,0,-1,15,4815,0,53,4868,2.80%,2.83%,
106/06/20,5,0,1,6,4799,0,54,4853,2.79%,2.82%,
106/06/19,8,0,3,11,4794,0,53,4847,2.79%,2.82%,
106/06/16,6,0,0,6,4786,0,50,4836,2.79%,2.82%,
106/06/15,2,0,-1,1,4780,0,50,4830,2.78%,2.81%,
106/06/14,4,0,0,4,4778,0,51,4829,2.78%,2.81%,
106/06/13,4,0,0,4,4774,0,51,4825,2.78%,2.81%,
106/06/12,4,0,0,4,4770,0,51,4821,2.78%,2.81%,
106/06/09,-5,0,-1,-6,4766,0,51,4817,2.77%,2.80%,
106/06/08,1,0,0,1,4771,0,52,4823,2.78%,2.81%,
106/06/07,7,0,0,7,4770,0,52,4822,2.78%,2.81%,
106/06/06,10,0,0,10,4763,0,52,4815,2.77%,2.80%,
106/06/05,15,0,0,15,4753,0,52,4805,2.77%,2.80%,
106/06/03,0,0,0,0,4738,0,52,4790,2.76%,2.79%,
106/06/02,11,0,0,11,4738,0,52,4790,2.76%,2.79%,
106/06/01,7,0,0,7,4727,0,52,4779,2.75%,2.78%,
106/05/31,3,0,1,4,4720,0,52,4772,2.75%,2.78%,
106/05/26,4,0,0,4,4717,0,51,4768,2.74%,2.77%,
106/05/25,13,0,0,13,4713,0,51,4764,2.74%,2.77%,
106/05/24,17,0,1,18,4700,0,51,4751,2.74%,2.77%,
106/05/23,9,0,0,9,4683,0,50,4733,2.73%,2.76%,
106/05/22,-5,0,0,-5,4674,0,50,4724,2.72%,2.75%,
106/05/19,0,0,0,0,4679,0,50,4729,2.72%,2.75%,
106/05/18,-10,0,-1,-11,4679,0,50,4729,2.72%,2.75%,
106/05/17,-4,0,0,-4,4689,0,51,4740,2.73%,2.76%,
106/05/16,-48,0,0,-48,4693,0,51,4744,2.73%,2.76%,
106/05/15,-9,0,0,-9,4740,0,51,4791,2.76%,2.79%,
106/05/12,-9,0,1,-8,4749,0,51,4800,2.76%,2.79%,
106/05/11,-14,0,2,-12,4758,0,50,4808,2.77%,2.80%,
106/05/10,-7,0,0,-7,4772,0,48,4820,2.78%,2.81%,
106/05/09,-39,0,0,-39,4779,0,48,4827,2.78%,2.81%,
106/05/08,-17,0,0,-17,4804,0,48,4852,2.80%,2.83%,
106/05/05,-2,0,0,-2,4821,0,48,4869,2.81%,2.84%,
106/05/04,0,0,0,0,4823,0,48,4871,2.81%,2.84%,
106/05/03,-36,0,-4,-40,4823,0,48,4871,2.81%,2.84%,
106/05/02,-12,0,0,-12,4859,0,52,4911,2.83%,2.86%,
106/04/28,-8,0,1,-7,4871,0,52,4923,2.84%,2.87%,
106/04/27,-30,0,0,-30,4879,0,51,4930,2.84%,2.87%,
106/04/26,-11,0,0,-11,4909,0,51,4960,2.86%,2.89%,
106/04/25,-7,0,2,-5,4920,0,51,4971,2.86%,2.89%,
106/04/24,-37,0,0,-37,4927,0,49,4976,2.87%,2.90%,
106/04/21,-18,0,0,-18,4964,0,49,5013,2.89%,2.92%,
106/04/20,-57,0,0,-57,4982,0,49,5031,2.90%,2.93%,
106/04/19,-108,0,0,-108,5039,0,49,5088,2.93%,2.96%,
106/04/18,-6,0,0,-6,5147,0,49,5196,3.00%,3.03%,
106/04/17,-69,0,0,-69,5153,0,49,5202,3.00%,3.03%,
106/04/14,-63,0,0,-63,5222,0,49,5271,3.04%,3.07%,
106/04/13,6,0,0,6,5285,0,49,5334,3.08%,3.11%,
106/04/12,-23,0,0,-23,5279,0,49,5328,3.07%,3.10%,
106/04/11,-38,0,0,-38,5302,0,49,5351,3.09%,3.12%,
106/04/10,-23,0,0,-23,5340,0,49,5389,3.11%,3.14%,
106/04/07,-64,0,-3,-67,5363,0,49,5412,3.12%,3.15%,
106/04/06,3,0,0,3,5427,0,52,5479,3.16%,3.19%,
106/04/05,-4,0,0,-4,5424,0,52,5476,3.16%,3.19%,
106/03/31,-2,0,0,-2,5425,0,52,5477,3.16%,3.19%,
106/03/30,-22,0,0,-22,5427,0,52,5479,3.16%,3.19%,
106/03/29,-27,0,0,-27,5449,0,52,5501,3.17%,3.20%,
106/03/28,-149,0,0,-149,5476,0,52,5528,3.19%,3.22%,
106/03/27,-70,0,0,-70,5645,0,52,5697,3.29%,3.32%,
106/03/24,-84,0,0,-84,5715,0,52,5767,3.33%,3.36%,
106/03/23,9,0,0,9,5799,0,52,5851,3.38%,3.41%,
106/03/22,-9,0,0,-9,5790,0,52,5842,3.37%,3.40%,
106/03/21,24,0,0,24,5799,0,52,5851,3.38%,3.41%,
106/03/20,16,0,0,16,5775,0,52,5827,3.36%,3.39%,
106/03/17,39,0,0,39,5759,0,52,5811,3.35%,3.38%,
106/03/16,7,0,0,7,5720,0,52,5772,3.33%,3.36%,
106/03/15,-6,0,0,-6,5713,0,52,5765,3.33%,3.36%,
106/03/14,-2,0,0,-2,5704,0,52,5756,3.32%,3.35%,
106/03/13,-10,0,0,-10,5706,0,52,5758,3.32%,3.35%,
106/03/10,-7,0,0,-7,5716,0,52,5768,3.33%,3.36%,
106/03/09,-4,0,0,-4,5723,0,52,5775,3.33%,3.36%,
106/03/08,38,0,0,38,5727,0,52,5779,3.33%,3.36%,
106/03/07,46,0,0,46,5689,0,52,5741,3.31%,3.34%,
106/03/06,7,0,0,7,5643,0,52,5695,3.29%,3.32%,
106/03/03,37,0,0,37,5636,0,52,5688,3.28%,3.31%,
106/03/02,0,0,0,0,5599,0,52,5651,3.26%,3.29%,
106/03/01,18,0,0,18,5599,0,52,5651,3.26%,3.29%,
106/02/24,16,0,0,16,5581,0,52,5633,3.25%,3.28%,
106/02/23,58,0,0,58,5565,0,52,5617,3.24%,3.27%,
106/02/22,53,0,0,53,5507,0,52,5559,3.21%,3.24%,
106/02/21,34,0,0,34,5454,0,52,5506,3.17%,3.20%,
106/02/20,11,0,0,11,5420,0,52,5472,3.16%,3.19%,
106/02/18,0,0,0,0,5409,0,52,5461,3.15%,3.18%,
106/02/17,41,0,0,41,5409,0,52,5461,3.15%,3.18%,
106/02/16,19,0,0,19,5368,0,52,5420,3.12%,3.15%,
106/02/15,40,0,0,40,5599,0,52,5651,3.26%,3.29%,
106/02/14,-2,0,0,-2,5539,0,52,5591,3.22%,3.25%,
106/02/13,-7,0,0,-7,5541,0,52,5593,3.23%,3.26%,
106/02/10,-40,0,0,-40,5548,0,52,5600,3.23%,3.26%,
106/02/09,-7,0,2,-5,5588,0,52,5640,3.25%,3.28%,
106/02/08,2,0,0,2,5595,0,50,5645,3.26%,3.29%,
106/02/07,3,0,0,3,5593,0,50,5643,3.26%,3.29%,
106/02/06,5,0,0,5,5590,0,50,5640,3.25%,3.28%,
106/02/03,-48,0,0,-48,5585,0,50,5635,3.25%,3.28%,
106/02/02,-8,0,0,-8,5633,0,50,5683,3.28%,3.31%,
106/01/24,8,0,0,8,5641,0,50,5691,3.28%,3.31%,
106/01/23,3,0,0,3,5633,0,50,5683,3.28%,3.31%,
106/01/20,-10,0,0,-10,5630,0,50,5680,3.28%,3.31%,
106/01/19,-33,0,0,-33,5640,0,50,5690,3.28%,3.31%,
106/01/18,13,0,1,14,5673,0,50,5723,3.30%,3.33%,
106/01/17,-14,0,0,-14,5660,0,49,5709,3.30%,3.33%,
106/01/16,-10,0,0,-10,5674,0,49,5723,3.30%,3.33%,
106/01/13,0,0,0,0,5684,0,49,5733,3.31%,3.34%,
106/01/12,15,0,0,15,5684,0,49,5733,3.31%,3.34%,
106/01/11,2,0,0,2,5669,0,49,5718,3.30%,3.33%,
106/01/10,14,0,0,14,5667,0,49,5716,3.30%,3.33%,
106/01/09,9,0,0,9,5653,0,49,5702,3.29%,3.32%,
106/01/06,41,0,0,41,5644,0,49,5693,3.29%,3.32%,
106/01/05,21,0,0,21,5603,0,49,5652,3.26%,3.29%,
106/01/04,27,0,0,27,5332,0,49,5381,3.10%,3.13%,
106/01/03,4,0,0,4,5285,0,49,5334,3.08%,3.11%,
105/12/30,0,0,0,0,5281,0,49,5330,3.07%,3.10%,
105/12/29,18,0,0,18,5281,0,49,5330,3.07%,3.10%,
105/12/28,5,0,0,5,5263,0,49,5312,3.06%,3.09%,
105/12/27,-112,0,0,-112,5258,0,49,5307,3.06%,3.09%,
105/12/26,-129,0,0,-129,5370,0,49,5419,3.13%,3.16%,
105/12/23,-6,0,-5,-11,5499,0,49,5548,3.20%,3.23%,
105/12/22,-14,0,0,-14,5505,0,54,5559,3.20%,3.23%,
105/12/21,-50,0,4,-46,5519,0,54,5573,3.21%,3.24%,
105/12/20,30,0,0,30,5569,0,50,5619,3.24%,3.27%,
105/12/19,3,0,0,3,5539,0,50,5589,3.22%,3.25%,
105/12/16,36,0,1,37,5536,0,50,5586,3.22%,3.25%,
105/12/15,20,0,0,20,5500,0,49,5549,3.20%,3.23%,
105/12/14,18,0,0,18,5480,0,49,5529,3.19%,3.22%,
105/12/13,8,0,0,8,5462,0,49,5511,3.18%,3.21%,
105/12/12,5,0,0,5,5455,0,49,5504,3.18%,3.21%,
105/12/09,11,0,0,11,5450,0,49,5499,3.17%,3.20%,
105/12/08,-26,0,0,-26,5439,0,49,5488,3.17%,3.20%,
105/12/07,13,0,0,13,5465,0,49,5514,3.18%,3.21%,
105/12/06,-48,0,0,-48,5452,0,49,5501,3.17%,3.20%,
105/12/05,17,0,-1,16,5500,0,49,5549,3.20%,3.23%,
105/12/02,13,0,0,13,5483,0,50,5533,3.19%,3.22%,
105/12/01,16,0,0,16,5470,0,50,5520,3.18%,3.21%,
105/11/30,23,0,0,23,5454,0,50,5504,3.17%,3.20%,
105/11/29,7,0,0,7,5431,0,50,5481,3.16%,3.19%,
105/11/28,21,0,0,21,5424,0,50,5474,3.16%,3.19%,
105/11/25,-20,0,0,-20,5403,0,50,5453,3.14%,3.17%,
105/11/24,3,0,0,3,5423,0,50,5473,3.16%,3.19%,
105/11/23,30,0,-2,28,5420,0,50,5470,3.15%,3.18%,
105/11/22,52,0,0,52,5390,0,52,5442,3.14%,3.17%,
105/11/21,12,0,0,12,5338,0,52,5390,3.11%,3.14%,
105/11/18,5,0,0,5,5326,0,52,5378,3.10%,3.13%,
105/11/17,-3,0,0,-3,5321,0,52,5373,3.10%,3.13%,
105/11/16,-1,0,1,0,5324,0,52,5376,3.10%,3.13%,
105/11/15,-44,0,2,-42,5325,0,51,5376,3.10%,3.13%,
105/11/14,-1,0,0,-1,5369,0,49,5418,3.13%,3.16%,
105/11/11,3,0,0,3,5370,0,49,5419,3.13%,3.16%,
105/11/10,4,0,0,4,5367,0,49,5416,3.12%,3.15%,
105/11/09,-37,0,-1,-38,5363,0,49,5412,3.12%,3.15%,
105/11/08,7,0,0,7,5400,0,50,5450,3.14%,3.17%,
105/11/07,10,0,0,10,5393,0,50,5443,3.14%,3.17%,
105/11/04,-3,0,0,-3,5383,0,50,5433,3.13%,3.16%,
105/11/03,41,0,1,42,5386,0,50,5436,3.13%,3.16%,
105/11/02,0,0,0,0,5345,0,49,5394,3.11%,3.14%,
105/11/01,-5,0,0,-5,5345,0,49,5394,3.11%,3.14%,
105/10/31,-1,0,0,-1,5350,0,49,5399,3.11%,3.14%,
105/10/28,-5,0,0,-5,5351,0,49,5400,3.11%,3.14%,
105/10/27,-4,0,0,-4,5356,0,49,5405,3.12%,3.15%,
105/10/26,-1,0,0,-1,5360,0,49,5409,3.12%,3.15%,
105/10/25,-2,0,0,-2,5361,0,49,5410,3.12%,3.15%,
105/10/24,3,0,-1,2,5363,0,49,5412,3.12%,3.15%,
105/10/21,-8,0,0,-8,5360,0,50,5410,3.12%,3.15%,
105/10/20,14,0,1,15,5368,0,50,5418,3.12%,3.15%,
105/10/19,21,0,0,21,5354,0,49,5403,3.12%,3.15%,
105/10/18,0,0,0,0,5333,0,49,5382,3.10%,3.13%,
105/10/17,-1,0,0,-1,5333,0,49,5382,3.10%,3.13%,
105/10/14,-81,0,0,-81,5334,0,49,5383,3.10%,3.13%,
105/10/13,-63,0,0,-63,5415,0,49,5464,3.15%,3.18%,
105/10/12,7,0,0,7,5478,0,49,5527,3.19%,3.22%,
105/10/11,17,0,0,17,5471,0,49,5520,3.18%,3.21%,
105/10/07,0,0,0,0,5454,0,49,5503,3.17%,3.20%,
105/10/06,6,0,0,6,5454,0,49,5503,3.17%,3.20%,
105/10/05,-2,0,0,-2,5448,0,49,5497,3.17%,3.20%,
105/10/04,-7,0,0,-7,5450,0,49,5499,3.17%,3.20%,
105/10/03,-10,0,0,-10,5457,0,49,5506,3.18%,3.21%,
105/09/30,3,0,-2,1,5467,0,49,5516,3.18%,3.21%,
105/09/29,6,0,0,6,5464,0,51,5515,3.18%,3.21%,
105/09/26,0,0,0,0,5458,0,51,5509,3.18%,3.21%,
105/09/23,-15,0,0,-15,5458,0,51,5509,3.18%,3.21%,
105/09/22,-24,0,0,-24,5473,0,51,5524,3.19%,3.22%,
105/09/21,45,0,2,47,5497,0,51,5548,3.20%,3.23%,
105/09/20,-2,0,0,-2,5452,0,49,5501,3.17%,3.20%,
105/09/19,-1,0,0,-1,5454,0,49,5503,3.17%,3.20%,
105/09/14,-2,0,0,-2,5455,0,49,5504,3.18%,3.21%,
105/09/13,-7,0,0,-7,5457,0,49,5506,3.18%,3.21%,
105/09/12,2,0,0,2,5464,0,49,5513,3.18%,3.21%,
105/09/10,0,0,0,0,5462,0,49,5511,3.18%,3.21%,
105/09/09,14,0,0,14,5462,0,49,5511,3.18%,3.21%,
105/09/08,0,0,0,0,5448,0,49,5497,3.17%,3.20%,
105/09/07,-10,0,0,-10,5448,0,49,5497,3.17%,3.20%,
105/09/06,-16,0,0,-16,5458,0,49,5507,3.18%,3.21%,
105/09/05,0,0,0,0,5474,0,49,5523,3.19%,3.22%,
105/09/02,1,0,0,1,5474,0,49,5523,3.19%,3.22%,
105/09/01,-4,0,0,-4,5473,0,49,5522,3.19%,3.22%,
105/08/31,-1,0,0,-1,5477,0,49,5526,3.19%,3.22%,
105/08/30,-1,0,0,-1,5478,0,49,5527,3.19%,3.22%,
105/08/29,-8,0,0,-8,5479,0,49,5528,3.19%,3.22%,
105/08/26,7,0,0,7,5487,0,49,5536,3.19%,3.22%,
105/08/25,3,0,0,3,5480,0,49,5529,3.19%,3.22%,
105/08/24,-2,0,0,-2,5477,0,49,5526,3.19%,3.22%,
105/08/23,0,0,0,0,5479,0,49,5528,3.19%,3.22%,
105/08/22,-7,0,0,-7,5479,0,49,5528,3.19%,3.22%,
105/08/19,-7,0,0,-7,5486,0,49,5535,3.19%,3.22%,
105/08/18,0,0,0,0,5493,0,49,5542,3.20%,3.23%,
105/08/17,23,0,0,23,5493,0,49,5542,3.20%,3.23%,
105/08/16,0,0,0,0,5470,0,49,5519,3.18%,3.21%,
105/08/15,0,0,0,0,5470,0,49,5519,3.18%,3.21%,
105/08/12,1,0,0,1,5470,0,49,5519,3.18%,3.21%,
105/08/11,-3,0,-2,-5,5469,0,49,5518,3.18%,3.21%,
105/08/10,0,0,0,0,5472,0,51,5523,3.19%,3.22%,
105/08/09,2,0,0,2,5472,0,51,5523,3.19%,3.22%,
105/08/08,-2,0,0,-2,5470,0,51,5521,3.18%,3.21%,
105/08/05,0,0,0,0,5472,0,51,5523,3.19%,3.22%,
105/08/04,-2,0,-1,-3,5472,0,51,5523,3.19%,3.22%,
105/08/03,8,0,0,8,5474,0,52,5526,3.19%,3.22%,
105/08/02,-14,0,0,-14,5466,0,52,5518,3.18%,3.21%,
105/08/01,0,0,0,0,5480,0,52,5532,3.19%,3.22%,
105/07/29,5,0,0,5,5480,0,52,5532,3.19%,3.22%,
105/07/28,5,0,0,5,5475,0,52,5527,3.19%,3.22%,
105/07/27,2,0,0,2,5470,0,52,5522,3.18%,3.21%,
105/07/26,-34,0,0,-34,5468,0,52,5520,3.18%,3.21%,
105/07/25,-2,0,3,1,5502,0,52,5554,3.20%,3.23%,
105/07/22,2,0,0,2,5504,0,49,5553,3.20%,3.23%,
105/07/21,2,0,8,10,5502,0,49,5551,3.20%,3.23%,
105/07/20,3,0,3,6,5500,0,41,5541,3.20%,3.22%,
105/07/19,4,0,0,4,5497,0,38,5535,3.20%,3.22%,
105/07/18,2,0,0,2,5493,0,38,5531,3.20%,3.22%,
105/07/15,2,0,0,2,5491,0,38,5529,3.20%,3.22%,
105/07/14,0,0,0,0,5489,0,38,5527,3.20%,3.22%,
105/07/13,1,0,0,1,5489,0,38,5527,3.20%,3.22%,
105/07/12,0,0,0,0,5488,0,38,5526,3.19%,3.21%,
105/07/11,0,0,0,0,5488,0,38,5526,3.19%,3.21%,
105/07/07,3,0,0,3,5488,0,38,5526,3.19%,3.21%,
105/07/06,0,0,0,0,5485,0,38,5523,3.19%,3.21%,
105/07/05,0,0,0,0,5485,0,38,5523,3.19%,3.21%,
105/07/04,-9,0,0,-9,5485,0,38,5523,3.19%,3.21%,
105/07/01,-9,0,0,-9,5494,0,38,5532,3.20%,3.22%,
105/06/30,-7,0,-1,-8,5503,0,38,5541,3.20%,3.22%,
105/06/29,0,0,0,0,5510,0,39,5549,3.21%,3.23%,
105/06/28,0,0,0,0,5510,0,39,5549,3.21%,3.23%,
105/06/27,-1,0,0,-1,5510,0,39,5549,3.21%,3.23%,
105/06/24,1,0,-3,-2,5511,0,39,5550,3.21%,3.23%,
105/06/23,0,0,0,0,5510,0,42,5552,3.21%,3.23%,
105/06/22,2,0,0,2,5510,0,42,5552,3.21%,3.23%,
105/06/21,2,0,0,2,5508,0,42,5550,3.21%,3.23%,
105/06/20,-7,0,6,-1,5506,0,42,5548,3.20%,3.22%,
105/06/17,-27,0,1,-26,5513,0,36,5549,3.21%,3.23%,
105/06/16,-14,0,0,-14,5540,0,35,5575,3.22%,3.24%,
105/06/15,-74,0,6,-68,5554,0,35,5589,3.23%,3.25%,
105/06/14,0,0,0,0,5628,0,29,5657,3.28%,3.30%,
105/06/13,0,0,0,0,5628,0,29,5657,3.28%,3.30%,
105/06/08,-9,0,1,-8,5628,0,29,5657,3.28%,3.30%,
105/06/07,-10,0,8,-2,5637,0,28,5665,3.28%,3.30%,
105/06/06,2,0,0,2,5647,0,20,5667,3.29%,3.30%,
105/06/04,0,0,0,0,5645,0,20,5665,3.29%,3.30%,
105/06/03,5,0,0,5,5645,0,20,5665,3.29%,3.30%,
105/06/02,-17,0,0,-17,5640,0,20,5660,3.28%,3.29%,
105/06/01,-1,0,0,-1,5657,0,20,5677,3.29%,3.30%,
105/05/31,3,0,0,3,5658,0,20,5678,3.29%,3.30%,
105/05/30,0,0,0,0,5650,0,20,5670,3.29%,3.30%,
105/05/27,4,0,0,4,5650,0,20,5670,3.29%,3.30%,
105/05/26,4,0,0,4,5646,0,20,5666,3.29%,3.30%,
105/05/25,-1,0,0,-1,5642,0,20,5662,3.28%,3.29%,
105/05/24,-4,0,0,-4,5643,0,20,5663,3.28%,3.29%,
105/05/23,14,0,0,14,5647,0,20,5667,3.29%,3.30%,
105/05/20,6,0,0,6,5633,0,20,5653,3.28%,3.29%,
105/05/19,0,0,0,0,5627,0,20,5647,3.28%,3.29%,
105/05/18,4,0,0,4,5627,0,20,5647,3.28%,3.29%,
105/05/17,18,0,0,18,5623,0,20,5643,3.27%,3.28%,
105/05/16,0,0,0,0,5605,0,20,5625,3.26%,3.27%,
105/05/13,0,0,0,0,5605,0,20,5625,3.26%,3.27%,
105/05/12,0,0,0,0,5605,0,20,5625,3.26%,3.27%,
105/05/11,-4,0,0,-4,5605,0,20,5625,3.26%,3.27%,
105/05/10,0,0,1,1,5609,0,20,5629,3.27%,3.28%,
105/05/09,-1,0,0,-1,5609,0,19,5628,3.27%,3.28%,
105/05/06,0,0,0,0,5610,0,19,5629,3.27%,3.28%,
105/05/05,0,0,0,0,5610,0,19,5629,3.27%,3.28%,
105/05/04,0,0,0,0,5610,0,19,5629,3.27%,3.28%,
105/05/03,-13,0,-2,-15,5610,0,19,5629,3.27%,3.28%,
105/04/29,11,0,4,15,5623,0,21,5644,3.27%,3.28%,
105/04/28,0,0,-7,-7,5612,0,17,5629,3.27%,3.28%,
105/04/27,-3,0,5,2,5612,0,24,5636,3.27%,3.28%,
105/04/26,2,0,12,14,5615,0,19,5634,3.27%,3.28%,
105/04/25,0,0,7,7,5613,0,7,5620,3.27%,3.27%,
105/04/22,0,0,-3,-3,5613,0,0,5613,3.27%,3.27%,
105/04/21,5,0,-14,-9,5613,0,0,5613,3.27%,3.27%,
105/04/20,-12,0,-25,-37,5608,0,0,5608,3.26%,3.26%,
105/04/19,0,0,-5,-5,5620,0,25,5645,3.27%,3.28%,
105/04/18,11,0,0,11,5620,0,30,5650,3.27%,3.29%,
105/04/15,1,0,0,1,5609,0,30,5639,3.27%,3.29%,
105/04/14,7,0,-1,6,5608,0,30,5638,3.26%,3.28%,
105/04/13,0,0,0,0,5601,0,31,5632,3.26%,3.28%,
105/04/12,-6,0,-1,-7,5601,0,31,5632,3.26%,3.28%,
105/04/11,-12,0,0,-12,5607,0,32,5639,3.26%,3.28%,
105/04/08,-3,0,0,-3,5619,0,32,5651,3.27%,3.29%,
105/04/07,-6,0,-1,-7,5622,0,32,5654,3.27%,3.29%,
105/04/06,6,0,-3,3,5628,0,33,5661,3.28%,3.30%,
105/04/01,7,0,-1,6,5622,0,36,5658,3.27%,3.29%,
105/03/31,4,0,1,5,5615,0,37,5652,3.27%,3.29%,
105/03/30,-3,0,0,-3,5611,0,36,5647,3.27%,3.29%,
105/03/29,-2,0,0,-2,5614,0,36,5650,3.27%,3.29%,
105/03/28,-4,0,4,0,5616,0,36,5652,3.27%,3.29%,
105/03/25,-5,0,2,-3,5620,0,32,5652,3.27%,3.29%,
105/03/24,-9,0,0,-9,5625,0,30,5655,3.27%,3.29%,
105/03/23,0,0,1,1,5634,0,30,5664,3.28%,3.30%,
105/03/22,0,0,0,0,5634,0,29,5663,3.28%,3.30%,
105/03/21,1,0,1,2,5634,0,29,5663,3.28%,3.30%,
105/03/18,0,0,0,0,5633,0,28,5661,3.28%,3.30%,
105/03/17,-62,0,0,-62,5633,0,28,5661,3.28%,3.30%,
105/03/16,40,0,9,49,5695,0,28,5723,3.32%,3.34%,
105/03/15,-98,0,10,-88,5655,0,19,5674,3.29%,3.30%,
105/03/14,-28,0,-1,-29,5753,0,9,5762,3.35%,3.36%,
105/03/11,69,0,-1,68,5781,0,10,5791,3.37%,3.38%,
105/03/10,10,0,-1,9,5712,0,11,5723,3.33%,3.34%,
105/03/09,2,0,-4,-2,5702,0,12,5714,3.32%,3.33%,
105/03/08,-11,0,-5,-16,5700,0,16,5716,3.32%,3.33%,
105/03/07,-7,0,0,-7,5711,0,21,5732,3.32%,3.33%,
105/03/04,17,0,-5,12,5718,0,21,5739,3.33%,3.34%,
105/03/03,-15,0,0,-15,5701,0,26,5727,3.32%,3.34%,
105/03/02,-26,0,0,-26,5716,0,26,5742,3.33%,3.35%,
105/03/01,0,0,-2,-2,5742,0,26,5768,3.34%,3.36%,
105/02/26,-20,0,-2,-22,5742,0,28,5770,3.34%,3.36%,
105/02/25,-45,0,0,-45,5762,0,30,5792,3.35%,3.37%,
105/02/24,29,0,-6,23,5807,0,30,5837,3.38%,3.40%,
105/02/23,97,0,-3,94,5778,0,36,5814,3.36%,3.38%,
105/02/22,0,0,1,1,5681,0,39,5720,3.31%,3.33%,
105/02/19,0,0,1,1,5681,0,38,5719,3.31%,3.33%,
105/02/18,0,0,0,0,5681,0,37,5718,3.31%,3.33%,
105/02/17,2,0,10,12,5681,0,37,5718,3.31%,3.33%,
105/02/16,0,0,12,12,5679,0,27,5706,3.31%,3.33%,
105/02/15,-8,0,-1,-9,5679,0,15,5694,3.31%,3.32%,
105/02/03,94,0,-2,92,5687,0,16,5703,3.31%,3.32%,
105/02/02,8,0,0,8,5593,0,18,5611,3.26%,3.27%,
105/02/01,-4,0,0,-4,5585,0,18,5603,3.25%,3.26%,
105/01/30,0,0,1,1,5589,0,18,5607,3.25%,3.26%,
105/01/29,4,0,3,7,5589,0,17,5606,3.25%,3.26%,
105/01/28,5,0,0,5,5585,0,14,5599,3.25%,3.26%,
105/01/27,115,0,-2,113,5580,0,14,5594,3.25%,3.26%,
105/01/26,0,0,-2,-2,5465,0,16,5481,3.18%,3.19%,
105/01/25,0,0,0,0,5465,0,18,5483,3.18%,3.19%,
105/01/22,0,0,1,1,5465,0,18,5483,3.18%,3.19%,
105/01/21,0,0,0,0,5465,0,17,5482,3.18%,3.19%,
105/01/20,0,0,0,0,5465,0,17,5482,3.18%,3.19%,
105/01/19,-1,0,-4,-5,5465,0,17,5482,3.18%,3.19%,
105/01/18,10,0,-1,9,5466,0,21,5487,3.18%,3.19%,
105/01/15,-1,0,1,0,5456,0,22,5478,3.18%,3.19%,
105/01/14,1,0,0,1,5457,0,21,5478,3.18%,3.19%,
105/01/13,0,0,2,2,5456,0,21,5477,3.18%,3.19%,
105/01/12,0,0,-2,-2,5456,0,19,5475,3.18%,3.19%,
105/01/11,-8,0,3,-5,5456,0,21,5477,3.18%,3.19%,
105/01/08,8,0,-7,1,5464,0,18,5482,3.18%,3.19%,
105/01/07,0,0,0,0,5456,0,25,5481,3.18%,3.19%,
105/01/06,-13,0,3,-10,5456,0,25,5481,3.18%,3.19%,
105/01/05,-3,0,0,-3,5469,0,22,5491,3.18%,3.19%,
105/01/04,1,0,-6,-5,5472,0,22,5494,3.19%,3.20%,
104/12/31,-2,0,0,-2,5471,0,28,5499,3.18%,3.20%,
104/12/30,-3,0,-6,-9,5473,0,28,5501,3.19%,3.21%,
104/12/29,0,0,6,6,5476,0,34,5510,3.19%,3.21%,
104/12/28,-2,0,0,-2,5476,0,28,5504,3.19%,3.21%,
104/12/25,4,0,0,4,5478,0,28,5506,3.19%,3.21%,
104/12/24,-1,0,1,0,5474,0,28,5502,3.19%,3.21%,
104/12/23,-4,0,0,-4,5475,0,27,5502,3.19%,3.21%,
104/12/22,-0,0,7,7,5479,0,27,5506,3.19%,3.21%,
104/12/21,14,0,0,14,5479,0,20,5499,3.19%,3.20%,
104/12/18,-5,0,-2,-7,5465,0,20,5485,3.18%,3.19%,
104/12/17,-48,0,-1,-49,5470,0,22,5492,3.18%,3.19%,
104/12/16,2,0,0,2,5518,0,23,5541,3.21%,3.22%,
104/12/15,-1,0,0,-1,5516,0,23,5539,3.21%,3.22%,
104/12/14,-10,0,0,-10,5517,0,23,5540,3.21%,3.22%,
104/12/11,5,0,-6,-1,5527,0,23,5550,3.22%,3.23%,
104/12/10,-1,0,0,-1,5522,0,29,5551,3.21%,3.23%,
104/12/09,-1,0,0,-1,5523,0,29,5552,3.21%,3.23%,
104/12/08,0,0,0,0,5524,0,29,5553,3.22%,3.24%,
104/12/07,0,0,-1,-1,5524,0,29,5553,3.22%,3.24%,
104/12/04,0,0,-4,-4,5524,0,30,5554,3.22%,3.24%,
104/12/03,-1,0,-3,-4,5524,0,34,5558,3.22%,3.24%,
104/12/02,0,0,0,0,5525,0,37,5562,3.22%,3.24%,
104/12/01,-2,0,0,-2,5525,0,37,5562,3.22%,3.24%,
104/11/30,-1,0,0,-1,5527,0,37,5564,3.22%,3.24%,
104/11/27,0,0,0,0,5528,0,37,5565,3.22%,3.24%,
104/11/26,-1,0,0,-1,5528,0,37,5565,3.22%,3.24%,
104/11/25,-3,0,0,-3,5529,0,37,5566,3.22%,3.24%,
104/11/24,0,0,3,3,5532,0,37,5569,3.22%,3.24%,
104/11/23,-3,0,0,-3,5532,0,34,5566,3.22%,3.24%,
104/11/20,0,0,0,0,5535,0,34,5569,3.22%,3.24%,
104/11/19,12,0,0,12,5535,0,34,5569,3.22%,3.24%,
104/11/18,-12,0,0,-12,5523,0,34,5557,3.21%,3.23%,
104/11/17,-4,0,-1,-5,5535,0,34,5569,3.22%,3.24%,
104/11/16,-3,0,1,-2,5539,0,35,5574,3.22%,3.24%,
104/11/13,0,0,0,0,5542,0,34,5576,3.23%,3.25%,
104/11/12,-3,0,0,-3,5542,0,34,5576,3.23%,3.25%,
104/11/11,-3,0,0,-3,5544,0,34,5578,3.23%,3.25%,
104/11/10,-5,0,0,-5,5547,0,34,5581,3.23%,3.25%,
104/11/09,-36,0,0,-36,5552,0,34,5586,3.23%,3.25%,
104/11/06,-29,0,0,-29,5588,0,34,5622,3.25%,3.27%,
104/11/05,-5,0,0,-5,5617,0,34,5651,3.27%,3.29%,
104/11/04,8,0,0,8,5622,0,34,5656,3.27%,3.29%,
104/11/03,-12,0,1,-11,5614,0,34,5648,3.27%,3.29%,
104/11/02,-9,0,0,-9,5626,0,33,5659,3.28%,3.30%,
104/10/30,-7,0,3,-4,5635,0,33,5668,3.28%,3.30%,
104/10/29,-9,0,0,-9,5642,0,30,5672,3.28%,3.30%,
104/10/28,-36,0,0,-36,5651,0,30,5681,3.29%,3.31%,
104/10/27,-23,0,0,-23,5687,0,30,5717,3.31%,3.33%,
104/10/26,-10,0,0,-10,5710,0,30,5740,3.32%,3.34%,
104/10/23,-3,0,0,-3,5720,0,30,5750,3.33%,3.35%,
104/10/22,0,0,0,0,5723,0,30,5753,3.33%,3.35%,
104/10/21,6,0,0,6,5723,0,30,5753,3.33%,3.35%,
104/10/20,18,0,0,18,5717,0,30,5747,3.33%,3.35%,
104/10/19,3,0,-1,2,5699,0,30,5729,3.32%,3.34%,
104/10/16,4,0,0,4,5696,0,31,5727,3.32%,3.34%,
104/10/15,13,0,0,13,5692,0,31,5723,3.31%,3.33%,
104/10/14,29,0,0,29,5679,0,31,5710,3.31%,3.33%,
104/10/13,10,0,0,10,5650,0,31,5681,3.29%,3.31%,
104/10/12,10,0,0,10,5640,0,31,5671,3.28%,3.30%,
104/10/08,1,0,0,1,5630,0,31,5661,3.28%,3.30%,
104/10/07,16,0,0,16,5629,0,31,5660,3.28%,3.30%,
104/10/06,-2,0,0,-2,5613,0,31,5644,3.27%,3.29%,
104/10/05,6,0,1,7,5615,0,31,5646,3.27%,3.29%,
104/10/02,3,0,0,3,5609,0,30,5639,3.27%,3.29%,
104/10/01,3,0,0,3,5606,0,30,5636,3.26%,3.28%,
104/09/30,-18,0,0,-18,5603,0,30,5633,3.26%,3.28%,
104/09/25,17,0,0,17,5621,0,30,5651,3.27%,3.29%,
104/09/24,-5,0,0,-5,5604,0,30,5634,3.26%,3.28%,
104/09/23,6,0,-5,1,5609,0,30,5639,3.27%,3.29%,
104/09/22,-3,0,-1,-4,5603,0,35,5638,3.26%,3.28%,
104/09/21,3,0,1,4,5606,0,36,5642,3.26%,3.28%,
104/09/18,15,0,0,15,5603,0,35,5638,3.26%,3.28%,
104/09/17,4,0,-2,2,5588,0,35,5623,3.25%,3.27%,
104/09/16,7,0,8,15,5584,0,37,5621,3.25%,3.27%,
104/09/15,2,0,-3,-1,5577,0,29,5606,3.25%,3.27%,
104/09/14,-6,0,0,-6,5575,0,32,5607,3.25%,3.27%,
104/09/11,6,0,-2,4,5581,0,32,5613,3.25%,3.27%,
104/09/10,17,0,0,17,5575,0,34,5609,3.25%,3.27%,
104/09/09,3,0,2,5,5558,0,34,5592,3.24%,3.26%,
104/09/08,-9,0,0,-9,5555,0,32,5587,3.23%,3.25%,
104/09/07,15,0,0,15,5564,0,32,5596,3.24%,3.26%,
104/09/04,-40,0,0,-40,5549,0,32,5581,3.23%,3.25%,
104/09/03,-1,0,-1,-2,5589,0,32,5621,3.25%,3.27%,
104/09/02,1,0,0,1,5590,0,33,5623,3.25%,3.27%,
104/09/01,-31,0,0,-31,5589,0,33,5622,3.25%,3.27%,
104/08/31,6,0,-2,4,5620,0,33,5653,3.27%,3.29%,
104/08/28,0,0,2,2,5614,0,35,5649,3.27%,3.29%,
104/08/27,-2,0,-9,-11,5614,0,33,5647,3.27%,3.29%,
104/08/26,54,0,0,54,5616,0,42,5658,3.27%,3.29%,
104/08/25,127,0,-1,126,5562,0,42,5604,3.24%,3.26%,
104/08/24,-29,0,-2,-31,5435,0,43,5478,3.16%,3.19%,
104/08/21,-50,0,-5,-55,5464,0,45,5509,3.18%,3.21%,
104/08/20,6,0,-3,3,5514,0,50,5564,3.21%,3.24%,
104/08/19,-53,0,12,-41,5508,0,53,5561,3.21%,3.24%,
104/08/18,-8,0,0,-8,5561,0,41,5602,3.24%,3.26%,
104/08/17,13,0,-8,5,5569,0,41,5610,3.24%,3.26%,
104/08/14,1,0,-7,-6,5556,0,49,5605,3.23%,3.26%,
104/08/13,9,0,4,13,5555,0,56,5611,3.23%,3.26%,
104/08/12,-4,0,10,6,5546,0,52,5598,3.23%,3.26%,
104/08/11,4,0,-6,-2,5550,0,42,5592,3.23%,3.25%,
104/08/10,3,0,-6,-3,5546,0,48,5594,3.23%,3.26%,
104/08/07,17,0,-1,16,5543,0,54,5597,3.23%,3.26%,
104/08/06,-43,0,-2,-45,5526,0,55,5581,3.22%,3.25%,
104/08/05,-53,0,0,-53,5569,0,57,5626,3.24%,3.27%,
104/08/04,-38,0,13,-25,5622,0,57,5679,3.27%,3.30%,
104/08/03,14,0,-7,7,5660,0,44,5704,3.29%,3.32%,
104/07/31,14,0,-4,10,5646,0,51,5697,3.29%,3.32%,
104/07/30,7,0,-1,6,5632,0,55,5687,3.28%,3.31%,
104/07/29,-17,0,-1,-18,5625,0,56,5681,3.27%,3.30%,
104/07/28,6,0,15,21,5642,0,57,5699,3.28%,3.31%,
104/07/27,-32,0,1,-31,5636,0,42,5678,3.28%,3.30%,
104/07/24,-7,0,-1,-8,5668,0,41,5709,3.30%,3.32%,
104/07/23,0,0,7,7,5675,0,42,5717,3.30%,3.32%,
104/07/22,0,0,-2,-2,5675,0,35,5710,3.30%,3.32%,
104/07/21,-4,0,-2,-6,5675,0,37,5712,3.30%,3.32%,
104/07/20,3,0,0,3,5679,0,39,5718,3.31%,3.33%,
104/07/17,-2,0,-1,-3,5676,0,39,5715,3.30%,3.32%,
104/07/16,-8,0,0,-8,5678,0,40,5718,3.31%,3.33%,
104/07/15,-3,0,0,-3,5686,0,40,5726,3.31%,3.33%,
104/07/14,-16,0,-1,-17,5689,0,40,5729,3.31%,3.33%,
104/07/13,7,0,-6,1,5705,0,41,5746,3.32%,3.34%,
104/07/09,-18,0,8,-10,5698,0,47,5745,3.32%,3.35%,
104/07/08,-4,0,1,-3,5716,0,39,5755,3.33%,3.35%,
104/07/07,-33,0,-3,-36,5720,0,38,5758,3.33%,3.35%,
104/07/06,1,0,0,1,5753,0,41,5794,3.35%,3.37%,
104/07/03,-10,0,0,-10,5752,0,41,5793,3.35%,3.37%,
104/07/02,3,0,0,3,5762,0,41,5803,3.35%,3.37%,
104/07/01,9,0,0,9,5759,0,41,5800,3.35%,3.37%,
104/06/30,0,0,0,0,5750,0,41,5791,3.35%,3.37%,
104/06/29,-16,0,0,-16,5750,0,41,5791,3.35%,3.37%,
104/06/26,-6,0,-2,-8,5766,0,41,5807,3.36%,3.38%,
104/06/25,11,0,2,13,5772,0,43,5815,3.36%,3.39%,
104/06/24,6,0,0,6,5761,0,41,5802,3.35%,3.37%,
104/06/23,26,0,0,26,5755,0,41,5796,3.35%,3.37%,
104/06/22,-95,0,1,-94,5729,0,41,5770,3.34%,3.36%,
104/06/18,-25,0,0,-25,5824,0,40,5864,3.39%,3.41%,
104/06/17,-65,0,0,-65,5849,0,40,5889,3.41%,3.43%,
104/06/16,-49,0,0,-49,5914,0,40,5954,3.44%,3.46%,
104/06/15,-4,0,0,-4,5963,0,40,6003,3.47%,3.49%,
104/06/12,-9,0,0,-9,5967,0,40,6007,3.47%,3.49%,
104/06/11,-16,0,1,-15,5976,0,40,6016,3.48%,3.50%,
104/06/10,24,0,-2,22,5992,0,39,6031,3.49%,3.51%,
104/06/09,2,0,1,3,5968,0,41,6009,3.47%,3.49%,
104/06/08,-27,0,0,-27,5966,0,40,6006,3.47%,3.49%,
104/06/05,-68,0,0,-68,5993,0,40,6033,3.49%,3.51%,
104/06/04,-32,0,0,-32,6061,0,40,6101,3.53%,3.55%,
104/06/03,-9,0,0,-9,6093,0,40,6133,3.55%,3.57%,
104/06/02,4,0,0,4,6102,0,40,6142,3.55%,3.57%,
104/06/01,5,0,0,5,6098,0,40,6138,3.55%,3.57%,
104/05/29,-7,0,0,-7,6093,0,40,6133,3.55%,3.57%,
104/05/28,-2,0,-2,-4,6100,0,40,6140,3.55%,3.57%,
104/05/27,-27,0,2,-25,6102,0,42,6144,3.55%,3.57%,
104/05/26,-20,0,0,-20,6110,0,40,6150,3.56%,3.58%,
104/05/25,-86,0,4,-82,6130,0,40,6170,3.57%,3.59%,
104/05/22,-14,0,-3,-17,6216,0,36,6252,3.62%,3.64%,
104/05/21,-6,0,-7,-13,6230,0,39,6269,3.63%,3.65%,
104/05/20,-3,0,-1,-4,6236,0,46,6282,3.63%,3.66%,
104/05/19,-16,0,1,-15,6239,0,47,6286,3.63%,3.66%,
104/05/18,-7,0,0,-7,6255,0,46,6301,3.64%,3.67%,
104/05/15,23,0,-3,20,6262,0,46,6308,3.65%,3.68%,
104/05/14,-12,0,0,-12,6239,0,49,6288,3.63%,3.66%,
104/05/13,31,0,-5,26,6251,0,49,6300,3.64%,3.67%,
104/05/12,6,0,6,12,6220,0,54,6274,3.62%,3.65%,
104/05/11,24,0,7,31,6214,0,48,6262,3.62%,3.65%,
104/05/08,5,0,-1,4,6190,0,41,6231,3.60%,3.62%,
104/05/07,23,0,-7,16,6185,0,42,6227,3.60%,3.62%,
104/05/06,26,0,7,33,6162,0,49,6211,3.59%,3.62%,
104/05/05,28,0,0,28,6136,0,42,6178,3.57%,3.59%,
104/05/04,-14,0,0,-14,6108,0,42,6150,3.56%,3.58%,
104/04/30,25,0,3,28,6122,0,42,6164,3.56%,3.58%,
104/04/29,37,0,1,38,6097,0,39,6136,3.55%,3.57%,
104/04/28,22,0,3,25,6060,0,38,6098,3.53%,3.55%,
104/04/27,49,0,0,49,6038,0,35,6073,3.52%,3.54%,
104/04/24,65,0,7,72,5989,0,35,6024,3.49%,3.51%,
104/04/23,9,0,-1,8,5924,0,28,5952,3.45%,3.47%,
104/04/22,-3,0,1,-2,5915,0,29,5944,3.44%,3.46%,
104/04/21,12,0,-10,2,5918,0,28,5946,3.45%,3.47%,
104/04/20,4,0,2,6,5906,0,38,5944,3.44%,3.46%,
104/04/17,38,0,0,38,5902,0,36,5938,3.44%,3.46%,
104/04/16,-58,0,-19,-77,5864,0,36,5900,3.41%,3.43%,
104/04/15,-41,0,5,-36,5922,0,55,5977,3.45%,3.48%,
104/04/14,-36,0,0,-36,5963,0,50,6013,3.47%,3.50%,
104/04/13,17,0,-5,12,5999,0,50,6049,3.49%,3.52%,
104/04/10,-4,0,0,-4,5982,0,55,6037,3.48%,3.51%,
104/04/09,19,0,0,19,5986,0,55,6041,3.49%,3.52%,
104/04/08,19,0,-1,18,5967,0,55,6022,3.47%,3.50%,
104/04/07,57,0,0,57,5948,0,56,6004,3.46%,3.49%,
104/04/02,-6,0,0,-6,5891,0,56,5947,3.43%,3.46%,
104/04/01,-18,0,-2,-20,5897,0,56,5953,3.43%,3.46%,
104/03/31,0,0,0,0,5915,0,58,5973,3.44%,3.47%,
104/03/30,-37,0,0,-37,5915,0,58,5973,3.44%,3.47%,
104/03/27,-12,0,3,-9,5952,0,58,6010,3.47%,3.50%,
104/03/26,17,0,5,22,5964,0,55,6019,3.47%,3.50%,
104/03/25,1,0,0,1,5947,0,50,5997,3.46%,3.49%,
104/03/24,8,0,-1,7,5946,0,50,5996,3.46%,3.49%,
104/03/23,12,0,0,12,5938,0,51,5989,3.46%,3.49%,
104/03/20,1,0,0,1,5926,0,51,5977,3.45%,3.48%,
104/03/19,6,0,0,6,5925,0,51,5976,3.45%,3.48%,
104/03/18,-4,0,4,0,5919,0,51,5970,3.45%,3.48%,
104/03/17,0,0,1,1,5923,0,47,5970,3.45%,3.48%,
104/03/16,1,0,3,4,5923,0,46,5969,3.45%,3.48%,
104/03/13,-11,0,0,-11,5922,0,43,5965,3.45%,3.48%,
104/03/12,-1,0,0,-1,5933,0,43,5976,3.45%,3.48%,
104/03/11,-35,0,0,-35,5934,0,43,5977,3.45%,3.48%,
104/03/10,-8,0,-1,-9,5969,0,43,6012,3.48%,3.51%,
104/03/09,-1,0,0,-1,5977,0,44,6021,3.48%,3.51%,
104/03/06,8,0,-2,6,5978,0,44,6022,3.48%,3.51%,
104/03/05,2,0,-3,-1,5970,0,46,6016,3.48%,3.51%,
104/03/04,-4,0,0,-4,5968,0,49,6017,3.47%,3.50%,
104/03/03,-9,0,0,-9,5972,0,49,6021,3.48%,3.51%,
104/03/02,-19,0,0,-19,5981,0,49,6030,3.48%,3.51%,
104/02/26,0,0,0,0,6000,0,49,6049,3.49%,3.52%,
104/02/25,4,0,-1,3,6000,0,49,6049,3.49%,3.52%,
104/02/24,-10,0,0,-10,5996,0,50,6046,3.49%,3.52%,
104/02/13,3,0,-2,1,6006,0,50,6056,3.50%,3.53%,
104/02/12,3,0,0,3,6003,0,52,6055,3.50%,3.53%,
104/02/11,-2,0,0,-2,6000,0,52,6052,3.49%,3.52%,
104/02/10,13,0,8,21,6002,0,52,6054,3.49%,3.52%,
104/02/09,3,0,0,3,5989,0,44,6033,3.49%,3.52%,
104/02/06,0,0,0,0,5986,0,44,6030,3.49%,3.52%,
104/02/05,4,0,0,4,5986,0,44,6030,3.49%,3.52%,
104/02/04,0,0,0,0,5982,0,44,6026,3.48%,3.51%,
104/02/03,3,0,0,3,5982,0,44,6026,3.48%,3.51%,
104/02/02,0,0,0,0,5979,0,44,6023,3.48%,3.51%,
104/01/30,-7,0,0,-7,5979,0,44,6023,3.48%,3.51%,
104/01/29,5,0,1,6,5986,0,44,6030,3.49%,3.52%,
104/01/28,4,0,2,6,5981,0,43,6024,3.48%,3.51%,
104/01/27,0,0,7,7,5977,0,41,6018,3.48%,3.50%,
104/01/26,-6,0,1,-5,5977,0,34,6011,3.48%,3.50%,
104/01/23,-11,0,0,-11,5983,0,33,6016,3.48%,3.50%,
104/01/22,2,0,-1,1,5994,0,33,6027,3.49%,3.51%,
104/01/21,1,0,0,1,5992,0,34,6026,3.49%,3.51%,
104/01/20,11,0,0,11,5991,0,34,6025,3.49%,3.51%,
104/01/19,-13,0,0,-13,5980,0,34,6014,3.48%,3.50%,
104/01/16,-35,0,-1,-36,5993,0,34,6027,3.49%,3.51%,
104/01/15,-5,0,0,-5,6028,0,35,6063,3.51%,3.53%,
104/01/14,-5,0,0,-5,6033,0,35,6068,3.51%,3.53%,
104/01/13,0,0,1,1,6038,0,35,6073,3.52%,3.54%,
104/01/12,3,0,-3,0,6038,0,34,6072,3.52%,3.54%,
104/01/09,10,0,1,11,6035,0,37,6072,3.51%,3.53%,
104/01/08,5,0,0,5,6025,0,36,6061,3.51%,3.53%,
104/01/07,12,0,0,12,6020,0,36,6056,3.51%,3.53%,
104/01/06,40,0,2,42,6008,0,36,6044,3.50%,3.52%,
104/01/05,-7,0,-4,-11,5968,0,34,6002,3.47%,3.49%,
