日期,外資買賣超,投信買賣超,自營商買賣超,單日合計買賣超,外資估計持股,投信估計持股,自營商估計持股,單日合計估計持股,外資持股比重,三大法人持股比重,
107/03/31,686,0,-810,-124,718894,772,7967,727633,22.22%,22.49%,
107/03/30,-762,-10,-90,-862,718208,772,8777,727757,22.20%,22.50%,
107/03/29,-806,0,52,-754,718827,782,8867,728476,22.22%,22.52%,
107/03/28,-4056,0,-971,-5027,721412,782,8815,731009,22.30%,22.60%,
107/03/27,-2465,3,-357,-2819,725468,782,9786,736036,22.43%,22.76%,
107/03/26,-973,0,57,-916,727939,779,10143,738861,22.50%,22.84%,
107/03/23,-2871,0,-820,-3691,728912,779,10086,739777,22.53%,22.87%,
107/03/22,-289,0,-161,-450,731008,779,10906,742693,22.60%,22.96%,
107/03/21,-2811,0,-422,-3233,730912,779,11067,742758,22.60%,22.97%,
107/03/20,-2946,-20,-251,-3217,734207,779,11489,746475,22.70%,23.08%,
107/03/19,-752,-19,-1378,-2149,736814,799,11740,749353,22.78%,23.17%,
107/03/16,-3307,0,-2147,-5454,739559,818,13118,753495,22.86%,23.29%,
107/03/15,17908,0,6759,24667,742866,818,15265,758949,22.97%,23.47%,
107/03/14,5149,0,964,6113,724906,818,8506,734230,22.41%,22.70%,
107/03/13,816,-19,33,830,720101,818,7542,728461,22.26%,22.52%,
107/03/12,-428,0,-151,-579,719285,837,7509,727631,22.24%,22.50%,
107/03/09,1333,0,-539,794,719713,837,7660,728210,22.25%,22.51%,
107/03/08,-212,0,1738,1526,718090,837,8199,727126,22.20%,22.48%,
107/03/07,-537,0,-230,-767,716287,837,6461,723585,22.14%,22.37%,
107/03/06,-1170,0,-76,-1246,716724,837,6691,724252,22.16%,22.39%,
107/03/05,-714,181,-361,-894,715887,837,6767,723491,22.13%,22.37%,
107/03/02,-879,0,107,-772,716382,656,7128,724166,22.15%,22.39%,
107/03/01,-5479,0,-180,-5659,717209,656,7021,724886,22.17%,22.41%,
107/02/27,1434,0,-7,1427,722561,656,7201,730418,22.34%,22.58%,
107/02/26,-1906,0,-365,-2271,721569,656,7208,729433,22.31%,22.55%,
107/02/23,-2920,0,629,-2291,723518,656,7573,731747,22.37%,22.62%,
107/02/22,-1348,-7,-333,-1688,728258,656,6944,735858,22.51%,22.75%,
107/02/21,-4917,0,1801,-3116,729606,663,7277,737546,22.56%,22.81%,
107/02/12,-2327,0,-115,-2442,734523,663,5476,740662,22.71%,22.90%,
107/02/09,1503,0,-447,1056,738685,663,5591,744939,22.84%,23.03%,
107/02/08,-565,0,190,-375,739262,663,6038,745963,22.85%,23.06%,
107/02/07,-3634,0,369,-3265,740177,663,5848,746688,22.88%,23.08%,
107/02/06,6281,0,-5535,746,741811,663,5479,747953,22.93%,23.12%,
107/02/05,-666,0,-1742,-2408,736056,663,11014,747733,22.76%,23.12%,
107/02/02,1366,0,-1901,-535,739722,663,12756,753141,22.87%,23.28%,
107/02/01,-2949,0,1409,-1540,739146,663,14657,754466,22.85%,23.32%,
107/01/31,2774,-100,-1297,1377,742318,663,13248,756229,22.95%,23.38%,
107/01/30,-7401,0,1432,-5969,740526,763,14545,755834,22.89%,23.36%,
107/01/29,7139,0,701,7840,747724,763,13113,761600,23.12%,23.55%,
107/01/26,-1952,-24,-253,-2229,740675,763,12412,753850,22.90%,23.31%,
107/01/25,-4360,0,-273,-4633,744030,787,12665,757482,23.00%,23.42%,
107/01/24,7541,-20,-243,7278,748493,787,12938,762218,23.14%,23.56%,
107/01/23,2214,0,-3123,-909,745853,807,13181,759841,23.06%,23.49%,
107/01/22,1318,0,1569,2887,742965,807,16304,760076,22.97%,23.50%,
107/01/19,666,0,370,1036,742861,807,14735,758403,22.97%,23.45%,
107/01/18,-4210,0,-2998,-7208,744548,807,14365,759720,23.02%,23.49%,
107/01/17,-3896,0,-3239,-7135,751809,807,17363,769979,23.24%,23.80%,
107/01/16,7027,-23,14172,21176,754664,807,20602,776073,23.33%,23.99%,
107/01/15,6218,0,-1352,4866,747402,830,6430,754662,23.11%,23.33%,
107/01/12,-119,0,2029,1910,741205,830,7782,749817,22.91%,23.18%,
107/01/11,2594,0,-197,2397,741506,830,5753,748089,22.92%,23.12%,
107/01/10,-2628,-19,-855,-3502,738909,830,5950,745689,22.84%,23.05%,
107/01/09,4151,0,-867,3284,750313,849,6805,757967,23.20%,23.44%,
107/01/08,-2185,0,-220,-2405,746480,849,7672,755001,23.08%,23.34%,
107/01/05,820,-18,-733,69,752128,849,7892,760869,23.25%,23.52%,
107/01/04,1259,506,652,2417,754414,867,8625,763906,23.32%,23.61%,
107/01/03,4289,0,15,4304,753955,361,7973,762289,23.31%,23.57%,
107/01/02,-402,0,469,67,749666,361,7958,757985,23.18%,23.44%,
106/12/29,857,0,-212,645,751400,361,7489,759250,23.23%,23.47%,
106/12/28,1009,-32,150,1127,750513,0,7701,758214,23.20%,23.44%,
106/12/27,-6622,-37,144,-6515,756480,0,7551,764031,23.39%,23.62%,
106/12/26,-2973,-28,-1415,-4416,761076,0,7407,768483,23.53%,23.76%,
106/12/25,-1174,0,-1535,-2709,764428,0,8822,773250,23.63%,23.90%,
106/12/22,1290,0,662,1952,765602,0,10357,775959,23.67%,23.99%,
106/12/21,1111,0,-677,434,770851,0,9695,780546,23.83%,24.13%,
106/12/20,2432,0,259,2691,770371,0,10372,780743,23.82%,24.14%,
106/12/19,1462,0,-1425,37,765561,0,10113,775674,23.67%,23.98%,
106/12/18,-2489,0,1166,-1323,772639,0,11538,784177,23.89%,24.25%,
106/12/15,-590,-5,-304,-899,775033,0,10372,785405,23.96%,24.28%,
106/12/14,16037,0,605,16642,776960,0,10676,787636,24.02%,24.35%,
106/12/13,-5344,0,-808,-6152,762211,0,10071,772282,23.56%,23.87%,
106/12/12,-6503,0,-1480,-7983,767451,0,10879,778330,23.73%,24.07%,
106/12/11,3903,0,3230,7133,773953,0,12359,786312,23.93%,24.31%,
106/12/08,9335,0,-5457,3878,770550,0,9129,779679,23.82%,24.10%,
106/12/07,-2456,0,-342,-2798,757115,0,14586,771701,23.41%,23.86%,
106/12/06,-4448,0,-1285,-5733,761634,0,14928,776562,23.55%,24.01%,
106/12/05,1970,-500,-1844,-374,769622,0,16213,785835,23.79%,24.29%,
106/12/04,-1732,0,314,-1418,767653,0,18057,785710,23.73%,24.29%,
106/12/01,-760,0,-2631,-3391,771594,0,17743,789337,23.85%,24.40%,
106/11/30,30782,0,4180,34962,771903,0,20374,792277,23.86%,24.49%,
106/11/29,5758,-1140,-1372,3246,735121,0,16194,751315,22.73%,23.23%,
106/11/28,-14140,0,862,-13278,730838,808,17566,749212,22.59%,23.16%,
106/11/27,-1148,0,-2222,-3370,744978,808,16704,762490,23.03%,23.57%,
106/11/24,-1895,0,689,-1206,746127,808,18926,765861,23.07%,23.68%,
106/11/23,-4985,0,-844,-5829,748021,808,18237,767066,23.13%,23.72%,
106/11/22,-4060,0,438,-3622,750537,808,19081,770426,23.20%,23.82%,
106/11/21,-8419,0,-2951,-11370,753215,808,18643,772666,23.29%,23.89%,
106/11/20,-11845,0,162,-11683,761220,808,21594,783622,23.53%,24.22%,
106/11/17,-10565,0,3876,-6689,773065,808,21432,795305,23.90%,24.59%,
106/11/16,-14219,0,2970,-11249,780626,808,17556,798990,24.13%,24.70%,
106/11/15,-6645,0,-1895,-8540,795076,808,14586,810470,24.58%,25.06%,
106/11/14,-13597,0,614,-12983,801721,808,16481,819010,24.79%,25.32%,
106/11/13,-16072,0,-2024,-18096,816618,808,15867,833293,25.25%,25.77%,
106/11/10,-6648,0,752,-5896,832790,808,17891,851489,25.75%,26.33%,
106/11/09,-12915,0,-5879,-18794,839452,808,17139,857399,25.95%,26.50%,
106/11/08,-25422,0,-761,-26183,847668,808,23018,871494,26.21%,26.95%,
106/11/07,-39018,0,826,-38192,872989,808,23779,897576,26.99%,27.75%,
106/11/06,-17992,-777,-1409,-20178,910393,808,22953,934154,28.15%,28.88%,
106/11/03,-38946,0,-2533,-41479,923885,1585,24362,949832,28.56%,29.36%,
106/11/02,-3203,500,499,-2204,961321,1585,26895,989801,29.72%,30.60%,
106/11/01,-11679,0,-1749,-13428,962475,1085,26396,989956,29.76%,30.61%,
106/10/31,7394,0,2363,9757,972197,1085,28145,1001427,30.06%,30.96%,
106/10/30,-6714,0,-2026,-8740,964514,1085,25782,991381,29.82%,30.65%,
106/10/27,-228,0,89,-139,968728,1085,27808,997621,29.95%,30.84%,
106/10/26,10872,0,1757,12629,984393,1085,27719,1013197,30.43%,31.32%,
106/10/25,-4260,0,-581,-4841,973784,1085,25962,1000831,30.11%,30.95%,
106/10/24,-3506,0,-2055,-5561,978068,1085,26543,1005696,30.24%,31.09%,
106/10/23,1475,0,2703,4178,986151,1085,28598,1015834,30.49%,31.41%,
106/10/20,2353,0,-1394,959,984177,1085,25895,1011157,30.43%,31.26%,
106/10/19,2389,-42,-723,1624,981234,1085,27289,1009608,30.34%,31.22%,
106/10/18,1646,0,5039,6685,977345,1127,28012,1006484,30.22%,31.12%,
106/10/17,621,0,-851,-230,975699,1127,22973,999799,30.17%,30.92%,
106/10/16,-2025,0,-1641,-3666,977278,1127,23824,1002229,30.21%,30.98%,
106/10/13,5636,0,4311,9947,979254,1127,25465,1005846,30.28%,31.10%,
106/10/12,1176,0,-73,1103,973871,1127,21154,996152,30.11%,30.80%,
106/10/11,-3838,0,-5835,-9673,970695,1127,21227,993049,30.01%,30.70%,
106/10/06,-4312,0,-3184,-7496,967183,1127,27062,995372,29.90%,30.77%,
106/10/05,5008,0,5847,10855,970025,1127,30246,1001398,29.99%,30.96%,
106/10/03,-1554,-1,-604,-2159,963017,1127,24399,988543,29.77%,30.56%,
106/10/02,6051,-617,-1619,3815,964571,1128,25003,990702,29.82%,30.63%,
106/09/30,0,-400,5741,5341,958520,1745,26622,986887,29.63%,30.51%,
106/09/29,7631,0,-3173,4458,958520,4133,20881,983534,29.63%,30.40%,
106/09/28,-847,0,-2815,-3662,947362,4133,24054,975549,29.29%,30.16%,
106/09/27,-1185,0,1378,193,945710,4133,26869,976712,29.24%,30.20%,
106/09/26,-16403,617,1092,-14694,928184,4133,25491,957808,28.70%,29.62%,
106/09/25,6139,0,-2083,4056,947226,3516,24399,975141,29.29%,30.15%,
106/09/22,4897,-400,-4277,220,942209,3516,26482,972207,29.13%,30.06%,
106/09/21,-4065,0,-590,-4655,938010,3916,30759,972685,29.00%,30.07%,
106/09/20,-4147,0,-4588,-8735,942075,3916,31349,977340,29.13%,30.22%,
106/09/19,-112,0,4488,4376,945222,3916,35937,985075,29.22%,30.45%,
106/09/18,3559,0,-550,3009,945334,3916,31449,980699,29.23%,30.32%,
106/09/15,-7370,1,-1204,-8573,933079,3916,31999,968994,28.85%,29.96%,
106/09/14,189,0,172,361,940792,3915,33203,977910,29.09%,30.24%,
106/09/13,2235,-200,1001,3036,939403,3915,33031,976349,29.04%,30.18%,
106/09/12,-1224,940,-3471,-3755,935484,4115,32030,971629,28.92%,30.04%,
106/09/11,-21166,0,-4173,-25339,937308,3175,35501,975984,28.98%,30.18%,
106/09/08,14570,-342,4271,18499,957974,3175,39674,1000823,29.62%,30.94%,
106/09/07,6083,0,-13465,-7382,943905,3517,35403,982825,29.18%,30.38%,
106/09/06,-26997,0,-2536,-29533,938997,3517,48868,991382,29.03%,30.65%,
106/09/05,74932,1,11705,86638,965780,3517,51404,1020701,29.86%,31.56%,
106/09/04,10010,0,-1331,8679,890848,3516,39699,934063,27.54%,28.88%,
106/09/01,-3792,0,-3074,-6866,880638,3516,41030,925184,27.23%,28.61%,
106/08/31,25396,0,1886,27282,885293,3516,44104,932913,27.37%,28.84%,
106/08/30,10238,0,-7692,2546,858897,3516,42218,904631,26.55%,27.96%,
106/08/29,2655,1,8690,11346,851013,3516,49910,904439,26.31%,27.96%,
106/08/28,15411,-189,-732,14490,853102,3515,41220,897837,26.37%,27.75%,
106/08/25,-1438,666,-14064,-14836,837605,3704,41952,883261,25.90%,27.31%,
106/08/24,12829,385,23964,37178,828103,3038,56016,887157,25.60%,27.43%,
106/08/23,27533,388,-983,26938,814774,2653,32052,849479,25.19%,26.26%,
106/08/22,28579,0,-3459,25120,774891,2265,33035,810191,23.96%,25.05%,
106/08/21,23408,0,-11119,12289,746663,2265,36494,785422,23.08%,24.28%,
106/08/18,24574,0,14667,39241,723355,2265,47613,773233,22.36%,23.90%,
106/08/17,54362,200,-3822,50740,698781,2265,32946,733992,21.60%,22.69%,
106/08/16,33748,0,-4025,29723,646533,2065,36768,685366,19.99%,21.19%,
106/08/15,20013,0,3315,23328,612775,2065,40793,655633,18.94%,20.27%,
106/08/14,30108,200,-843,29465,596826,2065,37478,636369,18.45%,19.67%,
106/08/11,27193,-600,8796,35389,568380,1865,38321,608566,17.57%,18.81%,
106/08/10,32618,500,-5616,27502,541187,2465,29525,573177,16.73%,17.72%,
106/08/09,17429,700,-1184,16945,511019,1965,35141,548125,15.80%,16.95%,
106/08/08,31987,-200,9871,41658,494290,1265,36325,531880,15.28%,16.44%,
106/08/07,9870,-200,855,10525,473308,1465,26454,501227,14.63%,15.49%,
106/08/04,10843,0,4336,15179,464438,1665,25599,491702,14.36%,15.20%,
106/08/03,15775,-290,317,15802,454421,1665,21263,477349,14.05%,14.76%,
106/08/02,13094,-10,-1552,11532,438646,1955,20946,461547,13.56%,14.27%,
106/08/01,14980,0,-765,14215,424726,1965,22498,449189,13.13%,13.89%,
106/07/31,10166,0,5390,15556,409350,1965,23263,434578,12.65%,13.43%,
106/07/28,5425,0,171,5596,399184,1965,17873,419022,12.34%,12.95%,
106/07/27,9274,0,-2018,7256,393539,1965,17702,413206,12.16%,12.77%,
106/07/26,15580,-200,-1475,13905,388898,1965,19720,410583,12.02%,12.69%,
106/07/25,35439,0,5310,40749,372518,2165,21195,395878,11.51%,12.23%,
106/07/24,4871,0,-5500,-629,336198,2165,15885,354248,10.39%,10.95%,
106/07/21,-1991,-400,5808,3417,330816,2165,21385,354366,10.22%,10.95%,
106/07/20,-5000,2,-1935,-6933,332808,2565,15577,350950,10.29%,10.85%,
106/07/19,-5051,0,-1946,-6997,337782,2563,17512,357857,10.44%,11.06%,
106/07/18,643,0,2739,3382,342783,2563,19458,364804,10.59%,11.27%,
106/07/17,-5207,0,-2014,-7221,340767,2563,16719,360049,10.53%,11.13%,
106/07/14,-122,-4000,-1440,-5562,345773,2563,18733,367069,10.69%,11.35%,
106/07/13,-1645,0,-2973,-4618,344051,6563,20173,370787,10.63%,11.46%,
106/07/12,-1761,0,-2327,-4088,344579,6563,23146,374288,10.65%,11.57%,
106/07/11,821,0,2132,2953,346045,6563,25473,378081,10.70%,11.69%,
106/07/10,-2356,400,-682,-2638,348188,6563,23341,378092,10.76%,11.68%,
106/07/07,22786,0,-2371,20415,351441,6163,24023,381627,10.86%,11.79%,
106/07/06,-2724,0,1725,-999,328103,6163,26394,360660,10.14%,11.15%,
106/07/05,2857,0,-827,2030,323077,6163,24669,353909,9.99%,10.94%,
106/07/04,-2578,0,-1015,-3593,320056,6163,25496,351715,9.89%,10.87%,
106/07/03,-107,4000,2353,6246,321872,6163,26511,354546,9.95%,10.96%,
106/06/30,7892,4,-2764,5132,323282,2163,24158,349603,9.99%,10.80%,
106/06/29,2291,0,5779,8070,322172,2254,26922,351348,9.96%,10.86%,
106/06/28,8925,0,-161,8764,323881,2254,21143,347278,10.01%,10.73%,
106/06/27,15051,0,7377,22428,313253,2254,21304,336811,9.68%,10.41%,
106/06/26,2779,0,1039,3818,298202,2254,13927,314383,9.22%,9.72%,
106/06/23,2215,0,344,2559,297120,2254,12888,312262,9.18%,9.65%,
106/06/22,2388,-400,-4527,-2539,297505,2254,12544,312303,9.19%,9.65%,
106/06/21,1871,0,8069,9940,294692,2654,17071,314417,9.11%,9.72%,
106/06/20,6167,2,741,6910,292822,2654,9002,304478,9.05%,9.41%,
106/06/19,779,0,-386,393,286709,2652,8261,297622,8.86%,9.20%,
106/06/16,13373,-611,1378,14140,278688,2652,8647,289987,8.61%,8.96%,
106/06/15,9610,0,227,9837,271052,3263,7269,281584,8.38%,8.71%,
106/06/14,2692,-300,-472,1920,261380,3263,7042,271685,8.08%,8.40%,
106/06/13,899,0,-1007,-108,270787,3563,7514,281864,8.37%,8.71%,
106/06/12,7552,0,-3202,4350,273138,3563,8521,285222,8.44%,8.81%,
106/06/09,15574,-222,4061,19413,276392,3563,11723,291678,8.54%,9.01%,
106/06/08,8350,-300,547,8597,264213,3785,7662,275660,8.17%,8.52%,
106/06/07,1605,0,-1678,-73,259719,4085,7115,270919,8.03%,8.38%,
106/06/06,8151,0,-631,7520,255975,4085,8793,268853,7.91%,8.31%,
106/06/05,4430,0,3072,7502,248580,4085,9423,262088,7.68%,8.10%,
106/06/03,0,0,-925,-925,244960,4085,6351,255396,7.57%,7.89%,
106/06/02,1053,0,871,1924,244460,4085,7276,255821,7.55%,7.90%,
106/06/01,1265,0,997,2262,243178,4085,6405,253668,7.51%,7.83%,
106/05/31,263,-31,-281,-49,241389,4085,5408,250882,7.46%,7.75%,
106/05/26,-4139,0,56,-4083,241126,4116,5689,250931,7.45%,7.75%,
106/05/25,-5908,0,-280,-6188,244765,4116,5633,254514,7.56%,7.86%,
106/05/24,-1298,0,-242,-1540,251123,4116,5913,261152,7.76%,8.07%,
106/05/23,-3646,0,628,-3018,253134,4116,6155,263405,7.82%,8.14%,
106/05/22,-1484,0,-2905,-4389,262018,4116,5527,271661,8.10%,8.40%,
106/05/19,-6343,0,3268,-3075,263495,4116,8432,276043,8.14%,8.53%,
106/05/18,1745,0,-1084,661,271259,4116,5164,280539,8.38%,8.67%,
106/05/17,4024,-300,1116,4840,274474,4116,6248,284838,8.48%,8.80%,
106/05/16,-3155,-500,-205,-3860,277341,4416,5132,286889,8.57%,8.87%,
106/05/15,795,0,509,1304,280561,4916,5337,290814,8.67%,8.99%,
106/05/12,1876,0,-360,1516,281166,4916,4828,290910,8.69%,8.99%,
106/05/11,-4062,0,-661,-4723,278490,4916,5188,288594,8.61%,8.92%,
106/05/10,1409,-500,-408,501,286309,4916,5849,297074,8.85%,9.18%,
106/05/09,-19299,0,-905,-20204,284344,5416,6257,296017,8.79%,9.15%,
106/05/08,-589,0,-873,-1462,296562,5416,7163,309141,9.17%,9.56%,
106/05/05,-2983,0,-1486,-4469,296606,5416,8036,310058,9.17%,9.59%,
106/05/04,2818,-1,1548,4365,298468,5416,9522,313406,9.22%,9.68%,
106/05/03,-248,0,465,217,295033,5417,7974,308424,9.12%,9.53%,
106/05/02,179,-3,-413,-237,293281,5417,7509,306207,9.06%,9.46%,
106/04/28,-3697,0,-1230,-4927,293102,5420,7922,306444,9.06%,9.47%,
106/04/27,-3122,0,-3903,-7025,295531,5420,9152,310103,9.13%,9.58%,
106/04/26,748,0,3906,4654,299640,5420,13055,318115,9.26%,9.83%,
106/04/25,5408,-0,826,6234,298892,5420,9149,313461,9.24%,9.69%,
106/04/24,3423,0,-1160,2263,291234,5420,8323,304977,9.00%,9.42%,
106/04/21,1680,0,-663,1017,288978,5420,9483,303881,8.93%,9.39%,
106/04/20,360,0,1029,1389,288979,5420,10146,304545,8.93%,9.41%,
106/04/19,8632,0,-1600,7032,291519,5420,9117,306056,9.01%,9.46%,
106/04/18,-3599,0,863,-2736,284138,5420,10717,300275,8.78%,9.28%,
106/04/17,-998,0,-3296,-4294,278487,5420,9854,293761,8.61%,9.08%,
106/04/14,-4111,0,-1789,-5900,282022,5420,13150,300592,8.72%,9.29%,
106/04/13,-4870,0,-2932,-7802,273833,5420,14939,294192,8.46%,9.09%,
106/04/12,1275,0,2825,4100,278703,5420,17871,301994,8.61%,9.33%,
106/04/11,1564,0,-5751,-4187,280478,5420,15046,300944,8.67%,9.30%,
106/04/10,-2049,0,6687,4638,274690,5420,20797,300907,8.49%,9.30%,
106/04/07,3870,0,-1186,2684,236749,5420,14110,256279,7.32%,7.92%,
106/04/06,6058,0,986,7044,232804,5420,15296,253520,7.19%,7.83%,
106/04/05,25302,0,1240,26542,226247,5420,14310,245977,6.99%,7.60%,
106/03/31,-543,0,-96,-639,200605,5420,13070,219095,6.20%,6.77%,
106/03/30,-3075,0,-2414,-5489,199666,5465,13166,218297,6.17%,6.75%,
106/03/29,-1378,0,909,-469,201954,5465,15580,222999,6.24%,6.89%,
106/03/28,-4511,0,-1274,-5785,207338,5465,14671,227474,6.41%,7.03%,
106/03/27,-6420,58,-2032,-8394,215429,5465,15945,236839,6.66%,7.32%,
106/03/24,3676,0,-5889,-2213,240836,5407,17977,264220,7.44%,8.16%,
106/03/23,7391,0,4567,11958,243789,5407,23866,273062,7.53%,8.44%,
106/03/22,9735,0,6542,16277,244605,5407,19299,269311,7.56%,8.32%,
106/03/21,4020,0,-89,3931,235570,5407,12757,253734,7.28%,7.84%,
106/03/20,5272,0,-151,5121,232198,5407,12846,250451,7.18%,7.74%,
106/03/17,6030,-5,-519,5506,235667,5407,12997,254071,7.28%,7.85%,
106/03/16,667,0,61,728,233078,5412,13516,252006,7.20%,7.79%,
106/03/15,99,-1100,-23,-1024,232728,5412,13455,251595,7.19%,7.77%,
106/03/14,144,-500,2029,1673,235951,6512,13478,255941,7.29%,7.91%,
106/03/13,3316,0,-1702,1614,239773,7012,11449,258234,7.41%,7.98%,
106/03/10,-3825,0,-4199,-8024,236556,7012,13151,256719,7.31%,7.93%,
106/03/09,6457,0,-4417,2040,241118,7012,17350,265480,7.45%,8.20%,
106/03/08,7694,0,6446,14140,242664,7012,21767,271443,7.50%,8.39%,
106/03/07,-3144,-1200,-7710,-12054,243209,7012,15321,265542,7.52%,8.21%,
106/03/06,1393,0,15219,16612,246919,8212,23031,278162,7.63%,8.60%,
106/03/03,1086,0,-153,933,244836,8212,7812,260860,7.57%,8.07%,
106/03/02,-1724,0,-395,-2119,242930,8212,7965,259107,7.51%,8.01%,
106/03/01,1802,0,-619,1183,244654,8212,8360,261226,7.56%,8.07%,
106/02/24,-1672,0,300,-1372,244977,8212,8979,262168,7.57%,8.10%,
106/02/23,-3533,-5000,-1348,-9881,241315,8212,8679,258206,7.46%,7.98%,
106/02/22,-2792,0,1683,-1109,243848,13212,10027,267087,7.54%,8.26%,
106/02/21,-3471,0,156,-3315,243994,13212,8344,265550,7.54%,8.21%,
106/02/20,-9843,0,-882,-10725,245765,13212,8188,267165,7.59%,8.25%,
106/02/18,-770,322,977,529,249739,13212,9070,272021,7.72%,8.41%,
106/02/17,60,0,49,109,250509,12890,8093,271492,7.74%,8.39%,
106/02/16,-2112,0,-201,-2313,256138,12890,8044,277072,7.92%,8.57%,
106/02/15,-1386,0,-2054,-3440,256357,12890,8245,277492,7.92%,8.57%,
106/02/14,999,-5000,2091,-1910,258801,12890,10299,281990,8.00%,8.72%,
106/02/13,-506,-800,-627,-1933,258983,17890,8208,285081,8.00%,8.81%,
106/02/10,1529,300,-2968,-1139,257091,18690,8835,284616,7.94%,8.79%,
106/02/09,-3629,-400,150,-3879,256807,18390,11803,287000,7.94%,8.87%,
106/02/08,-6663,0,-1135,-7798,258736,18790,11653,289179,8.00%,8.94%,
106/02/07,-938,0,-1196,-2134,260073,18790,12788,291651,8.04%,9.02%,
106/02/06,-1814,0,1826,12,262568,18790,13984,295342,8.11%,9.12%,
106/02/03,-4918,0,-3707,-8625,265085,18790,12158,296033,8.19%,9.15%,
106/02/02,7811,-400,9391,16802,268297,18790,15865,302952,8.29%,9.36%,
106/01/24,4852,0,-367,4485,256895,19190,6474,282559,7.94%,8.73%,
106/01/23,503,-2999,127,-2369,250042,19190,6841,276073,7.73%,8.53%,
106/01/20,1716,0,-173,1543,250739,22189,6714,279642,7.75%,8.64%,
106/01/19,472,0,757,1229,247523,22189,6887,276599,7.65%,8.55%,
106/01/18,4504,0,460,4964,246845,22189,6130,275164,7.63%,8.51%,
106/01/17,907,0,-39,868,242414,22189,5670,270273,7.49%,8.35%,
106/01/16,955,0,584,1539,241619,22189,5709,269517,7.47%,8.33%,
106/01/13,2063,0,267,2330,240064,22189,5125,267378,7.42%,8.26%,
106/01/12,-298,-5000,1139,-4159,237481,22189,4858,264528,7.34%,8.18%,
106/01/11,-3080,0,-194,-3274,237079,27189,3719,267987,7.33%,8.29%,
106/01/10,713,0,-155,558,240426,27189,3913,271528,7.43%,8.39%,
106/01/09,-2591,-200,-123,-2914,237979,27189,4068,269236,7.35%,8.32%,
106/01/06,361,0,1291,1652,238022,27389,4191,269602,7.36%,8.34%,
106/01/05,3120,0,-802,2318,235589,27389,2900,265878,7.28%,8.22%,
106/01/04,597,0,177,774,230291,27389,3702,261382,7.12%,8.08%,
106/01/03,-870,0,-95,-965,231231,27389,3525,262145,7.15%,8.11%,
105/12/30,839,-2600,-1084,-2845,227714,27389,3620,258723,7.04%,8.00%,
105/12/29,-14570,-878,-82,-15530,223001,29989,4704,257694,6.89%,7.96%,
105/12/28,9420,350,-530,9240,237066,30867,4786,272719,7.33%,8.43%,
105/12/27,-2700,-302,303,-2699,226444,30517,5316,262277,7.00%,8.11%,
105/12/26,-3194,-9950,164,-12980,229144,30819,5013,264976,7.08%,8.19%,
105/12/23,-7464,-3270,-350,-11084,228778,40769,4849,274396,7.07%,8.48%,
105/12/22,-9183,-200,66,-9317,220872,44039,5199,270110,6.82%,8.34%,
105/12/21,-10818,0,-1887,-12705,230015,44239,5133,279387,7.11%,8.64%,
105/12/20,-3176,-650,-144,-3970,235905,44239,7020,287164,7.29%,8.88%,
105/12/19,-5971,0,-1646,-7617,239081,44889,7164,291134,7.39%,9.00%,
105/12/16,-9243,-5032,-834,-15109,243402,44889,8810,297101,7.52%,9.18%,
105/12/15,-12901,0,1257,-11644,249795,49921,9644,309360,7.72%,9.56%,
105/12/14,-3368,231,1085,-2052,259496,49921,8387,317804,8.02%,9.82%,
105/12/13,-6139,300,-679,-6518,259180,49690,7302,316172,8.01%,9.77%,
105/12/12,-739,0,-521,-1260,265319,49390,7981,322690,8.20%,9.97%,
105/12/09,-6845,600,-3108,-9353,264558,49390,8502,322450,8.18%,9.97%,
105/12/08,-7784,-2398,726,-9456,267096,48790,11610,327496,8.25%,10.12%,
105/12/07,-5941,-2698,185,-8454,272887,51188,10884,334959,8.43%,10.35%,
105/12/06,-7395,0,213,-7182,275676,53886,10699,340261,8.52%,10.52%,
105/12/05,-13247,0,92,-13155,282821,53886,10486,347193,8.74%,10.73%,
105/12/02,-3897,0,-514,-4411,296147,53886,10394,360427,9.15%,11.14%,
105/12/01,-17771,0,1018,-16753,299686,53886,10908,364480,9.26%,11.26%,
105/11/30,-9037,0,100,-8937,315178,53886,9890,378954,9.74%,11.71%,
105/11/29,-99,-350,-1000,-1449,323615,53886,9790,387291,10.00%,11.97%,
105/11/28,-14044,1000,-332,-13376,321894,54236,10790,386920,9.95%,11.96%,
105/11/25,8711,1100,-1856,7955,333248,53236,11122,397606,10.30%,12.29%,
105/11/24,-56298,650,201,-55447,323537,52136,12978,388651,10.00%,12.01%,
105/11/23,6686,1500,-763,7423,379339,51486,12777,443602,11.72%,13.71%,
105/11/22,-14409,19450,-9513,-4472,373102,49986,13540,436628,11.53%,13.49%,
105/11/21,22799,22400,1242,46441,389036,30536,23053,442625,12.02%,13.68%,
105/11/18,6442,600,3231,10273,367187,8136,21811,397134,11.35%,12.28%,
105/11/17,10989,0,499,11488,360483,7536,18580,386599,11.14%,11.95%,
105/11/16,2446,0,153,2599,349483,7536,18081,375100,10.80%,11.59%,
105/11/15,3822,0,393,4215,347037,7536,17928,372501,10.73%,11.52%,
105/11/14,-2941,0,1012,-1929,343215,7536,17535,368286,10.61%,11.39%,
105/11/11,5358,700,2445,8503,345789,7536,16523,369848,10.69%,11.43%,
105/11/10,1890,4796,2004,8690,339431,6836,14078,360345,10.49%,11.14%,
105/11/09,271,1000,-1061,210,337541,2040,12074,351655,10.43%,10.87%,
105/11/08,4814,1000,1659,7473,336938,1040,13135,351113,10.41%,10.85%,
105/11/07,-5945,0,691,-5254,331524,40,11476,343040,10.25%,10.61%,
105/11/04,5399,0,3192,8591,338184,40,10785,349009,10.45%,10.78%,
105/11/03,-2363,-4,-4597,-6964,332785,40,7593,340418,10.29%,10.53%,
105/11/02,-3207,-0,-878,-4085,335298,44,12190,347532,10.36%,10.74%,
105/11/01,-625,0,-168,-793,338205,44,13068,351317,10.45%,10.86%,
105/10/31,2482,0,213,2695,338930,44,13236,352210,10.48%,10.89%,
105/10/28,-199,0,-149,-348,336448,44,13023,349515,10.40%,10.80%,
105/10/27,844,0,1253,2097,336710,44,13172,349926,10.41%,10.82%,
105/10/26,-2432,0,2053,-379,335866,44,11919,347829,10.38%,10.75%,
105/10/25,3694,0,1780,5474,337240,44,9866,347150,10.42%,10.73%,
105/10/24,-902,0,57,-845,333746,44,8086,341876,10.32%,10.57%,
105/10/21,-2366,0,-2213,-4579,334648,44,8029,342721,10.34%,10.59%,
105/10/20,-3131,0,478,-2653,336614,44,10242,346900,10.40%,10.72%,
105/10/19,-1956,0,796,-1160,339745,44,9764,349553,10.50%,10.80%,
105/10/18,-2273,0,60,-2213,341702,44,8968,350714,10.56%,10.84%,
105/10/17,13,0,-119,-106,345639,44,8908,354591,10.68%,10.96%,
105/10/14,-848,0,-708,-1556,345626,44,9027,354697,10.68%,10.96%,
105/10/13,-934,0,608,-326,346474,44,9735,356253,10.71%,11.01%,
105/10/12,3083,0,408,3491,346448,44,9127,355619,10.71%,10.99%,
105/10/11,2027,0,-6096,-4069,343581,44,8719,352344,10.62%,10.89%,
105/10/07,-11624,0,-248,-11872,339554,44,14815,354413,10.49%,10.95%,
105/10/06,4453,0,751,5204,352083,44,15063,367190,10.88%,11.35%,
105/10/05,1785,0,-44,1741,346994,44,14312,361350,10.72%,11.16%,
105/10/04,-11576,0,2370,-9206,344509,44,14356,358909,10.65%,11.10%,
105/10/03,13307,0,1176,14483,356036,44,11986,368066,11.00%,11.37%,
105/09/30,-1587,-1,146,-1442,342545,44,10810,353399,10.59%,10.93%,
105/09/29,241,0,-38,203,344022,25,10664,354711,10.63%,10.96%,
105/09/26,-772,0,2076,1304,343781,25,10702,354508,10.63%,10.96%,
105/09/23,-7834,0,2970,-4864,344498,25,8626,353149,10.65%,10.92%,
105/09/22,1338,0,102,1440,353698,25,5656,359379,10.93%,11.11%,
105/09/21,5780,0,-7989,-2209,351860,25,5554,357439,10.88%,11.05%,
105/09/20,-3724,0,-22,-3746,346780,25,13543,360348,10.72%,11.14%,
105/09/19,584,0,-2390,-1806,350115,25,13565,363705,10.82%,11.24%,
105/09/14,4884,0,-2192,2692,349531,25,15955,365511,10.80%,11.29%,
105/09/13,461,0,-6327,-5866,344327,25,18147,362499,10.64%,11.20%,
105/09/12,401,0,1105,1506,343705,25,24474,368204,10.62%,11.38%,
105/09/10,-26610,0,826,-25784,343857,25,23369,367251,10.63%,11.35%,
105/09/09,16412,0,-2414,13998,370467,25,22543,393035,11.45%,12.15%,
105/09/08,15000,-7,1948,16941,353950,25,24957,378932,10.94%,11.71%,
105/09/07,-3984,0,3697,-287,338950,32,23009,361991,10.48%,11.19%,
105/09/06,21,0,609,630,342795,32,19312,362139,10.59%,11.19%,
105/09/05,-896,0,52,-844,342874,32,18703,361609,10.60%,11.18%,
105/09/02,-894,0,-145,-1039,343770,32,18651,362453,10.63%,11.21%,
105/09/01,-833,0,937,104,344664,32,18796,363492,10.65%,11.23%,
105/08/31,-1526,0,573,-953,345273,32,17859,363164,10.67%,11.22%,
105/08/30,-1333,-2,305,-1030,346799,32,17286,364117,10.72%,11.26%,
105/08/29,-274,-1,-236,-511,348132,34,16981,365147,10.76%,11.29%,
105/08/26,-776,0,0,-776,348273,35,17217,365525,10.76%,11.29%,
105/08/25,-1298,-2,-814,-2114,349049,35,17217,366301,10.79%,11.32%,
105/08/24,-847,0,0,-847,350303,37,18031,368371,10.83%,11.39%,
105/08/23,-904,-2,50,-856,351150,37,18031,369218,10.85%,11.41%,
105/08/22,-1889,0,-371,-2260,351954,39,17981,369974,10.88%,11.44%,
105/08/19,-2559,0,215,-2344,353843,39,18352,372234,10.94%,11.51%,
105/08/18,-1038,0,185,-853,353925,39,18137,372101,10.94%,11.50%,
105/08/17,-736,0,37,-699,354963,39,17952,372954,10.97%,11.53%,
105/08/16,807,0,-133,674,355699,39,17915,373653,10.99%,11.55%,
105/08/15,-37,0,14,-23,354169,39,18048,372256,10.95%,11.51%,
105/08/12,-808,0,-36,-844,354206,39,18034,372279,10.95%,11.51%,
105/08/11,2180,0,-1123,1057,355014,39,18070,373123,10.97%,11.53%,
105/08/10,245,0,-1676,-1431,352834,39,19193,372066,10.91%,11.50%,
105/08/09,-1192,-1,218,-975,351706,39,20869,372614,10.87%,11.52%,
105/08/08,-1743,-1,-595,-2339,352898,40,20651,373589,10.91%,11.55%,
105/08/05,-188,0,495,307,354641,41,21246,375928,10.96%,11.62%,
105/08/04,1713,-3,537,2247,354529,41,20751,375321,10.96%,11.60%,
105/08/03,214,0,-142,72,351364,44,20214,371622,10.86%,11.49%,
105/08/02,1036,0,22,1058,351150,44,20356,371550,10.85%,11.48%,
105/08/01,1225,0,2173,3398,350114,44,20334,370492,10.82%,11.45%,
105/07/29,1544,15,319,1878,348889,44,18161,367094,10.78%,11.34%,
105/07/28,2167,0,-303,1864,347675,29,17842,365546,10.75%,11.30%,
105/07/27,674,0,446,1120,345508,29,18145,363682,10.68%,11.24%,
105/07/26,162,0,463,625,344834,29,17699,362562,10.66%,11.21%,
105/07/25,1734,0,-1602,132,344672,29,17236,361937,10.65%,11.18%,
105/07/22,-4527,0,2008,-2519,343238,29,18838,362105,10.61%,11.19%,
105/07/21,2213,-3,779,2989,347139,29,16830,363998,10.73%,11.25%,
105/07/20,1067,0,1308,2375,344874,32,16051,360957,10.66%,11.16%,
105/07/19,5578,-2,494,6070,343807,32,14743,358582,10.63%,11.09%,
105/07/18,927,0,458,1385,338263,34,14249,352546,10.45%,10.89%,
105/07/15,483,0,701,1184,338408,34,13791,352233,10.46%,10.89%,
105/07/14,4643,-3,98,4738,337925,34,13090,351049,10.44%,10.85%,
105/07/13,3692,0,130,3822,335349,37,12992,348378,10.36%,10.76%,
105/07/12,-465,0,697,232,331657,37,12862,344556,10.25%,10.65%,
105/07/11,6462,0,1868,8330,332122,37,12165,344324,10.26%,10.64%,
105/07/07,1271,0,840,2111,326160,37,10297,336494,10.08%,10.40%,
105/07/06,-786,0,-104,-890,324889,37,9457,334383,10.04%,10.33%,
105/07/05,4012,0,688,4700,325675,37,9561,335273,10.07%,10.37%,
105/07/04,1809,0,1853,3662,322100,37,8873,331010,9.96%,10.24%,
105/07/01,4198,0,-90,4108,320955,37,7020,328012,9.92%,10.14%,
105/06/30,3530,0,200,3730,318832,37,7110,325979,9.85%,10.07%,
105/06/29,-2905,0,172,-2733,314902,43,6910,321855,9.73%,9.95%,
105/06/28,-1046,2,616,-428,317807,43,6738,324588,9.82%,10.03%,
105/06/27,615,0,679,1294,318853,41,6122,325016,9.85%,10.04%,
105/06/24,5616,0,-1045,4571,318238,41,5443,323722,9.84%,10.01%,
105/06/23,3343,0,174,3517,312622,41,6488,319151,9.66%,9.86%,
105/06/22,-321,0,0,-321,309279,41,6314,315634,9.56%,9.76%,
105/06/21,-559,0,610,51,309600,41,6314,315955,9.57%,9.77%,
105/06/20,1537,0,-1,1536,310159,41,5704,315904,9.59%,9.77%,
105/06/17,322,0,353,675,308598,41,5705,314344,9.54%,9.72%,
105/06/16,202,0,293,495,308276,41,5352,313669,9.53%,9.70%,
105/06/15,-1421,0,-558,-1979,306974,41,5059,312074,9.49%,9.65%,
105/06/14,-147,0,648,501,308395,41,5617,314053,9.53%,9.70%,
105/06/13,-297,0,-157,-454,308542,41,4969,313552,9.54%,9.69%,
105/06/08,1287,0,302,1589,308839,41,5126,314006,9.54%,9.70%,
105/06/07,2751,0,-506,2245,307552,41,4824,312417,9.51%,9.66%,
105/06/06,-2144,0,3,-2141,304800,41,5330,310171,9.42%,9.59%,
105/06/04,0,0,194,194,276246,41,5327,281614,8.54%,8.71%,
105/06/03,997,0,3824,4821,276246,41,5133,281420,8.54%,8.70%,
105/06/02,-194,0,-19,-213,275249,41,1309,276599,8.51%,8.55%,
105/06/01,-138,0,-32,-170,275756,41,1328,277125,8.52%,8.56%,
105/05/31,-1345,0,-80,-1425,275894,41,1360,277295,8.53%,8.57%,
105/05/30,-3620,0,78,-3542,277240,41,1440,278721,8.57%,8.62%,
105/05/27,2269,0,11,2280,282160,41,1362,283563,8.72%,8.76%,
105/05/26,1179,3,28,1210,279891,41,1351,281283,8.65%,8.69%,
105/05/25,1388,0,46,1434,278712,38,1323,280073,8.61%,8.65%,
105/05/24,2841,0,1277,4118,277708,38,1277,279023,8.58%,8.62%,
105/05/23,1148,0,-476,672,274867,38,0,274905,8.49%,8.49%,
105/05/20,-696,0,-735,-1431,273719,38,0,273757,8.46%,8.46%,
105/05/19,-2368,0,-29,-2397,274407,38,28,274473,8.48%,8.48%,
105/05/18,-1322,0,57,-1265,276775,38,57,276870,8.55%,8.55%,
105/05/17,1170,0,0,1170,278097,38,0,278135,8.59%,8.59%,
105/05/16,1901,0,-23,1878,276903,38,0,276941,8.56%,8.56%,
105/05/13,148,0,-210,-62,273002,38,0,273040,8.44%,8.44%,
105/05/12,-173,0,-4,-177,272854,38,133,273025,8.43%,8.44%,
105/05/11,-1857,0,0,-1857,273027,38,137,273202,8.44%,8.45%,
105/05/10,-1801,-23,137,-1687,273884,38,137,274059,8.46%,8.47%,
105/05/09,-1601,0,-2,-1603,278889,61,0,278950,8.62%,8.62%,
105/05/06,-2909,0,-8,-2917,278665,61,0,278726,8.61%,8.61%,
105/05/05,-949,0,2,-947,281276,61,5,281342,8.69%,8.69%,
105/05/04,-1973,0,3,-1970,281093,61,3,281157,8.69%,8.69%,
105/05/03,-1534,0,-20,-1554,277060,61,0,277121,8.56%,8.56%,
105/04/29,-1903,0,-207,-2110,278129,61,0,278190,8.60%,8.60%,
105/04/28,-828,0,-263,-1091,275032,61,0,275093,8.50%,8.50%,
105/04/27,-997,0,-5,-1002,275860,61,0,275921,8.53%,8.53%,
105/04/26,-1414,0,-1,-1415,275918,61,0,275979,8.53%,8.53%,
105/04/25,-1367,3,-61,-1425,276582,61,0,276643,8.55%,8.55%,
105/04/22,-2470,0,-5,-2475,276949,58,0,277007,8.56%,8.56%,
105/04/21,-1588,0,-48,-1636,274419,58,0,274477,8.48%,8.48%,
105/04/20,-998,0,-233,-1231,275257,58,0,275315,8.51%,8.51%,
105/04/19,-1987,0,-71,-2058,275855,58,176,276089,8.53%,8.54%,
105/04/18,-845,0,-25,-870,275842,58,247,276147,8.52%,8.53%,
105/04/15,-1208,0,-52,-1260,274601,58,272,274931,8.49%,8.50%,
105/04/14,-597,0,-40,-637,275809,58,324,276191,8.52%,8.53%,
105/04/13,-953,0,-50,-1003,276396,58,364,276818,8.54%,8.55%,
105/04/12,-1856,-3,-16,-1875,277606,58,414,278078,8.58%,8.59%,
105/04/11,419,0,-18,401,280413,61,430,280904,8.67%,8.69%,
105/04/08,97,0,153,250,281194,61,448,281703,8.69%,8.71%,
105/04/07,458,0,62,520,286509,61,295,286865,8.85%,8.86%,
105/04/06,1962,0,-60,1902,289097,61,233,289391,8.93%,8.94%,
105/04/01,5048,0,71,5119,291698,61,293,292052,9.01%,9.02%,
105/03/31,6178,0,73,6251,296607,61,222,296890,9.17%,9.18%,
105/03/30,5251,0,0,5251,290429,53,149,290631,8.98%,8.99%,
105/03/29,2068,-1,-40,2027,287855,53,149,288057,8.90%,8.91%,
105/03/28,2519,0,-8,2511,285983,54,189,286226,8.84%,8.85%,
105/03/25,123,0,0,123,287506,54,197,287757,8.89%,8.90%,
105/03/24,2272,0,-63,2209,288132,54,197,288383,8.90%,8.91%,
105/03/23,1556,0,-117,1439,286090,54,260,286404,8.84%,8.85%,
105/03/22,1166,0,-16,1150,284534,54,377,284965,8.79%,8.80%,
105/03/21,-538,0,-88,-626,282491,54,393,282938,8.73%,8.74%,
105/03/18,2582,0,-49,2533,282838,54,481,283373,8.74%,8.76%,
105/03/17,246,0,-303,-57,281038,54,530,281622,8.69%,8.71%,
105/03/16,733,1,-389,345,280677,54,833,281564,8.67%,8.70%,
105/03/15,-357,-1,-526,-884,279949,53,1222,281224,8.65%,8.69%,
105/03/14,-731,0,111,-620,280218,54,1748,282020,8.66%,8.72%,
105/03/11,819,0,-429,390,280949,54,1637,282640,8.68%,8.73%,
105/03/10,3851,0,563,4414,280105,54,2066,282225,8.66%,8.73%,
105/03/09,415,0,-706,-291,277522,54,1503,279079,8.58%,8.63%,
105/03/08,6194,-5,1590,7779,277606,54,2209,279869,8.58%,8.65%,
105/03/07,349,0,-60,289,271672,59,619,272350,8.40%,8.42%,
105/03/04,4630,0,31,4661,271015,59,679,271753,8.38%,8.40%,
105/03/03,354,0,-1522,-1168,266385,59,648,267092,8.23%,8.25%,
105/03/02,1355,-5,-4,1346,268331,59,2170,270560,8.29%,8.36%,
105/03/01,247,0,-392,-145,275326,64,2174,277564,8.51%,8.58%,
105/02/26,2724,0,-505,2219,274836,64,2566,277466,8.49%,8.57%,
105/02/25,2312,0,-274,2038,272898,64,3071,276033,8.43%,8.53%,
105/02/24,8680,0,201,8881,272632,64,3345,276041,8.43%,8.54%,
105/02/23,1743,0,1204,2947,263942,64,3144,267150,8.16%,8.26%,
105/02/22,-291,0,-233,-524,260589,64,1940,262593,8.05%,8.11%,
105/02/19,388,1,-114,275,260870,64,2173,263107,8.06%,8.13%,
105/02/18,359,0,-35,324,260472,63,2287,262822,8.05%,8.12%,
105/02/17,-466,0,-242,-708,260047,63,2322,262432,8.04%,8.11%,
105/02/16,-2429,0,118,-2311,260233,63,2564,262860,8.04%,8.12%,
105/02/15,-1807,5,30,-1772,262798,63,2446,265307,8.12%,8.20%,
105/02/03,-1742,0,-3225,-4967,264627,58,2416,267101,8.18%,8.26%,
105/02/02,-137,0,-294,-431,266960,58,5641,272659,8.25%,8.43%,
105/02/01,315,0,-101,214,266949,58,5935,272942,8.25%,8.44%,
105/01/30,0,0,-1295,-1295,266634,58,6036,272728,8.24%,8.43%,
105/01/29,1454,0,-2837,-1383,266634,58,7331,274023,8.24%,8.47%,
105/01/28,1693,0,-385,1308,265556,58,10168,275782,8.21%,8.53%,
105/01/27,-646,0,-138,-784,263233,58,10553,273844,8.13%,8.46%,
105/01/26,3628,0,1848,5476,263879,58,10691,274628,8.15%,8.48%,
105/01/25,4109,0,865,4974,260251,58,8843,269152,8.04%,8.32%,
105/01/22,-5485,0,-1581,-7066,256227,58,7978,264263,7.92%,8.17%,
105/01/21,1132,0,954,2086,263412,58,9559,273029,8.14%,8.44%,
105/01/20,-3223,0,5825,2602,265170,58,8605,273833,8.19%,8.46%,
105/01/19,4491,0,1684,6175,274221,58,2780,277059,8.47%,8.56%,
105/01/18,3088,0,1096,4184,270606,58,1096,271760,8.36%,8.40%,
105/01/15,1299,0,-116,1183,267518,58,0,267576,8.27%,8.27%,
105/01/14,2654,0,27,2681,266220,58,55,266333,8.23%,8.23%,
105/01/13,2652,0,28,2680,265115,58,28,265201,8.19%,8.19%,
105/01/12,3900,0,-34,3866,262252,58,0,262310,8.10%,8.10%,
105/01/11,454,0,-37,417,258599,58,0,258657,7.99%,7.99%,
105/01/08,-584,0,-124,-708,258299,58,7,258364,7.98%,7.98%,
105/01/07,-245,0,-168,-413,256433,58,131,256622,7.92%,7.93%,
105/01/06,-594,0,-531,-1125,256078,58,299,256435,7.91%,7.92%,
105/01/05,20,0,-325,-305,257568,58,830,258456,7.96%,7.99%,
105/01/04,-164,0,-183,-347,256652,58,1155,257865,7.93%,7.97%,
104/12/31,-163,0,-247,-410,256816,58,1338,258212,7.94%,7.98%,
104/12/30,-1055,0,26,-1029,256953,63,1585,258601,7.94%,7.99%,
104/12/29,-206,0,-284,-490,257728,63,1559,259350,7.96%,8.01%,
104/12/28,-1108,0,170,-938,257924,63,1843,259830,7.97%,8.03%,
104/12/25,356,0,769,1125,259022,63,1673,260758,8.00%,8.05%,
104/12/24,-80,0,13,-67,258506,63,904,259473,7.99%,8.02%,
104/12/23,1022,0,-117,905,258576,63,891,259530,7.99%,8.02%,
104/12/22,-2812,0,-243,-3055,258554,63,1008,259625,7.99%,8.02%,
104/12/21,1938,0,785,2723,262210,63,1251,263524,8.10%,8.14%,
104/12/18,2164,0,-6,2158,260252,63,466,260781,8.04%,8.06%,
104/12/17,-304,0,0,-304,258078,63,472,258613,7.98%,8.00%,
104/12/16,-532,0,-24,-556,257368,63,472,257903,7.95%,7.97%,
104/12/15,-673,0,-8,-681,257847,63,496,258406,7.97%,7.99%,
104/12/14,167,3,40,210,258506,63,504,259073,7.99%,8.01%,
104/12/11,821,0,-254,567,257679,60,464,258203,7.96%,7.98%,
104/12/10,734,0,-63,671,256858,60,718,257636,7.94%,7.96%,
104/12/09,1625,0,-167,1458,257838,60,781,258679,7.97%,8.00%,
104/12/08,1770,0,-57,1713,256213,60,948,257221,7.92%,7.95%,
104/12/07,-488,0,6,-482,254443,60,1005,255508,7.86%,7.89%,
104/12/04,433,0,-107,326,254915,60,999,255974,7.88%,7.91%,
104/12/03,-1427,0,-271,-1698,255896,60,1106,257062,7.91%,7.95%,
104/12/02,153,0,-222,-69,257323,60,1377,258760,7.95%,7.99%,
104/12/01,-902,0,-265,-1167,256770,60,1599,258429,7.93%,7.98%,
104/11/30,-3179,0,255,-2924,257172,60,1864,259096,7.95%,8.01%,
104/11/27,1687,0,916,2603,261284,60,1609,262953,8.07%,8.12%,
104/11/26,2246,0,10,2256,259797,60,693,260550,8.03%,8.05%,
104/11/25,3607,0,-548,3059,257551,60,683,258294,7.96%,7.98%,
104/11/24,-138,0,-38,-176,254494,60,1231,255785,7.86%,7.90%,
104/11/23,528,0,-608,-80,254632,60,1269,255961,7.87%,7.91%,
104/11/20,383,0,-190,193,254104,60,1877,256041,7.85%,7.91%,
104/11/19,-1087,0,426,-661,254378,60,2067,256505,7.86%,7.93%,
104/11/18,-590,0,-36,-626,255265,60,1641,256966,7.89%,7.94%,
104/11/17,1489,0,-178,1311,255855,60,1677,257592,7.91%,7.96%,
104/11/16,-692,0,-129,-821,254366,60,1855,256281,7.86%,7.92%,
104/11/13,-1291,0,-197,-1488,255318,60,1984,257362,7.89%,7.95%,
104/11/12,-782,0,-199,-981,256609,60,2181,258850,7.93%,8.00%,
104/11/11,2111,0,-256,1855,257391,60,2380,259831,7.95%,8.03%,
104/11/10,-1675,0,-646,-2321,255280,60,2636,257976,7.89%,7.97%,
104/11/09,-1106,0,-783,-1889,256955,60,3282,260297,7.94%,8.04%,
104/11/06,-955,0,-828,-1783,257041,60,4065,261166,7.94%,8.07%,
104/11/05,353,0,873,1226,258095,60,4893,263048,7.98%,8.13%,
104/11/04,1632,5,352,1989,257742,60,4020,261822,7.96%,8.09%,
104/11/03,78,0,180,258,256110,55,3668,259833,7.91%,8.03%,
104/11/02,1051,0,-61,990,255008,55,3488,258551,7.88%,7.99%,
104/10/30,-690,0,-170,-860,255798,55,3549,259402,7.90%,8.01%,
104/10/29,790,0,-558,232,256216,55,3719,259990,7.92%,8.04%,
104/10/28,-814,0,-12,-826,255826,55,4277,260158,7.91%,8.04%,
104/10/27,-774,0,1154,380,255940,55,4289,260284,7.91%,8.04%,
104/10/26,286,0,11,297,255813,55,3135,259003,7.91%,8.01%,
104/10/23,-1441,0,-68,-1509,252527,55,3124,255706,7.80%,7.90%,
104/10/22,164,0,0,164,253168,55,3192,256415,7.82%,7.92%,
104/10/21,-823,0,-443,-1266,252390,55,3192,255637,7.80%,7.90%,
104/10/20,-167,0,-49,-216,253142,55,3635,256832,7.82%,7.93%,
104/10/19,-1853,0,-127,-1980,253642,55,3684,257381,7.84%,7.96%,
104/10/16,-1720,0,60,-1660,255495,55,3811,259361,7.90%,8.02%,
104/10/15,-1019,0,598,-421,257134,55,3751,260940,7.95%,8.07%,
104/10/14,-664,0,207,-457,258525,55,3153,261733,7.99%,8.09%,
104/10/13,-495,0,-44,-539,258864,55,2946,261865,8.00%,8.09%,
104/10/12,1360,0,10,1370,256989,55,2990,260034,7.94%,8.03%,
104/10/08,492,0,-55,437,254557,55,2980,257592,7.87%,7.96%,
104/10/07,-800,0,-230,-1030,255638,55,3035,258728,7.90%,8.00%,
104/10/06,-2335,0,-107,-2442,254258,55,3265,257578,7.86%,7.96%,
104/10/05,714,0,492,1206,256413,55,3372,259840,7.92%,8.03%,
104/10/02,-3148,0,-334,-3482,255689,55,2880,258624,7.90%,7.99%,
104/10/01,780,0,135,915,257837,55,3214,261106,7.97%,8.07%,
104/09/30,1635,0,-168,1467,252057,55,3079,255191,7.79%,7.88%,
104/09/25,-1540,0,-889,-2429,250422,53,3247,253722,7.74%,7.84%,
104/09/24,12,0,144,156,252657,53,4136,256846,7.81%,7.94%,
104/09/23,-1063,0,-226,-1289,252843,53,3992,256888,7.81%,7.93%,
104/09/22,4760,53,-566,4247,253907,53,4218,258178,7.85%,7.98%,
104/09/21,-4260,-42,-386,-4688,249147,0,4784,253931,7.70%,7.84%,
104/09/18,-4477,-520,21,-4976,253407,0,5170,258577,7.83%,7.99%,
104/09/17,-2999,0,-631,-3630,257717,365,5149,263231,7.96%,8.13%,
104/09/16,-210,0,1056,846,259616,365,5780,265761,8.02%,8.21%,
104/09/15,-134,0,863,729,258826,365,4724,263915,8.00%,8.15%,
104/09/14,948,0,-426,522,258635,365,3861,262861,7.99%,8.12%,
104/09/11,-3021,1,-63,-3083,258687,365,4287,263339,7.99%,8.13%,
104/09/10,-78,0,132,54,261007,364,4350,265721,8.07%,8.21%,
104/09/09,-1913,0,-25,-1938,261585,364,4218,266167,8.08%,8.22%,
104/09/08,141,0,-278,-137,264088,364,4243,268695,8.16%,8.30%,
104/09/07,462,0,-113,349,264437,364,4521,269322,8.17%,8.32%,
104/09/04,575,-6,-348,221,266520,364,4634,271518,8.24%,8.39%,
104/09/03,-1700,0,523,-1177,267465,370,4982,272817,8.27%,8.43%,
104/09/02,8489,0,2873,11362,270660,370,4459,275489,8.36%,8.51%,
104/09/01,1048,-6,753,1795,262172,370,1586,264128,8.10%,8.16%,
104/08/31,-1493,-3,-153,-1649,261424,376,833,262633,8.08%,8.12%,
104/08/28,-6118,0,695,-5423,265217,379,986,266582,8.03%,8.07%,
104/08/27,645,0,190,835,271034,379,291,271704,8.21%,8.23%,
104/08/26,6688,0,48,6736,274472,379,101,274952,8.31%,8.32%,
104/08/25,1519,-56,-55,1408,268037,379,53,268469,8.11%,8.12%,
104/08/24,7316,0,4,7320,266518,435,108,267061,8.07%,8.09%,
104/08/21,975,0,-48,927,259452,435,104,259991,7.85%,7.87%,
104/08/20,343,0,-40,303,257569,435,152,258156,7.80%,7.82%,
104/08/19,-3651,0,-88,-3739,256926,435,192,257553,7.78%,7.80%,
104/08/18,-132,0,-18,-150,258307,435,280,259022,7.82%,7.84%,
104/08/17,1000,0,226,1226,257609,435,298,258342,7.80%,7.82%,
104/08/14,71,0,14,85,257009,435,72,257516,7.78%,7.80%,
104/08/13,745,0,6,751,257288,435,58,257781,7.79%,7.80%,
104/08/12,-2134,0,52,-2082,256343,435,52,256830,7.76%,7.77%,
104/08/11,-2734,0,-225,-2959,260016,435,0,260451,7.87%,7.88%,
104/08/10,2948,0,-139,2809,271768,435,0,272203,8.23%,8.24%,
104/08/07,-2906,0,-337,-3243,268820,435,0,269255,8.14%,8.15%,
104/08/06,-3516,0,41,-3475,272727,435,215,273377,8.26%,8.28%,
104/08/05,216,0,144,360,276243,435,174,276852,8.36%,8.38%,
104/08/04,-973,0,30,-943,276917,435,30,277382,8.38%,8.39%,
104/08/03,227,0,-428,-201,277930,435,0,278365,8.41%,8.42%,
104/07/31,-4943,0,-381,-5324,278103,435,118,278656,8.42%,8.44%,
104/07/30,1167,0,-25,1142,286316,435,499,287250,8.67%,8.70%,
104/07/29,600,0,0,600,285149,435,524,286108,8.63%,8.66%,
104/07/28,3565,0,274,3839,286549,435,524,287508,8.68%,8.71%,
104/07/27,632,0,152,784,282084,435,250,282769,8.54%,8.56%,
104/07/24,-726,3,21,-702,281452,435,98,281985,8.52%,8.54%,
104/07/23,843,0,2,845,281821,432,77,282330,8.53%,8.55%,
104/07/22,1693,0,75,1768,282552,432,75,283059,8.55%,8.57%,
104/07/21,3339,5,-116,3228,282003,432,0,282435,8.54%,8.55%,
104/07/20,2245,0,-392,1853,278675,427,0,279102,8.44%,8.45%,
104/07/17,-210,-153,-113,-476,276442,427,0,276869,8.37%,8.38%,
104/07/16,272,0,-144,128,274843,580,0,275423,8.32%,8.34%,
104/07/15,-1538,0,-72,-1610,274568,580,73,275221,8.31%,8.33%,
104/07/14,234,0,123,357,272120,580,145,272845,8.24%,8.26%,
104/07/13,-208,-1,-49,-258,271553,580,22,272155,8.22%,8.24%,
104/07/09,1665,0,-48,1617,272904,581,71,273556,8.26%,8.28%,
104/07/08,1694,0,-434,1260,271239,581,119,271939,8.21%,8.23%,
104/07/07,679,0,-139,540,270465,581,553,271599,8.19%,8.22%,
104/07/06,1581,0,-237,1344,273243,581,692,274516,8.27%,8.31%,
104/07/03,-2949,0,-121,-3070,271662,581,929,273172,8.22%,8.27%,
104/07/02,-1257,0,-89,-1346,273991,581,1050,275622,8.29%,8.34%,
104/07/01,-385,0,-126,-511,274248,581,1139,275968,8.30%,8.35%,
104/06/30,-4461,0,135,-4326,274633,581,1265,276479,8.31%,8.37%,
104/06/29,4047,0,-508,3539,277996,770,1130,279896,8.42%,8.48%,
104/06/26,84,0,73,157,273442,770,1638,275850,8.28%,8.35%,
104/06/25,1630,0,-498,1132,273700,770,1565,276035,8.29%,8.36%,
104/06/24,-3158,0,-200,-3358,270855,770,2063,273688,8.20%,8.29%,
104/06/23,1483,0,32,1515,272730,770,2263,275763,8.26%,8.35%,
104/06/22,2638,0,248,2886,271188,770,2231,274189,8.21%,8.30%,
104/06/18,-816,-5,-103,-924,268466,770,1983,271219,8.13%,8.21%,
104/06/17,-2106,0,59,-2047,268583,775,2086,271444,8.13%,8.22%,
104/06/16,-2259,0,-10,-2269,270305,775,2027,273107,8.18%,8.26%,
104/06/15,-979,0,-1,-980,271554,775,2037,274366,8.22%,8.31%,
104/06/12,1980,0,59,2039,271331,775,2038,274144,8.21%,8.30%,
104/06/11,-1555,0,-884,-2439,268779,775,1979,271533,8.14%,8.22%,
104/06/10,-894,0,217,-677,270346,775,2863,273984,8.18%,8.29%,
104/06/09,-2186,0,-1274,-3460,270084,775,2646,273505,8.18%,8.28%,
104/06/08,520,0,90,610,260037,775,3920,264732,7.87%,8.01%,
104/06/05,-4127,-110,-931,-5168,258291,775,3830,262896,7.82%,7.96%,
104/06/04,-2171,-1,203,-1969,261443,886,4761,267090,7.91%,8.08%,
104/06/03,-473,0,338,-135,258775,887,4558,264220,7.83%,7.99%,
104/06/02,-2838,0,-12,-2850,257243,887,4220,262350,7.79%,7.94%,
104/06/01,-1420,0,-558,-1978,258861,887,4232,263980,7.84%,8.00%,
104/05/29,-799,0,44,-755,260080,887,4790,265757,7.87%,8.04%,
104/05/28,169,-7,-370,-208,260879,887,4746,266512,7.90%,8.07%,
104/05/27,-1229,0,551,-678,261064,894,5116,267074,7.90%,8.08%,
104/05/26,90,0,-15,75,262700,894,4565,268159,7.95%,8.12%,
104/05/25,825,0,349,1174,265734,894,4580,271208,8.04%,8.21%,
104/05/22,-498,0,-286,-784,263845,894,4231,268970,7.99%,8.15%,
104/05/21,-149,0,-1379,-1528,264433,894,4517,269844,8.01%,8.17%,
104/05/20,-1838,0,2019,181,264356,894,5896,271146,8.00%,8.21%,
104/05/19,335,0,384,719,266625,894,3877,271396,8.07%,8.21%,
104/05/18,-1396,0,17,-1379,266170,894,3493,270557,8.06%,8.19%,
104/05/15,-543,0,-249,-792,263480,894,3476,267850,7.98%,8.11%,
104/05/14,-1477,2,40,-1435,264089,894,3725,268708,7.99%,8.13%,
104/05/13,1618,0,71,1689,263621,892,3685,268198,7.98%,8.12%,
104/05/12,-14,0,194,180,261877,892,3614,266383,7.93%,8.07%,
104/05/11,-6,1,-618,-623,261725,892,3420,266037,7.92%,8.05%,
104/05/08,-2465,0,-1470,-3935,263190,891,4038,268119,7.97%,8.12%,
104/05/07,-776,0,-54,-830,261079,891,5508,267478,7.90%,8.09%,
104/05/06,-3263,0,-714,-3977,260879,891,5562,267332,7.90%,8.10%,
104/05/05,-300,0,4234,3934,258491,891,6276,265658,7.83%,8.05%,
104/05/04,-710,0,15,-695,257901,891,2042,260834,7.81%,7.90%,
104/04/30,-71,-1,5,-67,256303,891,2027,259221,7.76%,7.85%,
104/04/29,1439,0,69,1508,256553,892,2022,259467,7.77%,7.86%,
104/04/28,364,3,-217,150,254851,892,1953,257696,7.71%,7.80%,
104/04/27,-304,0,1128,824,257174,889,2170,260233,7.79%,7.88%,
104/04/24,7016,0,11,7027,255012,889,1042,256943,7.72%,7.78%,
104/04/23,-2175,0,420,-1755,247219,889,1031,249139,7.48%,7.54%,
104/04/22,-724,0,611,-113,245287,889,611,246787,7.43%,7.48%,
104/04/21,-4019,0,-189,-4208,245867,889,0,246756,7.44%,7.47%,
104/04/20,-4369,-26,-139,-4534,248863,889,17,249769,7.53%,7.56%,
104/04/17,-3583,0,-166,-3749,251112,915,156,252183,7.60%,7.63%,
104/04/16,-3785,0,-131,-3916,244544,915,322,245781,7.40%,7.44%,
104/04/15,-4622,207,-229,-4644,246692,915,453,248060,7.47%,7.51%,
104/04/14,-649,0,61,-588,247864,708,682,249254,7.50%,7.54%,
104/04/13,-847,0,-33,-880,247027,708,621,248356,7.48%,7.52%,
104/04/10,-1504,0,-156,-1660,247727,708,654,249089,7.50%,7.54%,
104/04/09,-751,0,217,-534,249231,708,810,250749,7.54%,7.59%,
104/04/08,3423,0,31,3454,249982,708,593,251283,7.57%,7.61%,
104/04/07,851,0,-792,59,246558,708,562,247828,7.46%,7.50%,
104/04/02,-1368,0,-183,-1551,246025,708,1354,248087,7.45%,7.51%,
104/04/01,228,0,-823,-595,247634,708,1537,249879,7.50%,7.57%,
104/03/31,463,0,-260,203,247649,708,2360,250717,7.50%,7.59%,
104/03/30,977,0,-1087,-110,247982,774,2620,251376,7.51%,7.61%,
104/03/27,983,0,-855,128,247673,774,3707,252154,7.50%,7.64%,
104/03/26,-5,0,-103,-108,246405,774,4562,251741,7.46%,7.62%,
104/03/25,-555,0,-163,-718,246617,774,4665,252056,7.47%,7.63%,
104/03/24,428,0,-124,304,246978,774,4828,252580,7.48%,7.65%,
104/03/23,1004,0,-65,939,246483,774,4952,252209,7.46%,7.63%,
104/03/20,-997,3,75,-919,245480,774,5017,251271,7.43%,7.61%,
104/03/19,1485,0,-921,564,246477,771,4942,252190,7.46%,7.63%,
104/03/18,-1928,0,-1392,-3320,245532,771,5863,252166,7.43%,7.63%,
104/03/17,-1538,0,-89,-1627,246300,771,7255,254326,7.46%,7.70%,
104/03/16,-1426,-182,-6,-1614,247805,771,7344,255920,7.50%,7.75%,
104/03/13,-2031,0,-222,-2253,249401,953,7350,257704,7.55%,7.80%,
104/03/12,-10844,-1,429,-10416,252197,953,7572,260722,7.63%,7.89%,
104/03/11,-5714,0,-493,-6207,262882,954,7143,270979,7.96%,8.21%,
104/03/10,-1585,0,-1750,-3335,268131,954,7636,276721,8.12%,8.38%,
104/03/09,-5072,0,-1541,-6613,269516,954,9386,279856,8.16%,8.47%,
104/03/06,-2583,-6,1427,-1162,274278,954,10927,286159,8.30%,8.66%,
104/03/05,-4382,0,3033,-1349,276756,960,9500,287216,8.38%,8.70%,
104/03/04,-3388,0,14,-3374,281138,960,6467,288565,8.51%,8.73%,
104/03/03,-3662,0,-77,-3739,282149,960,6453,289562,8.54%,8.76%,
104/03/02,-151,0,-509,-660,285811,960,6530,293301,8.65%,8.88%,
104/02/26,-3130,0,1692,-1438,286694,960,7039,294693,8.68%,8.92%,
104/02/25,-321,-1622,-215,-2158,289818,960,5347,296125,8.77%,8.96%,
104/02/24,-3634,0,265,-3369,291355,2582,5562,299499,8.82%,9.07%,
104/02/13,-736,-1601,-675,-3012,294876,2582,5297,302755,8.93%,9.17%,
104/02/12,-2413,0,-789,-3202,295925,4183,5972,306080,8.96%,9.27%,
104/02/11,-5089,0,1420,-3669,297980,4183,6761,308924,9.02%,9.35%,
104/02/10,-506,0,-580,-1086,303549,4183,5341,313073,9.19%,9.48%,
104/02/09,-3798,4,-369,-4163,303814,4183,5921,313918,9.20%,9.51%,
104/02/06,-6017,0,561,-5456,307359,4179,6290,317828,9.31%,9.63%,
104/02/05,-2972,0,35,-2937,313531,4179,5729,323439,9.49%,9.79%,
104/02/04,-5657,-60,-361,-6078,316794,4179,5694,326667,9.59%,9.89%,
104/02/03,-9979,0,816,-9163,322141,4239,6055,332435,9.75%,10.06%,
104/02/02,-3323,0,-168,-3491,331412,4239,5239,340890,10.03%,10.32%,
104/01/30,-4853,0,-258,-5111,333687,4239,5407,343333,10.10%,10.39%,
104/01/29,-7355,0,1275,-6080,332416,4239,5665,342320,10.06%,10.36%,
104/01/28,-1687,0,38,-1649,339676,4239,4390,348305,10.28%,10.54%,
104/01/27,-2553,0,-110,-2663,341324,4239,4352,349915,10.33%,10.59%,
104/01/26,-3124,0,-216,-3340,343256,4239,4462,351957,10.39%,10.65%,
104/01/23,-8305,0,-952,-9257,345806,4239,4678,354723,10.47%,10.74%,
104/01/22,-6345,0,2031,-4314,354584,4239,5630,364453,10.74%,11.04%,
104/01/21,-4467,0,-784,-5251,360929,4239,3599,368767,10.93%,11.17%,
104/01/20,1563,0,-115,1448,364500,4239,4383,373122,11.04%,11.30%,
104/01/19,-3591,0,-75,-3666,363537,4239,4498,372274,11.01%,11.27%,
104/01/16,-2283,0,-2999,-5282,367048,4239,4573,375860,11.11%,11.38%,
104/01/15,-267,0,-775,-1042,371276,4239,7573,383088,11.24%,11.60%,
104/01/14,-247,0,247,0,371543,4239,8348,384130,11.25%,11.63%,
104/01/13,1429,0,-601,828,372583,4239,8101,384923,11.28%,11.65%,
104/01/12,-2437,0,-1405,-3842,370992,4239,8702,383933,11.23%,11.62%,
104/01/09,-3812,0,-2092,-5904,373421,4239,10107,387767,11.31%,11.74%,
104/01/08,-870,0,2373,1503,377120,4239,12199,393558,11.42%,11.92%,
104/01/07,678,-6,181,853,381567,4239,9825,395631,11.55%,11.98%,
104/01/06,-1661,0,-4043,-5704,380770,4245,9644,394659,11.53%,11.95%,
104/01/05,-7449,0,5521,-1928,382792,4245,13687,400724,11.59%,12.13%,
