日期,外資買賣超,投信買賣超,自營商買賣超,單日合計買賣超,外資估計持股,投信估計持股,自營商估計持股,單日合計估計持股,外資持股比重,三大法人持股比重,
107/03/31,10,30,20,60,95338,4984,2407,102729,31.99%,34.47%,
107/03/30,-94,358,26,290,95328,4954,2387,102669,31.99%,34.45%,
107/03/29,-485,332,2,-151,95468,4596,2361,102425,32.04%,34.37%,
107/03/28,-627,162,12,-453,95930,4264,2359,102553,32.19%,34.41%,
107/03/27,-290,-4,32,-262,96591,4102,2347,103040,32.41%,34.57%,
107/03/26,329,-51,0,278,96987,4106,2315,103408,32.55%,34.70%,
107/03/23,-943,-34,40,-937,96610,4157,2315,103082,32.42%,34.59%,
107/03/22,-436,113,57,-266,97533,4191,2275,103999,32.73%,34.90%,
107/03/21,-1269,74,-29,-1224,97969,4078,2218,104265,32.87%,34.98%,
107/03/20,-789,-49,4,-834,99233,4004,2247,105484,33.30%,35.40%,
107/03/19,-2318,-285,57,-2546,100021,4053,2243,106317,33.56%,35.67%,
107/03/16,-2893,627,82,-2184,102356,4338,2186,108880,34.35%,36.54%,
107/03/15,-2776,504,55,-2217,105249,3711,2104,111064,35.32%,37.27%,
107/03/14,-2104,-170,4,-2270,108025,3207,2049,113281,36.25%,38.01%,
107/03/13,-815,-109,-8,-932,110117,3377,2045,115539,36.95%,38.77%,
107/03/12,-72,-291,-55,-418,110889,3486,2053,116428,37.21%,39.07%,
107/03/09,15,-235,-77,-297,110961,3777,2108,116846,37.23%,39.21%,
107/03/08,-748,0,-10,-758,110936,4012,2185,117133,37.23%,39.31%,
107/03/07,-126,-94,1,-219,111688,4012,2195,117895,37.48%,39.56%,
107/03/06,11,-138,8,-119,111835,4106,2194,118135,37.53%,39.64%,
107/03/05,-278,-95,15,-358,111882,4244,2186,118312,37.54%,39.70%,
107/03/02,-237,-41,-3,-281,112154,4339,2171,118664,37.64%,39.82%,
107/03/01,-287,-104,-2,-393,112384,4380,2174,118938,37.71%,39.91%,
107/02/27,-224,-11,-28,-263,112528,4484,2176,119188,37.76%,40.00%,
107/02/26,-262,-71,-22,-355,112742,4495,2204,119441,37.83%,40.08%,
107/02/23,-22,-395,-4,-421,113167,4566,2226,119959,37.98%,40.26%,
107/02/22,-500,-272,-14,-786,113188,4961,2230,120379,37.98%,40.39%,
107/02/21,-987,-86,-81,-1154,113723,5233,2244,121200,38.16%,40.67%,
107/02/12,-352,0,-12,-364,114615,5319,2325,122259,38.46%,41.03%,
107/02/09,-501,-200,23,-678,114948,5319,2337,122604,38.57%,41.14%,
107/02/08,240,-229,1,12,115503,5519,2314,123336,38.76%,41.39%,
107/02/07,111,13,-54,70,115257,5748,2313,123318,38.68%,41.39%,
107/02/06,363,-6,-89,268,115123,5735,2367,123225,38.63%,41.35%,
107/02/05,-85,0,1,-84,114728,5741,2456,122925,38.50%,41.25%,
107/02/02,-56,20,1,-35,114793,5741,2455,122989,38.52%,41.27%,
107/02/01,-343,-20,46,-317,114872,5721,2454,123047,38.55%,41.29%,
107/01/31,-376,-1,-18,-395,115296,5741,2408,123445,38.69%,41.42%,
107/01/30,140,3,-37,106,115670,5742,2426,123838,38.82%,41.56%,
107/01/29,-128,-591,57,-662,115453,5739,2463,123655,38.74%,41.49%,
107/01/26,-536,167,36,-333,115608,6330,2406,124344,38.79%,41.72%,
107/01/25,-1579,-274,-215,-2068,116114,6163,2370,124647,38.96%,41.82%,
107/01/24,-104,20,13,-71,117497,6437,2585,126519,39.43%,42.46%,
107/01/23,-753,65,-2,-690,117556,6417,2572,126545,39.45%,42.47%,
107/01/22,-435,-301,-37,-773,118217,6352,2574,127143,39.67%,42.67%,
107/01/19,-1584,-19,-46,-1649,118638,6653,2611,127902,39.81%,42.92%,
107/01/18,-1383,-18,65,-1336,120320,6672,2657,129649,40.38%,43.51%,
107/01/17,-1709,-204,-87,-2000,121535,6690,2592,130817,40.78%,43.90%,
107/01/16,-3021,-199,-230,-3450,123059,6894,2679,132632,41.30%,44.51%,
107/01/15,-218,-82,0,-300,126070,7093,2909,136072,42.31%,45.67%,
107/01/12,188,-384,-56,-252,126288,7175,2909,136372,42.38%,45.76%,
107/01/11,-359,540,-186,-5,126112,7559,2965,136636,42.32%,45.85%,
107/01/10,-820,718,-157,-259,126420,7019,3151,136590,42.42%,45.83%,
107/01/09,-12,0,80,68,127210,6301,3308,136819,42.69%,45.91%,
107/01/08,13,0,-32,-19,127365,6301,3228,136894,42.74%,45.94%,
107/01/05,-126,-99,2,-223,127344,6301,3260,136905,42.73%,45.94%,
107/01/04,161,-46,-49,66,127560,6400,3258,137218,42.81%,46.05%,
107/01/03,196,20,170,386,127389,6446,3307,137142,42.75%,46.02%,
107/01/02,35,26,-5,56,127193,6426,3137,136756,42.68%,45.89%,
106/12/29,186,99,-30,255,127158,6400,3142,136700,42.67%,45.87%,
106/12/28,115,62,-28,149,126971,7140,3172,137283,42.61%,46.07%,
106/12/27,-192,108,55,-29,126856,7078,3200,137134,42.57%,46.02%,
106/12/26,3,-0,-23,-20,127078,6970,3145,137193,42.64%,46.03%,
106/12/25,28,0,-72,-44,127050,6970,3168,137188,42.63%,46.03%,
106/12/22,-147,0,-47,-194,127053,6970,3240,137263,42.64%,46.07%,
106/12/21,-86,0,7,-79,127200,6970,3287,137457,42.68%,46.12%,
106/12/20,-52,-20,18,-54,127313,6970,3280,137563,42.72%,46.16%,
106/12/19,-21,0,-1,-22,127443,6990,3262,137695,42.77%,46.21%,
106/12/18,-38,-49,33,-54,127464,6990,3263,137717,42.77%,46.21%,
106/12/15,-165,104,-29,-90,127502,7039,3230,137771,42.79%,46.24%,
106/12/14,-136,0,10,-126,127668,6935,3259,137862,42.84%,46.26%,
106/12/13,-276,0,17,-259,127804,6935,3249,137988,42.89%,46.31%,
106/12/12,-78,-16,-9,-103,128079,6935,3232,138246,42.98%,46.39%,
106/12/11,-119,200,58,139,128145,6951,3241,138337,43.00%,46.42%,
106/12/08,-34,-14,36,-12,128242,6751,3183,138176,43.03%,46.36%,
106/12/07,-146,-20,-50,-216,128290,6765,3147,138202,43.05%,46.38%,
106/12/06,3,21,-73,-49,128413,6785,3197,138395,43.09%,46.44%,
106/12/05,-238,46,128,-64,128355,6764,3270,138389,43.07%,46.44%,
106/12/04,-260,44,307,91,128526,6718,3142,138386,43.13%,46.44%,
106/12/01,-297,-34,61,-270,128676,6674,2835,138185,43.18%,46.37%,
106/11/30,-243,-9,13,-239,128944,6708,2774,138426,43.27%,46.45%,
106/11/29,-190,-283,-12,-485,129157,6717,2761,138635,43.34%,46.52%,
106/11/28,23,14,-7,30,129344,7000,2773,139117,43.40%,46.68%,
106/11/27,22,0,6,28,129320,6986,2780,139086,43.40%,46.68%,
106/11/24,-139,-322,-20,-481,129298,6986,2774,139058,43.39%,46.67%,
106/11/23,-234,-94,11,-317,129437,7308,2794,139539,43.44%,46.83%,
106/11/22,-23,-86,-8,-117,129656,7402,2783,139841,43.51%,46.93%,
106/11/21,-94,-75,-37,-206,129665,7488,2791,139944,43.51%,46.96%,
106/11/20,91,-35,-76,-20,129750,7563,2828,140141,43.54%,47.03%,
106/11/17,861,-214,22,669,129623,7598,2904,140125,43.50%,47.02%,
106/11/16,-47,-84,118,-13,128746,7812,2882,139440,43.20%,46.79%,
106/11/15,-233,19,-52,-266,128784,7896,2764,139444,43.22%,46.80%,
106/11/14,-219,-80,-9,-308,129010,7877,2816,139703,43.29%,46.88%,
106/11/13,65,0,19,84,129207,7957,2825,139989,43.36%,46.98%,
106/11/10,-334,-54,-23,-411,129242,7957,2806,140005,43.37%,46.98%,
106/11/09,-269,-35,-59,-363,129576,8011,2829,140416,43.48%,47.12%,
106/11/08,297,-10,-12,275,129835,8046,2888,140769,43.57%,47.24%,
106/11/07,-221,-204,-75,-500,129513,8056,2900,140469,43.46%,47.14%,
106/11/06,-465,-7,-9,-481,129734,8260,2975,140969,43.54%,47.31%,
106/11/03,118,-50,27,95,130099,8267,2984,141350,43.66%,47.44%,
106/11/02,8,-53,24,-21,129981,8317,2957,141255,43.62%,47.40%,
106/11/01,-139,-78,-6,-223,129973,8370,2933,141276,43.62%,47.41%,
106/10/31,-116,-50,-17,-183,130112,8448,2939,141499,43.66%,47.48%,
106/10/30,95,0,9,104,130288,8498,2956,141742,43.72%,47.56%,
106/10/27,-88,30,-37,-95,130195,8498,2947,141640,43.69%,47.53%,
106/10/26,-165,-30,-10,-205,130291,8468,2984,141743,43.72%,47.56%,
106/10/25,-127,-9,-53,-189,130453,8498,2994,141945,43.78%,47.64%,
106/10/24,74,-19,40,95,130572,8507,3047,142126,43.82%,47.70%,
106/10/23,-35,-11,-12,-58,130504,8526,3007,142037,43.79%,47.66%,
106/10/20,62,-12,-15,35,130509,8537,3019,142065,43.80%,47.68%,
106/10/19,225,-1,-96,128,130447,8549,3034,142030,43.77%,47.66%,
106/10/18,262,19,2,283,130227,8550,3130,141907,43.70%,47.62%,
106/10/17,184,-523,-31,-370,129965,8531,3128,141624,43.61%,47.52%,
106/10/16,-103,-33,-17,-153,129875,9054,3159,142088,43.58%,47.68%,
106/10/13,-287,-326,-100,-713,130006,9087,3176,142269,43.63%,47.75%,
106/10/12,-309,-35,147,-197,130296,9413,3276,142985,43.72%,47.98%,
106/10/11,145,-23,-58,64,130585,9448,3129,143162,43.82%,48.04%,
106/10/06,2,-8,-78,-84,130443,9471,3187,143101,43.77%,48.02%,
106/10/05,63,-109,4,-42,130441,9479,3265,143185,43.77%,48.05%,
106/10/03,195,-56,-44,95,130368,9588,3261,143217,43.75%,48.06%,
106/10/02,-196,-3,10,-189,130143,9644,3305,143092,43.67%,48.02%,
106/09/30,0,5,-88,-83,130314,9647,3295,143256,43.73%,48.07%,
106/09/29,400,11,141,552,130314,9233,3383,142930,43.73%,47.96%,
106/09/28,398,5,78,481,129890,9222,3242,142354,43.59%,47.77%,
106/09/27,216,0,-123,93,129494,9217,3164,141875,43.45%,47.61%,
106/09/26,-50,-15,46,-19,129273,9217,3287,141777,43.38%,47.58%,
106/09/25,206,-47,-69,90,129309,9232,3241,141782,43.39%,47.58%,
106/09/22,178,60,-186,52,129107,9279,3310,141696,43.32%,47.55%,
106/09/21,-70,-34,114,10,128912,9219,3496,141627,43.26%,47.53%,
106/09/20,-94,-39,-69,-202,128977,9253,3382,141612,43.28%,47.52%,
106/09/19,-258,40,75,-143,129117,9292,3451,141860,43.33%,47.61%,
106/09/18,-29,26,-54,-57,129351,9252,3376,141979,43.41%,47.65%,
106/09/15,901,152,182,1235,129364,9226,3430,142020,43.41%,47.66%,
106/09/14,211,22,224,457,128462,9074,3248,140784,43.11%,47.25%,
106/09/13,190,0,-40,150,128251,9052,3024,140327,43.04%,47.09%,
106/09/12,-60,8,28,-24,128061,9052,3064,140177,42.97%,47.04%,
106/09/11,-107,45,-20,-82,128115,9044,3036,140195,42.99%,47.04%,
106/09/08,-284,82,72,-130,128209,8999,3056,140264,43.02%,47.07%,
106/09/07,187,-24,-164,-1,128490,8917,2984,140391,43.12%,47.11%,
106/09/06,58,-121,-20,-83,128302,8941,3148,140391,43.05%,47.11%,
106/09/05,106,-5,34,135,128216,9062,3168,140446,43.03%,47.13%,
106/09/04,-77,23,-46,-100,128104,9067,3134,140305,42.99%,47.08%,
106/09/01,-5,99,-45,49,128178,9044,3180,140402,43.01%,47.11%,
106/08/31,286,0,136,422,128171,8945,3225,140341,43.01%,47.09%,
106/08/30,-128,-38,-4,-170,127885,8945,3089,139919,42.91%,46.95%,
106/08/29,62,-31,-9,22,128013,8983,3093,140089,42.96%,47.01%,
106/08/28,58,-110,-8,-60,127951,9014,3102,140067,42.94%,47.01%,
106/08/25,-48,-50,-66,-164,127892,9124,3110,140126,42.92%,47.03%,
106/08/24,-73,-5,73,-5,127940,9174,3176,140290,42.93%,47.07%,
106/08/23,192,-87,-4,101,128013,9179,3103,140295,42.96%,47.08%,
106/08/22,19,-80,3,-58,127821,9266,3107,140194,42.89%,47.04%,
106/08/21,-22,-106,34,-94,127802,9346,3104,140252,42.89%,47.07%,
106/08/18,-48,15,0,-33,127824,9452,3070,140346,42.89%,47.09%,
106/08/17,27,0,-31,-4,127872,9437,3070,140379,42.91%,47.11%,
106/08/16,-79,-12,-48,-139,127851,9437,3101,140389,42.90%,47.11%,
106/08/15,189,50,41,280,127930,9449,3149,140528,42.93%,47.16%,
106/08/14,-52,0,-31,-83,127741,9399,3108,140248,42.87%,47.07%,
106/08/11,-89,0,-9,-98,127793,9399,3139,140331,42.88%,47.09%,
106/08/10,-15,-110,-85,-210,127882,9399,3148,140429,42.91%,47.12%,
106/08/09,3,133,-30,106,127892,9509,3233,140634,42.92%,47.20%,
106/08/08,-69,317,77,325,127889,9376,3263,140528,42.92%,47.16%,
106/08/07,69,2,-72,-1,127958,9059,3186,140203,42.94%,47.05%,
106/08/04,296,15,58,369,127889,9057,3258,140204,42.92%,47.05%,
106/08/03,505,45,-18,532,127592,9042,3200,139834,42.82%,46.93%,
106/08/02,221,-130,-39,52,127137,8997,3218,139352,42.66%,46.76%,
106/08/01,140,0,-26,114,126916,9127,3257,139300,42.59%,46.75%,
106/07/31,422,0,-6,416,126766,9127,3283,139176,42.54%,46.70%,
106/07/28,218,-51,-46,121,126344,9127,3289,138760,42.40%,46.57%,
106/07/27,129,-138,72,63,126248,9178,3335,138761,42.37%,46.57%,
106/07/26,39,-82,-333,-376,126169,9316,3263,138748,42.34%,46.56%,
106/07/25,-49,-47,344,248,126202,9398,3596,139196,42.35%,46.71%,
106/07/24,604,-77,52,579,126315,9445,3252,139012,42.39%,46.65%,
106/07/21,901,50,48,999,125758,9522,3200,138480,42.20%,46.47%,
106/07/20,-37,49,-65,-53,124926,9472,3152,137550,41.92%,46.16%,
106/07/19,89,319,-62,346,124963,9423,3217,137603,41.93%,46.17%,
106/07/18,574,-90,162,646,124874,9104,3279,137257,41.90%,46.06%,
106/07/17,91,22,-48,65,124300,9194,3117,136611,41.71%,45.84%,
106/07/14,416,0,-89,327,124209,9172,3165,136546,41.68%,45.82%,
106/07/13,17,-61,95,51,123793,9172,3254,136219,41.54%,45.71%,
106/07/12,-186,40,-86,-232,123824,9233,3159,136216,41.55%,45.71%,
106/07/11,110,0,41,151,124004,9193,3245,136442,41.61%,45.78%,
106/07/10,-136,-100,-74,-310,123921,9193,3204,136318,41.58%,45.74%,
106/07/07,286,-47,-130,109,124092,9293,3278,136663,41.64%,45.86%,
106/07/06,191,-202,196,185,123806,9340,3408,136554,41.55%,45.83%,
106/07/05,-276,-62,-152,-490,123639,9542,3212,136393,41.49%,45.77%,
106/07/04,-58,-12,-99,-169,123798,9604,3364,136766,41.54%,45.89%,
106/07/03,-147,-218,5,-360,123824,9616,3463,136903,41.55%,45.94%,
106/06/30,648,240,173,1061,123971,9834,3458,137263,41.60%,46.06%,
106/06/29,-207,-177,34,-350,123293,8747,3285,135325,41.37%,45.41%,
106/06/28,30,-39,-33,-42,123550,8924,3251,135725,41.46%,45.55%,
106/06/27,29,0,-89,-60,123605,8963,3284,135852,41.48%,45.59%,
106/06/26,226,-61,-123,42,123549,8963,3373,135885,41.46%,45.60%,
106/06/23,589,77,175,841,123309,9024,3496,135829,41.38%,45.58%,
106/06/22,133,-14,-15,104,122720,8947,3321,134988,41.18%,45.30%,
106/06/21,271,-26,-4,241,122592,8961,3336,134889,41.14%,45.27%,
106/06/20,26,-39,-20,-33,122319,8987,3340,134646,41.05%,45.19%,
106/06/19,71,-58,-61,-48,122280,9026,3360,134666,41.03%,45.19%,
106/06/16,463,-156,292,599,122210,9084,3421,134715,41.01%,45.21%,
106/06/15,260,-90,53,223,121757,9240,3129,134126,40.86%,45.01%,
106/06/14,25,0,74,99,121496,9330,3076,133902,40.77%,44.93%,
106/06/13,-297,9,-21,-309,121463,9330,3002,133795,40.76%,44.90%,
106/06/12,-279,0,-15,-294,121759,9321,3023,134103,40.86%,45.00%,
106/06/09,-341,0,-79,-420,122038,9321,3038,134397,40.95%,45.10%,
106/06/08,-448,177,63,-208,122379,9321,3117,134817,41.07%,45.24%,
106/06/07,201,-67,7,141,122834,9144,3054,135032,41.22%,45.31%,
106/06/06,53,-79,-24,-50,122633,9211,3047,134891,41.15%,45.26%,
106/06/05,-127,-89,56,-160,122510,9290,3071,134871,41.11%,45.26%,
106/06/03,0,-18,27,9,122637,9379,3015,135031,41.15%,45.31%,
106/06/02,-142,18,-1,-125,122637,9397,2988,135022,41.15%,45.31%,
106/06/01,17,0,2,19,122772,9379,2989,135140,41.20%,45.35%,
106/05/31,79,-55,-8,16,122755,9379,2987,135121,41.19%,45.34%,
106/05/26,-113,0,-14,-127,122625,9434,2995,135054,41.15%,45.32%,
106/05/25,-253,5,-68,-316,122738,9434,3009,135181,41.19%,45.37%,
106/05/24,-171,-25,56,-140,122951,9429,3077,135457,41.26%,45.46%,
106/05/23,-351,-26,15,-362,123111,9454,3021,135586,41.31%,45.50%,
106/05/22,-93,-69,-3,-165,123452,9480,3006,135938,41.43%,45.62%,
106/05/19,-186,-15,8,-193,123609,9549,3009,136167,41.48%,45.69%,
106/05/18,-193,-4,-92,-289,123795,9564,3001,136360,41.54%,45.76%,
106/05/17,-43,-260,39,-264,123988,9568,3093,136649,41.61%,45.86%,
106/05/16,-932,-329,-2,-1263,124064,9828,3054,136946,41.63%,45.95%,
106/05/15,-218,-52,-5,-275,124937,10157,3056,138150,41.93%,46.36%,
106/05/12,-91,0,-13,-104,125225,10209,3061,138495,42.02%,46.47%,
106/05/11,135,-6,-11,118,125212,10209,3074,138495,42.02%,46.48%,
106/05/10,618,19,-152,485,124978,10215,3085,138278,41.94%,46.40%,
106/05/09,852,-84,16,784,124339,10196,3237,137772,41.72%,46.23%,
106/05/08,596,-7,-61,528,123487,10280,3221,136988,41.44%,45.97%,
106/05/05,-64,-96,141,-19,122881,10287,3282,136450,41.24%,45.79%,
106/05/04,-63,-70,46,-87,122945,10383,3141,136469,41.26%,45.80%,
106/05/03,-38,-50,-63,-151,122998,10453,3095,136546,41.27%,45.82%,
106/05/02,119,-347,51,-177,123036,10503,3158,136697,41.29%,45.87%,
106/04/28,-21,-53,-13,-87,122917,10850,3107,136874,41.25%,45.93%,
106/04/27,159,-185,26,0,122938,10903,3120,136961,41.25%,45.96%,
106/04/26,429,-184,19,264,122779,11088,3094,136961,41.20%,45.96%,
106/04/25,196,-165,22,53,122350,11272,3075,136697,41.06%,45.88%,
106/04/24,71,-358,-16,-303,122154,11437,3053,136644,40.99%,45.85%,
106/04/21,51,70,3,124,122083,11795,3069,136947,40.97%,45.96%,
106/04/20,56,0,-47,9,122032,11725,3066,136823,40.95%,45.91%,
106/04/19,424,-150,22,296,122036,11725,3113,136874,40.95%,45.93%,
106/04/18,138,17,-32,123,121612,11875,3091,136578,40.81%,45.83%,
106/04/17,86,-135,-46,-95,121474,11858,3123,136455,40.76%,45.79%,
106/04/14,-12,-200,-98,-310,121388,11993,3169,136550,40.73%,45.82%,
106/04/13,-44,-412,-35,-491,121400,12193,3267,136860,40.74%,45.93%,
106/04/12,-7,-90,1,-96,121444,12605,3302,137351,40.75%,46.09%,
106/04/11,50,-50,-12,-12,121451,12695,3301,137447,40.76%,46.13%,
106/04/10,-299,-86,-11,-396,121401,12745,3313,137459,40.74%,46.13%,
106/04/07,-245,-30,-242,-517,121690,12831,3324,137845,40.84%,46.26%,
106/04/06,-279,-30,-116,-425,121925,12861,3566,138352,40.91%,46.42%,
106/04/05,227,-60,281,448,122205,12891,3682,138778,41.01%,46.57%,
106/03/31,-255,40,-172,-387,121978,12951,3401,138330,40.93%,46.42%,
106/03/30,-56,123,-96,-29,122233,12270,3573,138076,41.02%,46.34%,
106/03/29,-307,0,195,-112,122302,12147,3669,138118,41.04%,46.35%,
106/03/28,301,0,-6,295,122599,12147,3474,138220,41.14%,46.38%,
106/03/27,435,-34,-189,212,122298,12147,3480,137925,41.04%,46.28%,
106/03/24,191,40,41,272,121863,12181,3669,137713,40.89%,46.21%,
106/03/23,456,30,-2,484,121672,12141,3628,137441,40.83%,46.12%,
106/03/22,158,-67,-3,88,121216,12111,3630,136957,40.68%,45.96%,
106/03/21,729,14,-104,639,121061,12178,3633,136872,40.62%,45.93%,
106/03/20,613,-84,3,532,120325,12164,3737,136226,40.38%,45.72%,
106/03/17,127,-81,-110,-64,119905,12248,3734,135887,40.24%,45.60%,
106/03/16,1525,549,151,2225,119749,12329,3844,135922,40.18%,45.61%,
106/03/15,-37,42,37,42,118165,11780,3693,133638,39.65%,44.84%,
106/03/14,486,100,-88,498,118185,11738,3656,133579,39.66%,44.83%,
106/03/13,126,292,-217,201,117689,11638,3744,133071,39.49%,44.65%,
106/03/10,976,287,268,1531,117779,11346,3961,133086,39.52%,44.66%,
106/03/09,359,149,684,1192,116790,11059,3693,131542,39.19%,44.14%,
106/03/08,-87,75,33,21,116431,10910,3009,130350,39.07%,43.74%,
106/03/07,-67,53,17,3,116518,10835,2976,130329,39.10%,43.74%,
106/03/06,-69,60,7,-2,116585,10782,2959,130326,39.12%,43.73%,
106/03/03,129,0,-9,120,116644,10722,2952,130318,39.14%,43.73%,
106/03/02,-346,175,-3,-174,116621,10722,2961,130304,39.13%,43.72%,
106/03/01,-223,218,1,-4,116967,10547,2964,130478,39.25%,43.78%,
106/02/24,-267,0,11,-256,117180,10329,2963,130472,39.32%,43.78%,
106/02/23,-39,-50,-25,-114,117447,10329,2952,130728,39.41%,43.87%,
106/02/22,-254,12,35,-207,117486,10379,2977,130842,39.42%,43.90%,
106/02/21,6,-81,2,-73,117740,10367,2942,131049,39.51%,43.98%,
106/02/20,14,0,-1,13,117734,10448,2940,131122,39.51%,44.00%,
106/02/18,0,-60,69,9,117739,10448,2941,131128,39.51%,44.00%,
106/02/17,-564,-335,-126,-1025,117739,10508,2872,131119,39.51%,44.00%,
106/02/16,-462,-55,100,-417,118308,10843,2998,132149,39.70%,44.35%,
106/02/15,-657,-106,-130,-893,118770,10898,2898,132566,39.86%,44.49%,
106/02/14,-708,158,-126,-676,119427,11004,3028,133459,40.08%,44.79%,
106/02/13,-177,138,22,-17,120135,10846,3154,134135,40.31%,45.01%,
106/02/10,171,-33,173,311,120286,10708,3132,134126,40.36%,45.00%,
106/02/09,-411,64,-19,-366,120049,10741,2959,133749,40.28%,44.88%,
106/02/08,-509,-118,55,-572,120360,10677,2978,134015,40.39%,44.97%,
106/02/07,-808,-71,-13,-892,120845,10795,2923,134563,40.55%,45.15%,
106/02/06,-380,-228,110,-498,121653,10866,2936,135455,40.82%,45.45%,
106/02/03,-373,80,-159,-452,122065,11094,2826,135985,40.96%,45.63%,
106/02/02,-514,-7,-26,-547,122387,11014,2985,136386,41.07%,45.77%,
106/01/24,-541,139,-3,-405,122901,11021,3011,136933,41.24%,45.95%,
106/01/23,-134,25,-39,-148,123490,10882,3014,137386,41.44%,46.10%,
106/01/20,-343,-14,43,-314,123624,10857,3053,137534,41.48%,46.15%,
106/01/19,-940,539,-38,-439,123967,10871,3010,137848,41.60%,46.26%,
106/01/18,37,-204,-11,-178,124907,10332,3048,138287,41.92%,46.41%,
106/01/17,-34,229,-91,104,124867,10536,3059,138462,41.90%,46.46%,
106/01/16,-380,67,202,-111,124978,10307,3150,138435,41.94%,46.46%,
106/01/13,-977,53,-46,-970,125373,10240,2948,138561,42.07%,46.50%,
106/01/12,-319,345,-31,-5,126220,10187,2994,139401,42.36%,46.78%,
106/01/11,-244,-2,32,-214,126539,9842,3025,139406,42.46%,46.78%,
106/01/10,-249,64,-8,-193,126783,9844,2993,139620,42.54%,46.85%,
106/01/09,-638,-19,-8,-665,127032,9780,3001,139813,42.63%,46.92%,
106/01/06,27,-8,26,45,127670,9799,3009,140478,42.84%,47.14%,
106/01/05,161,-72,-13,76,127633,9807,2983,140423,42.83%,47.12%,
106/01/04,64,100,95,259,127461,9879,2996,140336,42.77%,47.09%,
106/01/03,224,-272,-34,-82,127417,9779,2901,140097,42.76%,47.02%,
105/12/30,-8,221,-47,166,127140,10051,2935,140126,42.66%,47.02%,
105/12/29,16,34,52,102,127123,9830,2982,139935,42.66%,46.96%,
105/12/28,312,-35,-21,256,127145,9796,2930,139871,42.67%,46.94%,
105/12/27,24,-30,-48,-54,126822,9831,2951,139604,42.56%,46.85%,
105/12/26,210,-29,-97,84,126706,9861,2999,139566,42.52%,46.84%,
105/12/23,-558,-73,-97,-728,126514,9890,3096,139500,42.45%,46.81%,
105/12/22,-419,0,-76,-495,127062,9963,3193,140218,42.64%,47.06%,
105/12/21,-345,-100,-48,-493,127545,9963,3269,140777,42.80%,47.24%,
105/12/20,46,-20,9,35,127786,10063,3317,141166,42.88%,47.37%,
105/12/19,-39,0,-4,-43,127740,10083,3308,141131,42.87%,47.36%,
105/12/16,-353,320,-37,-70,127906,10083,3312,141301,42.92%,47.42%,
105/12/15,-19,-110,29,-100,128249,9763,3349,141361,43.04%,47.44%,
105/12/14,38,-147,-103,-212,128247,9873,3320,141440,43.04%,47.47%,
105/12/13,-33,-100,-41,-174,128203,10020,3423,141646,43.02%,47.53%,
105/12/12,-522,-204,-101,-827,128236,10120,3464,141820,43.03%,47.59%,
105/12/09,-214,22,-234,-426,128748,10324,3565,142637,43.20%,47.86%,
105/12/08,-95,-37,650,518,129179,10302,3799,143280,43.35%,48.08%,
105/12/07,-241,-30,-50,-321,129211,10339,3149,142699,43.36%,47.89%,
105/12/06,-113,-9,107,-15,129442,10369,3199,143010,43.44%,47.99%,
105/12/05,22,0,-23,-1,129555,10378,3092,143025,43.48%,48.00%,
105/12/02,-85,0,-36,-121,129533,10378,3115,143026,43.47%,48.00%,
105/12/01,35,-32,15,18,129618,10378,3151,143147,43.50%,48.04%,
105/11/30,-17,21,77,81,129570,10410,3136,143116,43.48%,48.03%,
105/11/29,-12,-158,-5,-175,129587,10389,3059,143035,43.49%,48.00%,
105/11/28,-269,-5,9,-265,129599,10547,3064,143210,43.49%,48.06%,
105/11/25,94,5,16,115,129853,10552,3055,143460,43.58%,48.15%,
105/11/24,-1010,-269,-157,-1436,129749,10547,3039,143335,43.54%,48.10%,
105/11/23,-13,36,-91,-68,130577,10816,3196,144589,43.82%,48.52%,
105/11/22,119,59,255,433,130661,10780,3287,144728,43.85%,48.57%,
105/11/21,43,-10,77,110,130523,10721,3032,144276,43.80%,48.42%,
105/11/18,-156,0,-25,-181,130413,10731,2955,144099,43.76%,48.35%,
105/11/17,88,-23,36,101,130517,10731,2980,144228,43.80%,48.40%,
105/11/16,-329,-182,34,-477,130419,10754,2944,144117,43.77%,48.37%,
105/11/15,-348,300,73,25,130748,10936,2910,144594,43.88%,48.53%,
105/11/14,-53,-52,13,-92,131096,10636,2837,144569,43.99%,48.51%,
105/11/11,-32,-84,-65,-181,131149,10688,2824,144661,44.01%,48.54%,
105/11/10,52,-136,7,-77,131156,10772,2889,144817,44.01%,48.59%,
105/11/09,-186,-758,-106,-1050,131104,10908,2882,144894,44.00%,48.63%,
105/11/08,1147,-896,-486,-235,131290,11666,2988,145944,44.06%,48.98%,
105/11/07,50,-58,116,108,130143,12562,3474,146179,43.67%,49.05%,
105/11/04,701,-333,110,478,130093,12620,3358,146071,43.66%,49.02%,
105/11/03,393,-218,181,356,129382,12953,3248,145583,43.42%,48.86%,
105/11/02,-64,-122,-464,-650,128989,13171,3067,145227,43.29%,48.74%,
105/11/01,616,-390,-16,210,129053,13293,3531,145877,43.31%,48.96%,
105/10/31,-416,-479,-91,-986,128421,13683,3547,145651,43.09%,48.87%,
105/10/28,167,-50,-11,106,128787,14162,3638,146587,43.22%,49.19%,
105/10/27,366,-309,-29,28,128610,14212,3649,146471,43.16%,49.15%,
105/10/26,22,-293,-166,-437,128393,14521,3678,146592,43.09%,49.20%,
105/10/25,-58,-61,-149,-268,128371,14814,3844,147029,43.08%,49.34%,
105/10/24,2,52,233,287,128429,14875,3993,147297,43.10%,49.43%,
105/10/21,139,-81,-213,-155,128427,14823,3760,147010,43.10%,49.34%,
105/10/20,-18,33,62,77,128288,14904,3973,147165,43.05%,49.39%,
105/10/19,382,0,-60,322,128296,14871,3911,147078,43.05%,49.35%,
105/10/18,-148,175,25,52,127914,14871,3971,146756,42.92%,49.24%,
105/10/17,387,96,148,631,128177,14696,3946,146819,43.01%,49.27%,
105/10/14,597,81,-36,642,127780,14600,3798,146178,42.88%,49.05%,
105/10/13,589,118,-183,524,127023,14519,3834,145376,42.63%,48.79%,
105/10/12,-258,94,203,39,126445,14401,4017,144863,42.43%,48.61%,
105/10/11,367,0,-307,60,126717,14307,3814,144838,42.52%,48.60%,
105/10/07,845,164,100,1109,126350,14307,4121,144778,42.40%,48.58%,
105/10/06,-643,178,-300,-765,125501,14143,4021,143665,42.11%,48.21%,
105/10/05,697,555,204,1456,126374,13965,4321,144660,42.41%,48.55%,
105/10/04,532,0,172,704,125677,13410,4117,143204,42.17%,48.05%,
105/10/03,417,29,-184,262,125145,13410,3945,142500,42.00%,47.82%,
105/09/30,252,-3,-65,184,124666,13381,4129,142176,41.83%,47.71%,
105/09/29,819,-579,156,396,124413,13839,4194,142446,41.75%,47.80%,
105/09/26,579,40,-255,364,123612,14418,4038,142068,41.48%,47.67%,
105/09/23,221,-172,-66,-17,123023,14378,4293,141694,41.28%,47.55%,
105/09/22,285,112,121,518,122801,14550,4359,141710,41.21%,47.56%,
105/09/21,-39,-774,231,-582,122506,14438,4238,141182,41.11%,47.38%,
105/09/20,-369,169,33,-167,122464,15212,4007,141683,41.10%,47.55%,
105/09/19,1082,315,95,1492,122822,15043,3974,141839,41.22%,47.60%,
105/09/14,1345,802,212,2359,121725,14728,3879,140332,40.85%,47.09%,
105/09/13,368,236,-44,560,120380,13926,3667,137973,40.40%,46.30%,
105/09/12,-378,166,-36,-248,120012,13690,3711,137413,40.27%,46.11%,
105/09/10,-74,-12,-180,-266,120380,13524,3747,137651,40.40%,46.20%,
105/09/09,58,758,105,921,120454,13536,3927,137917,40.42%,46.28%,
105/09/08,-415,-102,-54,-571,120386,12778,3822,136986,40.40%,45.97%,
105/09/07,2097,560,48,2705,120790,12880,3876,137546,40.53%,46.15%,
105/09/06,543,24,134,701,118683,12320,3828,134831,39.83%,45.25%,
105/09/05,-41,0,254,213,118140,12296,3694,134130,39.64%,45.01%,
105/09/02,159,-5,-7,147,118133,12296,3440,133869,39.64%,44.92%,
105/09/01,-107,-15,-36,-158,117968,12301,3447,133716,39.59%,44.88%,
105/08/31,-629,-20,-86,-735,118065,12316,3483,133864,39.62%,44.92%,
105/08/30,-39,-24,-161,-224,118694,12336,3569,134599,39.83%,45.17%,
105/08/29,122,0,253,375,118740,12360,3730,134830,39.85%,45.25%,
105/08/26,96,11,-28,79,118608,12360,3477,134445,39.80%,45.12%,
105/08/25,243,-10,59,292,118512,12349,3505,134366,39.77%,45.09%,
105/08/24,322,86,22,430,118268,12359,3446,134073,39.69%,44.99%,
105/08/23,-60,45,44,29,117856,12273,3424,133553,39.55%,44.82%,
105/08/22,-24,74,-16,34,117916,12228,3380,133524,39.57%,44.81%,
105/08/19,-11,5,-63,-69,117940,12154,3396,133490,39.58%,44.80%,
105/08/18,150,-14,36,172,117952,12149,3459,133560,39.58%,44.82%,
105/08/17,-83,16,-47,-114,117802,12163,3423,133388,39.53%,44.76%,
105/08/16,105,144,61,310,117884,12147,3470,133501,39.56%,44.80%,
105/08/15,-352,95,14,-243,117779,12003,3409,133191,39.52%,44.69%,
105/08/12,813,872,-25,1660,118122,11908,3395,133425,39.64%,44.78%,
105/08/11,213,50,118,381,117292,11036,3420,131748,39.36%,44.21%,
105/08/10,107,130,17,254,117079,10986,3302,131367,39.29%,44.09%,
105/08/09,-598,-77,-345,-1020,116972,10856,3285,131113,39.25%,44.00%,
105/08/08,18,60,-41,37,117570,10933,3630,132133,39.45%,44.34%,
105/08/05,80,30,0,110,117552,10873,3671,132096,39.45%,44.33%,
105/08/04,12,50,-387,-325,117472,10843,3671,131986,39.42%,44.29%,
105/08/03,-186,150,508,472,117495,10793,4058,132346,39.43%,44.41%,
105/08/02,-165,-178,4,-339,117681,10643,3550,131874,39.49%,44.25%,
105/08/01,-101,-10,76,-35,117846,10821,3546,132213,39.55%,44.37%,
105/07/29,629,-186,-50,393,117947,10831,3470,132248,39.58%,44.38%,
105/07/28,121,-200,146,67,117318,11017,3520,131855,39.37%,44.25%,
105/07/27,55,-8,-116,-69,117197,11217,3374,131788,39.33%,44.23%,
105/07/26,73,0,189,262,117142,11225,3490,131857,39.31%,44.25%,
105/07/25,14,0,-54,-40,117069,11225,3301,131595,39.28%,44.16%,
105/07/22,232,-1,-28,203,117055,11225,3355,131635,39.28%,44.17%,
105/07/21,417,-58,-14,345,116823,11226,3383,131432,39.20%,44.10%,
105/07/20,291,-10,-85,196,116406,11284,3397,131087,39.06%,43.99%,
105/07/19,422,-50,-188,184,116115,11294,3482,130891,38.96%,43.92%,
105/07/18,659,16,221,896,115693,11344,3670,130707,38.82%,43.86%,
105/07/15,806,-52,185,939,115052,11328,3449,129829,38.61%,43.57%,
105/07/14,1627,21,-79,1569,114272,11380,3264,128916,38.35%,43.26%,
105/07/13,443,14,-327,130,112627,11359,3343,127329,37.79%,42.72%,
105/07/12,-456,150,728,422,112168,11345,3670,127183,37.64%,42.68%,
105/07/11,-217,41,-39,-215,112584,11195,2942,126721,37.78%,42.52%,
105/07/07,-703,90,89,-524,112791,11154,2981,126926,37.85%,42.59%,
105/07/06,-254,48,-53,-259,113494,11064,2892,127450,38.08%,42.76%,
105/07/05,-169,71,-30,-128,113748,11016,2945,127709,38.17%,42.86%,
105/07/04,-251,73,-31,-209,113917,10945,2975,127837,38.23%,42.90%,
105/07/01,-702,-41,-2,-745,114168,10872,3006,128046,38.31%,42.97%,
105/06/30,-722,202,286,-234,114870,10913,3008,128791,38.55%,43.22%,
105/06/29,-122,293,79,250,115611,11922,2722,130255,38.80%,43.71%,
105/06/28,424,-386,29,67,115733,11629,2643,130005,38.84%,43.63%,
105/06/27,-79,111,-13,19,115310,12015,2614,129939,38.69%,43.60%,
105/06/24,19,9,-22,6,115389,11904,2627,129920,38.72%,43.60%,
105/06/23,-127,0,12,-115,115370,11895,2649,129914,38.71%,43.59%,
105/06/22,112,-235,17,-106,115497,11895,2637,130029,38.76%,43.64%,
105/06/21,260,-563,-53,-356,115384,12130,2620,130134,38.72%,43.67%,
105/06/20,-85,230,45,190,115124,12693,2673,130490,38.63%,43.79%,
105/06/17,451,-823,-45,-417,115262,12463,2628,130353,38.68%,43.74%,
105/06/16,-655,-245,-221,-1121,114792,13286,2673,130751,38.52%,43.88%,
105/06/15,-597,-228,-35,-860,115447,13531,2894,131872,38.74%,44.25%,
105/06/14,-146,0,47,-99,116044,13759,2929,132732,38.94%,44.54%,
105/06/13,-185,-210,-6,-401,116190,13759,2882,132831,38.99%,44.57%,
105/06/08,-478,-145,-24,-647,116375,13969,2888,133232,39.05%,44.71%,
105/06/07,-21,-107,-7,-135,116853,14114,2912,133879,39.21%,44.92%,
105/06/06,-309,18,15,-276,116874,14221,2919,134014,39.22%,44.97%,
105/06/04,0,0,-39,-39,117183,14203,2904,134290,39.32%,45.06%,
105/06/03,-309,-96,-199,-604,117183,14203,2943,134329,39.32%,45.07%,
105/06/02,355,-29,289,615,117482,14299,3142,134923,39.42%,45.27%,
105/06/01,242,-12,106,336,117137,14328,2853,134318,39.31%,45.08%,
105/05/31,-242,-495,-66,-803,116885,14340,2747,133972,39.22%,44.95%,
105/05/30,145,-402,-66,-323,117117,14835,2813,134765,39.30%,45.22%,
105/05/27,-118,-186,-67,-371,116962,15237,2879,135078,39.25%,45.33%,
105/05/26,-14,-218,221,-11,117067,15423,2946,135436,39.28%,45.44%,
105/05/25,330,-413,-47,-130,117081,15641,2725,135447,39.29%,45.45%,
105/05/24,-343,-68,-12,-423,116751,16054,2772,135577,39.18%,45.50%,
105/05/23,109,-148,93,54,117094,16122,2784,136000,39.29%,45.64%,
105/05/20,605,-98,-25,482,116985,16270,2691,135946,39.26%,45.62%,
105/05/19,-58,-83,-86,-227,116496,16368,2716,135580,39.09%,45.49%,
105/05/18,-169,-80,-15,-264,116554,16451,2802,135807,39.11%,45.57%,
105/05/17,66,-70,-3,-7,116723,16531,2817,136071,39.17%,45.66%,
105/05/16,240,-50,17,207,116657,16601,2820,136078,39.15%,45.67%,
105/05/13,-48,200,-51,101,116417,16651,2803,135871,39.07%,45.60%,
105/05/12,409,-570,-227,-388,116456,16451,2854,135761,39.08%,45.56%,
105/05/11,415,-174,-17,224,116047,17021,3081,136149,38.94%,45.69%,
105/05/10,459,-513,-383,-437,115632,17195,3098,135925,38.80%,45.61%,
105/05/09,265,-79,-140,46,115173,17708,3481,136362,38.65%,45.76%,
105/05/06,-572,13,-161,-720,114908,17787,3621,136316,38.56%,45.74%,
105/05/05,526,-15,332,843,115500,17774,3782,137056,38.76%,45.99%,
105/05/04,34,-5,-37,-8,114974,17789,3450,136213,38.58%,45.71%,
105/05/03,192,0,-60,132,114940,17794,3487,136221,38.57%,45.71%,
105/04/29,41,0,-151,-110,114748,17794,3547,136089,38.51%,45.67%,
105/04/28,176,114,83,373,114707,17794,3698,136199,38.49%,45.70%,
105/04/27,219,154,-73,300,114531,17680,3615,135826,38.43%,45.58%,
105/04/26,836,-60,-50,726,114338,17526,3688,135552,38.37%,45.49%,
105/04/25,2408,359,299,3066,113502,17586,3738,134826,38.09%,45.25%,
105/04/22,403,107,-26,484,111094,17227,3439,131760,37.28%,44.22%,
105/04/21,648,80,42,770,110691,17120,3465,131276,37.14%,44.05%,
105/04/20,-488,-50,-76,-614,110017,17040,3423,130480,36.92%,43.79%,
105/04/19,-517,95,-530,-952,110523,17090,3499,131112,37.09%,44.00%,
105/04/18,376,438,774,1588,111030,16995,4029,132054,37.26%,44.32%,
105/04/15,208,326,153,687,110636,16557,3255,130448,37.13%,43.78%,
105/04/14,267,40,274,581,110427,16231,3102,129760,37.06%,43.55%,
105/04/13,90,376,80,546,110160,16191,2828,129179,36.97%,43.35%,
105/04/12,684,-110,-527,47,110060,15815,2748,128623,36.93%,43.16%,
105/04/11,124,-244,-112,-232,109376,15925,3275,128576,36.70%,43.14%,
105/04/08,-430,240,-206,-396,109262,16169,3387,128818,36.66%,43.22%,
105/04/07,-917,-25,-562,-1504,109879,15929,3593,129401,36.87%,43.42%,
105/04/06,-1324,214,112,-998,110796,15954,4155,130905,37.18%,43.93%,
105/04/01,-163,0,-17,-180,112321,15740,4043,132104,37.69%,44.33%,
105/03/31,-342,0,12,-330,112494,15740,4060,132294,37.75%,44.40%,
105/03/30,716,-81,-34,601,112635,15377,4048,132060,37.80%,44.32%,
105/03/29,397,123,170,690,111919,15458,4082,131459,37.56%,44.12%,
105/03/28,979,9,-77,911,111636,15335,3912,130883,37.46%,43.92%,
105/03/25,558,-125,-179,254,110647,15326,3989,129962,37.13%,43.61%,
105/03/24,449,26,125,600,110136,15451,4168,129755,36.96%,43.54%,
105/03/23,1588,-20,-41,1527,109843,15425,4043,129311,36.86%,43.39%,
105/03/22,1893,-467,-244,1182,108265,15445,4084,127794,36.33%,42.88%,
105/03/21,2781,-95,-537,2149,106295,15912,4328,126535,35.67%,42.46%,
105/03/18,1883,237,-182,1938,103514,16007,4865,124386,34.74%,41.74%,
105/03/17,123,0,-38,85,101621,15770,5047,122438,34.10%,41.09%,
105/03/16,1243,90,367,1700,101614,15770,5085,122469,34.10%,41.10%,
105/03/15,364,-81,-335,-52,100361,15680,4718,120759,33.68%,40.53%,
105/03/14,-95,109,77,91,100095,15761,5053,120909,33.59%,40.58%,
105/03/11,94,484,-194,384,100178,15652,4976,120806,33.62%,40.54%,
105/03/10,269,442,855,1566,100113,15168,5170,120451,33.59%,40.42%,
105/03/09,1088,339,197,1624,99772,14726,4315,118813,33.48%,39.87%,
105/03/08,687,-405,180,462,98859,14387,4118,117364,33.17%,39.38%,
105/03/07,33,290,-77,246,98132,14792,3938,116862,32.93%,39.22%,
105/03/04,530,-121,-4,405,98082,14502,4015,116599,32.91%,39.12%,
105/03/03,-136,-272,-221,-629,97449,14623,4019,116091,32.70%,38.96%,
105/03/02,445,-242,770,973,97477,14895,4240,116612,32.71%,39.13%,
105/03/01,10,201,23,234,97029,15137,3470,115636,32.56%,38.80%,
105/02/26,-362,61,-196,-497,97019,14936,3447,115402,32.56%,38.73%,
105/02/25,-571,77,618,124,97331,14875,3643,115849,32.66%,38.87%,
105/02/24,-226,-75,-19,-320,97936,14798,3025,115759,32.86%,38.84%,
105/02/23,-114,-154,17,-251,98162,14873,3044,116079,32.94%,38.95%,
105/02/22,-335,0,89,-246,98276,15027,3027,116330,32.98%,39.04%,
105/02/19,22,101,-28,95,98611,15027,2938,116576,33.09%,39.12%,
105/02/18,500,0,-41,459,98688,14926,2966,116580,33.12%,39.12%,
105/02/17,254,-317,87,24,98197,14926,3007,116130,32.95%,38.97%,
105/02/16,-621,-317,42,-896,97844,15243,2920,116007,32.83%,38.93%,
105/02/15,402,33,-22,413,98465,15560,2878,116903,33.04%,39.23%,
105/02/03,340,-35,-128,177,98063,15527,2900,116490,32.91%,39.09%,
105/02/02,774,-539,-47,188,97705,15562,3028,116295,32.79%,39.03%,
105/02/01,558,-157,-67,334,97005,16101,3075,116181,32.55%,38.99%,
105/01/30,0,251,-316,-65,96431,16258,3142,115831,32.36%,38.87%,
105/01/29,992,507,415,1914,96431,16007,3458,115896,32.36%,38.89%,
105/01/28,1085,21,81,1187,95429,15500,3043,113972,32.02%,38.24%,
105/01/27,1255,-903,-145,207,94344,15479,2962,112785,31.66%,37.85%,
105/01/26,609,-844,-74,-309,93090,16382,3107,112579,31.24%,37.78%,
105/01/25,324,179,151,654,92519,17226,3181,112926,31.05%,37.90%,
105/01/22,1157,-107,-189,861,92301,17047,3030,112378,30.97%,37.71%,
105/01/21,625,456,168,1249,91084,17154,3219,111457,30.56%,37.40%,
105/01/20,124,1053,-245,932,90436,16698,3051,110185,30.35%,36.98%,
105/01/19,336,1067,853,2256,90614,15645,3296,109555,30.41%,36.77%,
105/01/18,1077,731,181,1989,90278,14578,2443,107299,30.29%,36.00%,
105/01/15,522,18,30,570,89201,13847,2262,105310,29.93%,35.34%,
105/01/14,-293,-175,-62,-530,88679,13829,2232,104740,29.76%,35.15%,
105/01/13,-174,-115,22,-267,88972,14004,2294,105270,29.85%,35.32%,
105/01/12,-104,-308,-133,-545,89047,14119,2272,105438,29.88%,35.38%,
105/01/11,-303,-455,1,-757,89139,14427,2405,105971,29.91%,35.56%,
105/01/08,-428,-127,34,-521,89442,14882,2404,106728,30.01%,35.81%,
105/01/07,-265,-620,-308,-1193,89870,15009,2370,107249,30.16%,35.99%,
105/01/06,10,-262,-89,-341,90135,15629,2678,108442,30.25%,36.39%,
105/01/05,-580,-325,-190,-1095,90125,15891,2767,108783,30.24%,36.50%,
105/01/04,-371,-155,-79,-605,90605,16216,2957,109778,30.40%,36.83%,
104/12/31,-407,168,-95,-334,90948,16371,3036,110355,30.52%,37.03%,
104/12/30,-168,162,-66,-72,91355,16517,3131,111003,30.65%,37.24%,
104/12/29,-43,-95,13,-125,91523,16355,3197,111075,30.71%,37.27%,
104/12/28,-61,6,-175,-230,91490,16450,3184,111124,30.70%,37.29%,
104/12/25,34,144,-208,-30,91551,16444,3359,111354,30.72%,37.37%,
104/12/24,-82,0,-326,-408,91517,16300,3567,111384,30.71%,37.38%,
104/12/23,-764,342,689,267,91730,16300,3893,111923,30.78%,37.56%,
104/12/22,-349,0,36,-313,92445,15958,3204,111607,31.02%,37.45%,
104/12/21,-404,191,-24,-237,92744,15958,3168,111870,31.12%,37.54%,
104/12/18,-924,857,-95,-162,93146,15767,3192,112105,31.26%,37.62%,
104/12/17,-485,1173,81,769,94020,14910,3287,112217,31.55%,37.66%,
104/12/16,-1230,587,147,-496,94505,13737,3206,111448,31.71%,37.40%,
104/12/15,-427,-147,67,-507,95724,13150,3059,111933,32.12%,37.56%,
104/12/14,-1388,-13,11,-1390,96151,13297,2992,112440,32.26%,37.73%,
104/12/11,-303,-40,-191,-534,97421,13310,2981,113712,32.69%,38.16%,
104/12/10,-838,-47,66,-819,97750,13350,3172,114272,32.80%,38.34%,
104/12/09,1189,-1740,-648,-1199,98588,13397,3106,115091,33.08%,38.62%,
104/12/08,-78,-336,-68,-482,97399,15137,3754,116290,32.68%,39.02%,
104/12/07,35,184,85,304,97467,15473,3822,116762,32.71%,39.19%,
104/12/04,-156,-57,-202,-415,97432,15289,3737,116458,32.69%,39.08%,
104/12/03,1076,223,776,2075,97588,15346,3939,116873,32.75%,39.22%,
104/12/02,199,-372,16,-157,96512,15123,3163,114798,32.39%,38.53%,
104/12/01,384,-5,-52,327,96413,15495,3147,115055,32.35%,38.61%,
104/11/30,119,-160,-48,-89,96030,15500,3199,114729,32.22%,38.50%,
104/11/27,-129,-410,-179,-718,95911,15660,3247,114818,32.18%,38.53%,
104/11/26,186,-92,293,387,96044,16070,3426,115540,32.23%,38.77%,
104/11/25,100,-61,-12,27,95858,16162,3133,115153,32.17%,38.65%,
104/11/24,-92,-110,-18,-220,95758,16223,3145,115126,32.13%,38.63%,
104/11/23,646,-55,-49,542,95840,16333,3163,115336,32.16%,38.70%,
104/11/20,-163,-358,177,-344,95183,16388,3212,114783,31.94%,38.52%,
104/11/19,-571,-824,16,-1379,95346,16746,3035,115127,31.99%,38.63%,
104/11/18,57,-982,-210,-1135,95917,17570,3019,116506,32.19%,39.10%,
104/11/17,436,-266,-21,149,95860,18552,3229,117641,32.17%,39.48%,
104/11/16,-18,-13,-9,-40,95424,18818,3250,117492,32.02%,39.43%,
104/11/13,213,-107,26,132,95462,18831,3259,117552,32.03%,39.44%,
104/11/12,154,-211,-18,-75,95149,18938,3233,117320,31.93%,39.37%,
104/11/11,482,-1023,-482,-1023,94995,19149,3251,117395,31.88%,39.40%,
104/11/10,-317,-172,-50,-539,94513,20172,3733,118418,31.71%,39.73%,
104/11/09,384,27,-2,409,94830,20344,3783,118957,31.82%,39.92%,
104/11/06,293,-921,-22,-650,94446,20317,3785,118548,31.69%,39.78%,
104/11/05,130,-80,82,132,94164,21238,3807,119209,31.60%,40.01%,
104/11/04,203,-352,55,-94,94034,21318,3725,119077,31.55%,39.95%,
104/11/03,186,-75,-37,74,93831,21670,3670,119171,31.49%,39.99%,
104/11/02,464,-9,-40,415,93635,21745,3707,119087,31.42%,39.96%,
104/10/30,-275,0,-66,-341,93171,21754,3747,118672,31.26%,39.82%,
104/10/29,403,-118,323,608,93446,21754,3813,119013,31.36%,39.94%,
104/10/28,1,-403,-57,-459,93043,21872,3490,118405,31.22%,39.73%,
104/10/27,-103,-7,-240,-350,93042,22275,3547,118864,31.22%,39.89%,
104/10/26,-154,-132,-264,-550,93145,22282,3787,119214,31.26%,40.01%,
104/10/23,-119,-39,-177,-335,93299,22414,4051,119764,31.31%,40.19%,
104/10/22,-66,0,-20,-86,93418,22453,4228,120099,31.35%,40.30%,
104/10/21,545,-211,-234,100,93484,22453,4248,120185,31.37%,40.33%,
104/10/20,-214,54,316,156,92929,22664,4482,120075,31.18%,40.29%,
104/10/19,279,76,-81,274,93143,22610,4166,119919,31.25%,40.24%,
104/10/16,-529,20,130,-379,92864,22534,4247,119645,31.16%,40.15%,
104/10/15,1410,-192,275,1493,93393,22514,4117,120024,31.34%,40.28%,
104/10/14,-576,109,-479,-946,92002,22706,3842,118550,30.87%,39.78%,
104/10/13,-318,-9,479,152,92568,22597,4321,119486,31.06%,40.09%,
104/10/12,-945,-416,-93,-1454,92886,22606,3842,119334,31.17%,40.05%,
104/10/08,-3208,-977,-680,-4865,93831,23022,3935,120788,31.49%,40.54%,
104/10/07,-626,-50,-108,-784,96699,23999,4615,125313,32.45%,42.05%,
104/10/06,380,-197,-188,-5,97343,24049,4723,126115,32.66%,42.32%,
104/10/05,61,-45,-58,-42,96963,24246,4911,126120,32.54%,42.33%,
104/10/02,-187,2,-16,-201,96902,24291,4969,126162,32.52%,42.34%,
104/10/01,34,-87,217,164,97079,24289,4985,126353,32.58%,42.40%,
104/09/30,-182,162,472,452,97035,24376,4768,126179,32.56%,42.34%,
104/09/25,651,293,236,1180,97475,21909,4296,123680,32.71%,41.50%,
104/09/24,-21,-43,-18,-82,96834,21616,4060,122510,32.49%,41.11%,
104/09/23,232,34,105,371,96855,21659,4078,122592,32.50%,41.14%,
104/09/22,-573,17,88,-468,96623,21625,3973,122221,32.42%,41.01%,
104/09/21,-48,-29,8,-69,97196,21608,3885,122689,32.61%,41.17%,
104/09/18,1694,-630,375,1439,97244,21637,3877,122758,32.63%,41.19%,
104/09/17,-85,-252,614,277,95596,22267,3502,121365,32.08%,40.73%,
104/09/16,-97,-298,28,-367,95681,22519,2888,121088,32.11%,40.64%,
104/09/15,65,-705,5,-635,95778,22817,2860,121455,32.14%,40.76%,
104/09/14,148,-499,-57,-408,95713,23522,2855,122090,32.12%,40.97%,
104/09/11,-215,-178,161,-232,95565,24021,2912,122498,32.07%,41.11%,
104/09/10,488,107,44,639,95780,24199,2751,122730,32.14%,41.18%,
104/09/09,161,-31,128,258,95258,24092,2707,122057,31.96%,40.95%,
104/09/08,-89,122,-172,-139,95087,24123,2579,121789,31.91%,40.87%,
104/09/07,455,156,-35,576,95166,24001,2751,121918,31.93%,40.91%,
104/09/04,-718,241,-340,-817,94711,23845,2786,121342,31.78%,40.72%,
104/09/03,-204,717,854,1367,95439,23604,3126,122169,32.03%,41.00%,
104/09/02,-371,51,-87,-407,95643,22887,2272,120802,32.09%,40.53%,
104/09/01,259,20,-94,185,96004,22836,2359,121199,32.21%,40.67%,
104/08/31,-474,-448,177,-745,95795,22816,2453,121064,32.14%,40.62%,
104/08/28,-188,266,53,131,96269,23264,2276,121809,32.30%,40.87%,
104/08/27,-240,589,377,726,96457,22998,2223,121678,32.37%,40.83%,
104/08/26,-528,-45,-40,-613,96697,22409,1846,120952,32.45%,40.59%,
104/08/25,-400,296,4,-100,97225,22454,1886,121565,32.62%,40.79%,
104/08/24,-275,-492,-325,-1092,97425,22158,1882,121465,32.69%,40.76%,
104/08/21,-1241,969,75,-197,97750,22650,2207,122607,32.80%,41.14%,
104/08/20,2397,217,79,2693,99007,21681,2132,122820,33.22%,41.21%,
104/08/19,1213,-65,-110,1038,96610,21464,2053,120127,32.42%,40.31%,
104/08/18,-250,-7,5,-252,95397,21529,2163,119089,32.01%,39.96%,
104/08/17,-105,52,-64,-117,95647,21536,2158,119341,32.10%,40.05%,
104/08/14,235,326,171,732,95752,21484,2222,119458,32.13%,40.09%,
104/08/13,-309,0,91,-218,95517,21158,2051,118726,32.05%,39.84%,
104/08/12,920,67,-119,868,95826,21158,1960,118944,32.16%,39.92%,
104/08/11,261,-65,-132,64,94906,21091,2079,118076,31.85%,39.63%,
104/08/10,320,261,145,726,94605,21156,2211,117972,31.75%,39.59%,
104/08/07,-272,124,-135,-283,94237,20895,2066,117198,31.62%,39.33%,
104/08/06,-153,799,164,810,94499,20771,2201,117471,31.71%,39.42%,
104/08/05,193,387,290,870,94624,19972,2037,116633,31.75%,39.14%,
104/08/04,-1248,455,-47,-840,94446,19585,1747,115778,31.69%,38.85%,
104/08/03,-493,29,-150,-614,95694,19130,1794,116618,32.11%,39.13%,
104/07/31,-1594,454,-51,-1191,96187,19101,1944,117232,32.28%,39.34%,
104/07/30,-703,923,183,403,97711,18647,1995,118353,32.79%,39.72%,
104/07/29,-1010,329,166,-515,98414,17724,1812,117950,33.02%,39.58%,
104/07/28,-1407,146,50,-1211,99424,17395,1646,118465,33.36%,39.75%,
104/07/27,-878,442,-198,-634,100831,17249,1596,119676,33.84%,40.16%,
104/07/24,-1454,10,50,-1394,101709,16807,1794,120310,34.13%,40.37%,
104/07/23,-693,58,199,-436,103201,16797,1744,121742,34.63%,40.85%,
104/07/22,-881,314,130,-437,104123,16739,1545,122407,34.94%,41.08%,
104/07/21,-585,-558,-139,-1282,105015,16425,1415,122855,35.24%,41.23%,
104/07/20,-535,394,-241,-382,105516,16983,1554,124053,35.41%,41.63%,
104/07/17,-1821,284,-199,-1736,106046,16589,1795,124430,35.59%,41.76%,
104/07/16,-50,-14,84,20,107595,16305,1994,125894,36.10%,42.24%,
104/07/15,40,-78,-166,-204,107645,16319,1910,125874,36.12%,42.24%,
104/07/14,-1413,180,-275,-1508,107605,16397,2076,126078,36.11%,42.31%,
104/07/13,-283,489,222,428,109018,16217,2351,127586,36.58%,42.81%,
104/07/09,1263,-470,13,806,109300,15728,2129,127157,36.68%,42.67%,
104/07/08,288,-471,-382,-565,108047,16198,2116,126361,36.26%,42.41%,
104/07/07,129,15,-89,55,107759,16669,2498,126926,36.16%,42.59%,
104/07/06,-215,-50,80,-185,107630,16654,2587,126871,36.12%,42.58%,
104/07/03,526,-652,-165,-291,107845,16704,2507,127056,36.19%,42.64%,
104/07/02,-332,-960,-311,-1603,107319,17356,2673,127348,36.01%,42.73%,
104/07/01,-227,-875,-162,-1264,107651,18316,2984,128951,36.12%,43.27%,
104/06/30,-343,-52,-140,-535,107878,19191,3146,130215,36.20%,43.70%,
104/06/29,-847,0,-314,-1161,108211,21183,3286,132680,36.31%,44.52%,
104/06/26,-186,-35,-27,-248,109058,21183,3600,133841,36.60%,44.92%,
104/06/25,-478,120,172,-186,109244,21218,3627,134089,36.66%,45.00%,
104/06/24,-445,56,-316,-705,109722,21098,3455,134275,36.82%,45.06%,
104/06/23,-222,-14,614,378,110167,21042,3771,134980,36.97%,45.30%,
104/06/22,214,-34,-10,170,110396,21056,3157,134609,37.05%,45.18%,
104/06/18,-43,0,71,28,110214,21090,3167,134471,36.98%,45.12%,
104/06/17,-573,-155,-308,-1036,110257,21090,3096,134443,37.00%,45.12%,
104/06/16,-209,-10,-70,-289,110830,21245,3404,135479,37.19%,45.46%,
104/06/15,-303,-168,-369,-840,111039,21255,3474,135768,37.26%,45.56%,
104/06/12,-777,223,0,-554,111342,21423,3843,136608,37.36%,45.84%,
104/06/11,-40,0,209,169,112109,21200,3843,137152,37.62%,46.02%,
104/06/10,85,0,-9,76,112149,21200,3634,136983,37.63%,45.96%,
104/06/09,637,506,19,1162,112064,21200,3643,136907,37.60%,45.94%,
104/06/08,209,-283,52,-22,111427,20694,3624,135745,37.39%,45.55%,
104/06/05,-94,4,-11,-101,111208,20977,3572,135757,37.32%,45.56%,
104/06/04,-353,44,-138,-447,111302,20973,3583,135858,37.35%,45.59%,
104/06/03,-389,-140,-6,-535,111655,20929,3721,136305,37.47%,45.74%,
104/06/02,-656,-450,-399,-1505,112044,21069,3727,136840,37.60%,45.92%,
104/06/01,-841,655,1214,1028,112700,21519,4126,138345,37.82%,46.43%,
104/05/29,276,6,31,313,113542,20864,2912,137318,38.10%,46.08%,
104/05/28,325,855,160,1340,113256,20858,2881,136995,38.00%,45.97%,
104/05/27,1907,-223,94,1778,112931,20003,2721,135655,37.90%,45.53%,
104/05/26,-201,-111,-32,-344,111043,20226,2627,133896,37.26%,44.93%,
104/05/25,-432,58,-137,-511,111244,20337,2659,134240,37.33%,45.05%,
104/05/22,33,1011,10,1054,111676,20279,2796,134751,37.47%,45.21%,
104/05/21,560,11,-92,479,111633,19268,2786,133687,37.46%,44.86%,
104/05/20,-294,-45,-287,-626,111082,19257,2878,133217,37.28%,44.71%,
104/05/19,1011,2045,386,3442,111441,19302,3165,133908,37.40%,44.94%,
104/05/18,-408,1282,269,1143,110261,17257,2779,130297,37.00%,43.72%,
104/05/15,-22,-104,-90,-216,110669,15975,2510,129154,37.14%,43.34%,
104/05/14,-41,-40,-125,-206,110691,16079,2600,129370,37.14%,43.41%,
104/05/13,-159,-298,68,-389,110825,16119,2725,129669,37.19%,43.51%,
104/05/12,-834,11,-111,-934,110984,16417,2657,130058,37.24%,43.64%,
104/05/11,-84,113,267,296,111818,16406,2768,130992,37.52%,43.96%,
104/05/08,294,10,48,352,111895,16293,2501,130689,37.55%,43.86%,
104/05/07,285,24,-206,103,111634,16283,2453,130370,37.46%,43.75%,
104/05/06,190,100,188,478,111349,16259,2659,130267,37.37%,43.72%,
104/05/05,-326,-200,-75,-601,111159,16159,2471,129789,37.30%,43.55%,
104/05/04,142,-10,129,261,111448,16359,2546,130353,37.40%,43.74%,
104/04/30,-127,-31,-124,-282,111279,16369,2417,130065,37.34%,43.64%,
104/04/29,373,-58,311,626,111321,16400,2541,130262,37.36%,43.72%,
104/04/28,-623,18,-21,-626,110948,16458,2230,129636,37.23%,43.50%,
104/04/27,-870,-272,-42,-1184,111571,16440,2251,130262,37.44%,43.71%,
104/04/24,-256,33,-205,-428,112441,16712,2293,131446,37.73%,44.11%,
104/04/23,-711,1700,-123,866,112697,16679,2498,131874,37.82%,44.26%,
104/04/22,1490,618,276,2384,113398,14979,2621,130998,38.05%,43.96%,
104/04/21,2183,0,-1,2182,111885,14361,2345,128591,37.54%,43.15%,
104/04/20,39,29,68,136,109690,14361,2346,126397,36.81%,42.42%,
104/04/17,33,9,37,79,109651,14332,2278,126261,36.80%,42.37%,
104/04/16,-470,0,-3,-473,109608,14323,2241,126172,36.78%,42.34%,
104/04/15,272,473,-554,191,110078,14323,2244,126645,36.94%,42.50%,
104/04/14,867,870,416,2153,109806,13850,2798,126454,36.85%,42.44%,
104/04/13,2624,491,65,3180,108939,12980,2382,124301,36.56%,41.72%,
104/04/10,-324,-195,217,-302,106315,12489,2317,121121,35.68%,40.65%,
104/04/09,1445,-457,-103,885,106639,12684,2100,121423,35.78%,40.74%,
104/04/08,-641,39,238,-364,105194,13141,2203,120538,35.30%,40.45%,
104/04/07,-34,-45,76,-3,105835,13102,1965,120902,35.51%,40.57%,
104/04/02,-877,45,-60,-892,105869,13147,1889,120905,35.53%,40.58%,
104/04/01,-83,393,-183,127,106746,13102,1949,121797,35.82%,40.87%,
104/03/31,301,6,-80,227,106829,12709,2132,121670,35.85%,40.83%,
104/03/30,146,632,-12,766,106528,14478,2212,123218,35.75%,41.35%,
104/03/27,12,412,444,868,106382,13846,2224,122452,35.70%,41.09%,
104/03/26,-386,216,-77,-247,106370,13434,1780,121584,35.69%,40.80%,
104/03/25,90,-66,97,121,106756,13218,1857,121831,35.82%,40.88%,
104/03/24,605,43,-164,484,106666,13284,1760,121710,35.79%,40.84%,
104/03/23,-362,107,-146,-401,106061,13241,1924,121226,35.59%,40.68%,
104/03/20,1007,251,66,1324,106423,13134,2070,121627,35.71%,40.81%,
104/03/19,1824,11,352,2187,105416,12883,2004,120303,35.37%,40.37%,
104/03/18,1053,-299,66,820,103592,12872,1652,118116,34.76%,39.63%,
104/03/17,-221,-440,-160,-821,102539,13171,1586,117296,34.41%,39.36%,
104/03/16,618,-426,75,267,102827,13611,1746,118184,34.50%,39.65%,
104/03/13,76,-108,-759,-791,102209,14037,1671,117917,34.30%,39.57%,
104/03/12,194,-102,-166,-74,102133,14145,2430,118708,34.27%,39.83%,
104/03/11,123,153,-50,226,101939,14247,2596,118782,34.21%,39.86%,
104/03/10,-718,-13,-151,-882,101816,14094,2646,118556,34.17%,39.79%,
104/03/09,631,-298,622,955,102534,14107,2797,119438,34.41%,40.08%,
104/03/06,115,-806,-102,-793,102090,14405,2175,118670,34.26%,39.82%,
104/03/05,-173,-104,-253,-530,102017,15211,2277,119505,34.23%,40.10%,
104/03/04,827,-152,-4,671,102166,15315,2530,120011,34.28%,40.27%,
104/03/03,1170,592,589,2351,101277,15467,2534,119278,33.98%,40.02%,
104/03/02,295,-333,-125,-163,100107,14875,1945,116927,33.59%,39.23%,
104/02/26,985,-558,-257,170,99773,15208,2070,117051,33.48%,39.28%,
104/02/25,1323,13,-29,1307,98741,15766,2327,116834,33.13%,39.20%,
104/02/24,588,-150,535,973,97435,15753,2356,115544,32.70%,38.78%,
104/02/13,1119,-436,-439,244,96847,15903,1821,114571,32.50%,38.45%,
104/02/12,54,-297,-42,-285,95889,16339,2260,114488,32.18%,38.42%,
104/02/11,2258,93,87,2438,95791,16636,2302,114729,32.14%,38.50%,
104/02/10,620,-387,-25,208,93533,16543,2215,112291,31.39%,37.69%,
104/02/09,115,-125,33,23,92903,16930,2240,112073,31.17%,37.60%,
104/02/06,-95,1985,-839,1051,92774,17055,2207,112036,31.13%,37.59%,
104/02/05,363,-206,-181,-24,92836,15070,3046,110952,31.15%,37.23%,
104/02/04,965,26,718,1709,92436,15276,3227,110939,31.02%,37.23%,
104/02/03,1399,67,45,1511,91456,15250,2509,109215,30.69%,36.65%,
104/02/02,177,-250,-343,-416,90057,15183,2464,107704,30.22%,36.14%,
104/01/30,2646,249,25,2920,89866,15433,2807,108106,30.15%,36.27%,
104/01/29,364,-215,-188,-39,87125,15184,2782,105091,29.23%,35.26%,
104/01/28,235,47,168,450,86761,15399,2970,105130,29.11%,35.27%,
104/01/27,544,472,275,1291,86526,15352,2802,104680,29.03%,35.12%,
104/01/26,-1079,-300,220,-1159,85995,14880,2527,103402,28.86%,34.70%,
104/01/23,160,-330,-70,-240,87074,15180,2307,104561,29.22%,35.09%,
104/01/22,619,-90,-964,-435,86914,15510,2377,104801,29.16%,35.16%,
104/01/21,1619,111,840,2570,86322,15600,3341,105263,28.97%,35.33%,
104/01/20,1246,234,398,1878,84703,15489,2501,102693,28.42%,34.46%,
104/01/19,348,0,-19,329,83457,15255,2103,100815,28.00%,33.83%,
104/01/16,366,-30,-273,63,83109,15255,2122,100486,27.89%,33.72%,
104/01/15,150,0,-126,24,82743,15285,2395,100423,27.76%,33.69%,
104/01/14,-422,300,-236,-358,82593,15285,2521,100399,27.71%,33.69%,
104/01/13,1654,149,601,2404,83005,14985,2757,100747,27.85%,33.80%,
104/01/12,746,0,-39,707,81331,14836,2156,98323,27.29%,32.99%,
104/01/09,339,0,88,427,80585,14836,2195,97616,27.04%,32.76%,
104/01/08,-65,0,12,-53,80246,14836,2107,97189,26.93%,32.62%,
104/01/07,-469,610,-92,49,80311,14836,2095,97242,26.95%,32.63%,
104/01/06,2518,700,47,3265,80780,14226,2187,97193,27.11%,32.62%,
104/01/05,-9,0,-17,-26,78262,13526,2140,93928,26.26%,31.52%,
