日期,外資買賣超,投信買賣超,自營商買賣超,單日合計買賣超,外資估計持股,投信估計持股,自營商估計持股,單日合計估計持股,外資持股比重,三大法人持股比重,
107/03/31,0,-15,0,-15,3212,3304,27,6543,2.83%,6.06%,
107/03/30,2,-16,0,-14,3212,3319,27,6558,2.83%,6.07%,
107/03/29,1,-16,0,-15,3210,3335,27,6572,2.83%,6.09%,
107/03/28,-2,0,0,-2,3209,3351,27,6587,2.83%,6.10%,
107/03/27,-2,-1,0,-3,3201,3351,27,6579,2.82%,6.09%,
107/03/26,-4,0,0,-4,3203,3352,27,6582,2.82%,6.09%,
107/03/23,-7,0,0,-7,3197,3352,27,6576,2.82%,6.09%,
107/03/22,3,-4,0,-1,3204,3352,27,6583,2.82%,6.09%,
107/03/21,0,0,0,0,3211,3356,27,6594,2.83%,6.11%,
107/03/20,-3,0,0,-3,3211,3356,27,6594,2.83%,6.11%,
107/03/19,0,0,0,0,3316,3356,27,6699,2.92%,6.20%,
107/03/16,0,-17,0,-17,3224,3356,27,6607,2.84%,6.12%,
107/03/15,0,-24,0,-24,3224,3373,27,6624,2.84%,6.13%,
107/03/14,-6,-16,0,-22,3224,3397,27,6648,2.84%,6.16%,
107/03/13,2,-17,-1,-16,3230,3413,27,6670,2.85%,6.18%,
107/03/12,-1,0,0,-1,3228,3430,28,6686,2.84%,6.19%,
107/03/09,-1,0,0,-1,3229,3430,28,6687,2.85%,6.20%,
107/03/08,2,-10,0,-8,3230,3430,28,6688,2.85%,6.20%,
107/03/07,1,0,0,1,3228,3440,28,6696,2.84%,6.20%,
107/03/06,8,-70,8,-54,3227,3440,28,6695,2.84%,6.20%,
107/03/05,-7,-13,0,-20,3219,3510,20,6749,2.84%,6.26%,
107/03/02,-11,-119,-1,-131,3226,3523,20,6769,2.84%,6.27%,
107/03/01,-11,-40,0,-51,3237,3642,21,6900,2.85%,6.40%,
107/02/27,-176,-69,0,-245,3248,3682,21,6951,2.86%,6.45%,
107/02/26,-11,-18,0,-29,3423,3751,21,7195,3.02%,6.67%,
107/02/23,-33,-82,-1,-116,3434,3769,21,7224,3.03%,6.70%,
107/02/22,-32,-79,0,-111,3466,3851,22,7339,3.05%,6.80%,
107/02/21,-10,0,0,-10,3498,3930,22,7450,3.08%,6.91%,
107/02/12,-35,-21,2,-54,3508,3930,22,7460,3.09%,6.92%,
107/02/09,13,0,1,14,3543,3951,20,7514,3.12%,6.96%,
107/02/08,-35,-4,1,-38,3530,3951,19,7500,3.11%,6.95%,
107/02/07,-32,-47,-2,-81,3565,3955,18,7538,3.14%,6.99%,
107/02/06,-43,0,-3,-46,3597,4002,20,7619,3.17%,7.06%,
107/02/05,-34,0,-1,-35,3640,4002,23,7665,3.21%,7.11%,
107/02/02,-88,-10,0,-98,3674,4002,24,7700,3.24%,7.14%,
107/02/01,-40,-13,0,-53,3762,4012,24,7798,3.32%,7.23%,
107/01/31,-41,0,0,-41,3804,4025,24,7853,3.35%,7.27%,
107/01/30,-22,-17,0,-39,3845,4025,24,7894,3.39%,7.31%,
107/01/29,-9,0,0,-9,3867,4042,24,7933,3.41%,7.35%,
107/01/26,-21,0,0,-21,3876,4042,24,7942,3.42%,7.36%,
107/01/25,-12,0,0,-12,3897,4042,24,7963,3.44%,7.38%,
107/01/24,0,0,0,0,3909,4042,24,7975,3.45%,7.39%,
107/01/23,-27,0,0,-27,3909,4042,24,7975,3.45%,7.39%,
107/01/22,-38,0,0,-38,3936,4042,24,8002,3.47%,7.41%,
107/01/19,0,0,0,0,3974,4042,24,8040,3.50%,7.44%,
107/01/18,-18,0,1,-17,3974,4042,24,8040,3.50%,7.44%,
107/01/17,-2,0,0,-2,4028,4042,23,8093,3.55%,7.49%,
107/01/16,2,0,0,2,4030,4042,23,8095,3.55%,7.49%,
107/01/15,-12,0,0,-12,4028,4042,23,8093,3.55%,7.49%,
107/01/12,-0,0,0,0,4040,4042,23,8105,3.56%,7.50%,
107/01/11,-2,0,0,-2,4040,4042,23,8105,3.56%,7.50%,
107/01/10,-1,0,0,-1,4042,4042,23,8107,3.56%,7.50%,
107/01/09,-5,0,0,-5,4043,4042,23,8108,3.56%,7.50%,
107/01/08,-17,0,3,-14,4106,4042,23,8171,3.62%,7.56%,
107/01/05,4,0,0,4,4123,4042,20,8185,3.63%,7.56%,
107/01/04,1,0,0,1,4174,4042,20,8236,3.68%,7.61%,
107/01/03,-4,0,0,-4,4173,4042,20,8235,3.68%,7.61%,
107/01/02,-4,0,0,-4,4177,4042,20,8239,3.68%,7.61%,
106/12/29,5,0,0,5,4181,4042,20,8243,3.69%,7.62%,
106/12/28,4,0,-1,3,4176,4045,20,8241,3.68%,7.62%,
106/12/27,6,0,0,6,4172,4045,21,8238,3.68%,7.62%,
106/12/26,1,0,0,1,4166,4045,21,8232,3.67%,7.61%,
106/12/25,-1,0,0,-1,4165,4045,21,8231,3.67%,7.61%,
106/12/22,0,0,0,0,4166,4045,21,8232,3.67%,7.61%,
106/12/21,4,0,0,4,4166,4045,21,8232,3.67%,7.61%,
106/12/20,-2,0,0,-2,4162,4045,21,8228,3.67%,7.61%,
106/12/19,2,0,0,2,4266,4045,21,8332,3.76%,7.70%,
106/12/18,-21,0,1,-20,4264,4045,21,8330,3.76%,7.70%,
106/12/15,-2,0,0,-2,4285,4045,20,8350,3.78%,7.72%,
106/12/14,-11,0,0,-11,4287,4045,20,8352,3.78%,7.72%,
106/12/13,0,0,0,0,4298,4045,20,8363,3.79%,7.73%,
106/12/12,20,0,0,20,4298,4045,20,8363,3.79%,7.73%,
106/12/11,-11,0,0,-11,4278,4045,20,8343,3.77%,7.71%,
106/12/08,-7,0,0,-7,4289,4045,20,8354,3.78%,7.72%,
106/12/07,-2,0,0,-2,4296,4045,20,8361,3.79%,7.73%,
106/12/06,-9,0,0,-9,4298,4045,20,8363,3.79%,7.73%,
106/12/05,1,0,0,1,4307,4045,20,8372,3.80%,7.74%,
106/12/04,-8,0,1,-7,4306,4045,20,8371,3.80%,7.74%,
106/12/01,-23,0,1,-22,4314,4045,19,8378,3.80%,7.73%,
106/11/30,-30,0,0,-30,4337,4045,18,8400,3.82%,7.75%,
106/11/29,-6,0,0,-6,4367,4045,18,8430,3.85%,7.78%,
106/11/28,-10,0,-3,-13,4373,4045,18,8436,3.86%,7.79%,
106/11/27,-34,0,0,-34,4373,4045,21,8439,3.86%,7.80%,
106/11/24,14,0,1,15,4407,4045,21,8473,3.89%,7.83%,
106/11/23,4,0,0,4,4393,4045,20,8458,3.87%,7.81%,
106/11/22,9,0,5,14,4389,4045,20,8454,3.87%,7.81%,
106/11/21,-42,0,0,-42,4380,4045,15,8440,3.86%,7.79%,
106/11/20,-18,0,0,-18,4422,4045,15,8482,3.90%,7.83%,
106/11/17,-45,0,0,-45,4440,4045,15,8500,3.91%,7.84%,
106/11/16,6,0,0,6,4485,4045,15,8545,3.95%,7.88%,
106/11/15,7,0,0,7,4479,4045,15,8539,3.95%,7.88%,
106/11/14,67,0,3,70,4472,4045,15,8532,3.94%,7.87%,
106/11/13,39,0,0,39,4405,4045,12,8462,3.88%,7.81%,
106/11/10,34,0,-1,33,4394,4045,12,8451,3.87%,7.80%,
106/11/09,-15,0,0,-15,4360,4045,13,8418,3.84%,7.77%,
106/11/08,15,0,0,15,4375,4045,13,8433,3.86%,7.79%,
106/11/07,-13,0,-7,-20,4360,4045,13,8418,3.84%,7.77%,
106/11/06,21,0,-1,20,4373,4045,20,8438,3.86%,7.80%,
106/11/03,7,0,-4,3,4352,4045,21,8418,3.84%,7.78%,
106/11/02,-35,0,0,-35,4345,4045,25,8415,3.83%,7.77%,
106/11/01,-19,0,0,-19,4368,4045,25,8438,3.85%,7.79%,
106/10/31,-24,0,-8,-32,4387,4045,25,8457,3.87%,7.81%,
106/10/30,-73,0,-10,-83,4411,4045,33,8489,3.89%,7.84%,
106/10/27,-55,0,-1,-56,4473,4045,43,8561,3.94%,7.90%,
106/10/26,-25,0,0,-25,4525,4045,44,8614,3.99%,7.95%,
106/10/25,-61,0,-10,-71,4550,4045,44,8639,4.01%,7.97%,
106/10/24,-7,0,0,-7,4611,4045,54,8710,4.07%,8.04%,
106/10/23,-7,0,0,-7,4618,4045,54,8717,4.07%,8.04%,
106/10/20,-9,0,4,-5,4625,4045,54,8724,4.08%,8.05%,
106/10/19,-18,0,5,-13,4634,4045,50,8729,4.09%,8.05%,
106/10/18,-17,0,0,-17,4639,4045,45,8729,4.09%,8.05%,
106/10/17,-70,0,0,-70,4656,4045,45,8746,4.10%,8.06%,
106/10/16,-33,0,0,-33,4717,4045,45,8807,4.16%,8.12%,
106/10/13,1,0,0,1,4740,4045,45,8830,4.18%,8.14%,
106/10/12,16,0,0,16,4722,4045,45,8812,4.16%,8.12%,
106/10/11,12,0,0,12,4706,4045,45,8796,4.15%,8.11%,
106/10/06,-14,0,0,-14,4694,4045,45,8784,4.14%,8.10%,
106/10/05,17,0,0,17,4708,4045,45,8798,4.15%,8.11%,
106/10/03,37,0,0,37,4691,4045,45,8781,4.14%,8.10%,
106/10/02,33,0,-1,32,4629,4045,45,8719,4.08%,8.04%,
106/09/30,0,0,0,0,4591,4045,46,8682,4.05%,8.01%,
106/09/29,-9,0,0,-9,4591,4044,46,8681,4.05%,8.01%,
106/09/28,5,0,0,5,4600,4044,46,8690,4.06%,8.02%,
106/09/27,99,0,0,99,4593,4044,46,8683,4.05%,8.01%,
106/09/26,-94,0,0,-94,4481,4044,46,8571,3.95%,7.91%,
106/09/25,-59,0,1,-58,4571,4044,46,8661,4.03%,7.99%,
106/09/22,5,0,0,5,4630,4044,45,8719,4.08%,8.04%,
106/09/21,42,0,0,42,4625,4044,45,8714,4.08%,8.04%,
106/09/20,101,0,0,101,4583,4044,45,8672,4.04%,8.00%,
106/09/19,218,0,0,218,4482,4044,45,8571,3.95%,7.91%,
106/09/18,33,0,0,33,4261,4044,45,8350,3.76%,7.72%,
106/09/15,25,0,0,25,4228,4044,45,8317,3.73%,7.69%,
106/09/14,-13,0,0,-13,4203,4044,45,8292,3.71%,7.67%,
106/09/13,-27,0,0,-27,4115,4044,45,8204,3.63%,7.59%,
106/09/12,-34,0,0,-34,4143,4044,45,8232,3.65%,7.61%,
106/09/11,-49,0,1,-48,4177,4044,45,8266,3.68%,7.64%,
106/09/08,-71,-29,0,-100,4226,4044,44,8314,3.72%,7.68%,
106/09/07,-60,0,0,-60,4280,4073,44,8397,3.77%,7.76%,
106/09/06,-55,0,0,-55,4340,4073,44,8457,3.83%,7.82%,
106/09/05,-29,0,0,-29,4388,4073,44,8505,3.87%,7.86%,
106/09/04,-24,0,0,-24,4364,4073,44,8481,3.85%,7.84%,
106/09/01,-62,0,0,-62,4388,4073,44,8505,3.87%,7.86%,
106/08/31,-50,0,0,-50,4450,4073,44,8567,3.92%,7.91%,
106/08/30,-96,0,0,-96,4500,4073,44,8617,3.97%,7.96%,
106/08/29,-43,0,0,-43,4596,4073,44,8713,4.05%,8.04%,
106/08/28,-89,0,0,-89,4639,4073,44,8756,4.09%,8.08%,
106/08/25,-109,0,-3,-112,4728,4073,44,8845,4.17%,8.16%,
106/08/24,-112,0,0,-112,4837,4073,47,8957,4.26%,8.25%,
106/08/23,-129,0,-1,-130,4949,4073,47,9069,4.36%,8.35%,
106/08/22,-25,0,0,-25,5078,4073,48,9199,4.48%,8.47%,
106/08/21,47,0,0,47,5103,4073,48,9224,4.50%,8.49%,
106/08/18,-154,0,-1,-155,5056,4073,48,9177,4.46%,8.45%,
106/08/17,-134,0,-5,-139,5160,4073,49,9282,4.55%,8.54%,
106/08/16,-185,0,0,-185,5294,4073,54,9421,4.67%,8.67%,
106/08/15,-162,0,0,-162,5472,4073,54,9599,4.82%,8.82%,
106/08/14,-195,0,-11,-206,5634,4073,54,9761,4.97%,8.97%,
106/08/11,66,-30,-1,35,5829,4073,65,9967,5.14%,9.15%,
106/08/10,-86,0,-20,-106,5763,4103,66,9932,5.08%,9.12%,
106/08/09,42,0,0,42,5849,4103,86,10038,5.16%,9.22%,
106/08/08,9,0,-10,-1,5807,4103,86,9996,5.12%,9.18%,
106/08/07,17,0,-9,8,5798,4103,96,9997,5.11%,9.18%,
106/08/04,57,0,0,57,5781,4103,105,9989,5.10%,9.17%,
106/08/03,149,0,0,149,5724,4103,105,9932,5.05%,9.12%,
106/08/02,14,0,0,14,5575,4103,105,9783,4.92%,8.99%,
106/08/01,-103,0,0,-103,5561,4103,105,9769,4.90%,8.97%,
106/07/31,-48,0,28,-20,5563,4103,105,9771,4.91%,8.98%,
106/07/28,35,0,-6,29,5611,4103,77,9791,4.95%,9.00%,
106/07/27,-80,0,0,-80,5576,4103,83,9762,4.92%,8.97%,
106/07/26,-115,0,3,-112,5656,4103,83,9842,4.99%,9.04%,
106/07/25,13,0,0,13,5735,4103,80,9918,5.06%,9.11%,
106/07/24,43,0,0,43,5722,4103,80,9905,5.05%,9.10%,
106/07/21,-73,0,0,-73,5679,4103,80,9862,5.01%,9.06%,
106/07/20,-215,55,-3,-163,5752,4103,80,9935,5.07%,9.12%,
106/07/19,-154,0,-13,-167,6065,4048,83,10196,5.35%,9.35%,
106/07/18,-125,107,20,2,6260,4048,96,10404,5.52%,9.53%,
106/07/17,-97,0,0,-97,6385,3941,76,10402,5.63%,9.52%,
106/07/14,-15,0,-1,-16,6482,3941,76,10499,5.72%,9.61%,
106/07/13,-33,0,-3,-36,6497,3941,77,10515,5.73%,9.62%,
106/07/12,-32,0,-2,-34,6530,3941,80,10551,5.76%,9.65%,
106/07/11,-50,0,-8,-58,6562,3941,82,10585,5.79%,9.69%,
106/07/10,-84,39,-1,-46,6612,3941,90,10643,5.83%,9.73%,
106/07/07,-96,178,0,82,6938,3902,91,10931,6.12%,9.99%,
106/07/06,-188,0,0,-188,7034,3724,91,10849,6.20%,9.89%,
106/07/05,-227,253,2,28,7222,3724,91,11037,6.37%,10.06%,
106/07/04,-219,139,-14,-94,7449,3471,89,11009,6.57%,10.02%,
106/07/03,-59,134,-10,65,7668,3332,103,11103,6.76%,10.09%,
106/06/30,-267,172,-2,-97,7727,3198,113,11038,6.82%,10.03%,
106/06/29,-129,252,2,125,7994,3026,115,11135,7.05%,10.09%,
106/06/28,-240,250,0,10,8123,2774,113,11010,7.17%,9.97%,
106/06/27,64,0,-3,61,8363,2524,113,11000,7.38%,9.93%,
106/06/26,64,0,-3,61,8299,2524,116,10939,7.32%,9.88%,
106/06/23,-278,180,0,-98,8235,2524,119,10878,7.26%,9.82%,
106/06/22,281,0,-17,264,8513,2344,119,10976,7.51%,9.89%,
106/06/21,58,200,1,259,8232,2344,136,10712,7.26%,9.66%,
106/06/20,-197,50,-44,-191,8174,2144,135,10453,7.21%,9.42%,
106/06/19,22,0,-10,12,8371,2094,179,10644,7.38%,9.58%,
106/06/16,128,0,-69,59,8349,2094,189,10632,7.36%,9.57%,
106/06/15,204,0,11,215,8221,2094,258,10573,7.25%,9.53%,
106/06/14,-80,234,-30,124,8017,2094,247,10358,7.07%,9.34%,
106/06/13,106,300,-47,359,8097,1860,277,10234,7.14%,9.21%,
106/06/12,324,0,-69,255,8126,1560,324,10010,7.17%,8.99%,
106/06/09,211,114,-5,320,7856,1560,393,9809,6.93%,8.82%,
106/06/08,422,0,126,548,8034,1446,398,9878,7.09%,8.88%,
106/06/07,594,300,38,932,7612,1446,272,9330,6.71%,8.37%,
106/06/06,1191,80,26,1297,7192,1146,234,8572,6.34%,7.68%,
106/06/05,614,8,-9,613,6149,1066,208,7423,5.42%,6.65%,
106/06/03,10,188,56,254,5535,1058,217,6810,4.88%,6.11%,
106/06/02,1070,0,-2,1068,5525,870,161,6556,4.87%,5.87%,
106/06/01,569,0,11,580,4585,870,163,5618,4.04%,5.04%,
106/05/31,354,0,41,395,4016,870,152,5038,3.54%,4.53%,
106/05/26,237,110,24,371,3725,870,111,4706,3.28%,4.23%,
106/05/25,205,10,24,239,3635,760,87,4482,3.20%,4.02%,
106/05/24,405,200,13,618,3563,750,63,4376,3.14%,3.93%,
106/05/23,198,87,22,307,3289,550,50,3889,2.90%,3.48%,
106/05/22,68,150,0,218,3081,463,28,3572,2.71%,3.19%,
106/05/19,181,9,-1,189,2993,313,28,3334,2.64%,2.97%,
106/05/18,-68,114,0,46,2812,304,29,3145,2.48%,2.80%,
106/05/17,-42,150,0,108,2875,190,29,3094,2.53%,2.74%,
106/05/16,94,0,0,94,2917,40,29,2986,2.57%,2.64%,
106/05/15,-33,20,0,-13,2923,40,29,2992,2.57%,2.64%,
106/05/12,13,0,0,13,2963,20,29,3012,2.61%,2.66%,
106/05/11,41,0,0,41,2820,20,29,2869,2.48%,2.53%,
106/05/10,35,20,0,55,2779,20,29,2828,2.45%,2.50%,
106/05/09,-16,0,0,-16,2734,0,29,2763,2.41%,2.44%,
106/05/08,135,0,0,135,2740,0,29,2769,2.41%,2.44%,
106/05/05,-156,0,0,-156,2634,0,29,2663,2.32%,2.35%,
106/05/04,-105,0,3,-102,2668,0,29,2697,2.35%,2.38%,
106/05/03,-57,0,0,-57,2813,0,26,2839,2.48%,2.51%,
106/05/02,91,0,-2,89,2871,0,26,2897,2.53%,2.56%,
106/04/28,111,0,0,111,2780,0,28,2808,2.45%,2.48%,
106/04/27,60,0,1,61,2753,0,28,2781,2.42%,2.45%,
106/04/26,89,0,0,89,2693,0,27,2720,2.37%,2.40%,
106/04/25,-15,0,0,-15,2603,0,27,2630,2.29%,2.32%,
106/04/24,53,0,0,53,2418,0,27,2445,2.13%,2.16%,
106/04/21,2,0,0,2,2226,0,27,2253,1.96%,1.99%,
106/04/20,-9,0,0,-9,2224,0,27,2251,1.96%,1.99%,
106/04/19,24,0,-1,23,2183,0,27,2210,1.92%,1.95%,
106/04/18,-40,0,0,-40,2159,0,28,2187,1.90%,1.93%,
106/04/17,-16,0,0,-16,2199,0,28,2227,1.94%,1.97%,
106/04/14,-7,0,0,-7,2215,0,28,2243,1.95%,1.98%,
106/04/13,-10,0,1,-9,2222,0,28,2250,1.96%,1.99%,
106/04/12,41,0,0,41,2232,0,27,2259,1.97%,2.00%,
106/04/11,62,0,0,62,2191,0,27,2218,1.93%,1.96%,
106/04/10,-30,0,0,-30,2129,0,27,2156,1.87%,1.90%,
106/04/07,-58,0,0,-58,2154,0,27,2181,1.90%,1.93%,
106/04/06,-3,0,0,-3,2212,0,27,2239,1.95%,1.98%,
106/04/05,43,0,0,43,2215,0,27,2242,1.95%,1.98%,
106/03/31,-115,0,0,-115,2172,0,27,2199,1.91%,1.94%,
106/03/30,-7,0,0,-7,2287,0,27,2314,2.01%,2.04%,
106/03/29,-140,0,0,-140,2294,0,27,2321,2.02%,2.05%,
106/03/28,-30,0,-2,-32,2418,0,27,2445,2.13%,2.16%,
106/03/27,20,0,0,20,2448,0,29,2477,2.16%,2.19%,
106/03/24,23,0,0,23,2428,0,29,2457,2.14%,2.17%,
106/03/23,-38,0,0,-38,2405,0,29,2434,2.12%,2.15%,
106/03/22,74,0,0,74,2443,0,29,2472,2.15%,2.18%,
106/03/21,-129,0,2,-127,2376,0,29,2405,2.09%,2.12%,
106/03/20,-69,0,4,-65,2355,0,27,2382,2.07%,2.10%,
106/03/17,-93,0,0,-93,2264,0,23,2287,1.99%,2.01%,
106/03/16,-16,0,1,-15,2215,0,23,2238,1.95%,1.97%,
106/03/15,-8,0,1,-7,2231,0,22,2253,1.96%,1.98%,
106/03/14,58,0,-1,57,2199,0,21,2220,1.94%,1.96%,
106/03/13,-24,0,0,-24,2141,0,22,2163,1.88%,1.90%,
106/03/10,-40,0,1,-39,2163,0,22,2185,1.90%,1.92%,
106/03/09,-1,0,1,0,2183,0,21,2204,1.92%,1.94%,
106/03/08,6,0,0,6,2184,0,20,2204,1.92%,1.94%,
106/03/07,-17,0,0,-17,2178,0,20,2198,1.92%,1.94%,
106/03/06,-174,0,0,-174,2195,0,20,2215,1.93%,1.95%,
106/03/03,146,0,-2,144,2319,0,20,2339,2.04%,2.06%,
106/03/02,-100,0,2,-98,2163,0,22,2185,1.90%,1.92%,
106/03/01,-155,0,4,-151,2259,0,20,2279,1.99%,2.01%,
106/02/24,-84,0,0,-84,2414,0,16,2430,2.13%,2.15%,
106/02/23,-209,0,0,-209,2398,0,16,2414,2.11%,2.13%,
106/02/22,-99,0,1,-98,2556,0,16,2572,2.25%,2.27%,
106/02/21,-92,0,1,-91,2655,0,15,2670,2.34%,2.35%,
106/02/20,-52,0,0,-52,2599,0,14,2613,2.29%,2.30%,
106/02/18,0,0,0,0,2576,0,14,2590,2.27%,2.28%,
106/02/17,-78,0,3,-75,2576,0,14,2590,2.27%,2.28%,
106/02/16,-42,0,0,-42,2664,0,11,2675,2.35%,2.36%,
106/02/15,-27,0,0,-27,2706,0,11,2717,2.38%,2.39%,
106/02/14,-37,0,0,-37,2731,0,11,2742,2.41%,2.42%,
106/02/13,-43,0,0,-43,2768,0,11,2779,2.44%,2.45%,
106/02/10,-38,0,1,-37,2810,0,11,2821,2.48%,2.49%,
106/02/09,-54,0,-1,-55,2871,0,10,2881,2.53%,2.54%,
106/02/08,-28,0,-1,-29,2923,0,11,2934,2.57%,2.58%,
106/02/07,-182,0,0,-182,2946,0,12,2958,2.60%,2.61%,
106/02/06,407,0,-2,405,3128,0,12,3140,2.76%,2.77%,
106/02/03,43,0,0,43,2701,0,14,2715,2.38%,2.39%,
106/02/02,72,0,-2,70,2727,0,14,2741,2.40%,2.41%,
106/01/24,115,0,1,116,2651,0,16,2667,2.33%,2.35%,
106/01/23,-1,0,0,-1,2536,0,15,2551,2.23%,2.24%,
106/01/20,-13,0,2,-11,2537,0,15,2552,2.23%,2.24%,
106/01/19,473,0,-2,471,2550,0,13,2563,2.25%,2.26%,
106/01/18,106,-220,-4,-118,2077,0,15,2092,1.83%,1.84%,
106/01/17,46,-150,-1,-105,1971,220,19,2210,1.73%,1.96%,
106/01/16,31,-30,0,1,1907,370,20,2297,1.68%,2.06%,
106/01/13,-30,0,0,-30,1786,400,20,2206,1.57%,1.98%,
106/01/12,-117,0,-1,-118,1806,400,20,2226,1.59%,2.00%,
106/01/11,85,0,0,85,1923,400,21,2344,1.69%,2.10%,
106/01/10,-73,0,0,-73,1838,400,21,2259,1.62%,2.03%,
106/01/09,-166,0,0,-166,2056,400,21,2477,1.81%,2.22%,
106/01/06,-633,0,0,-633,2222,400,21,2643,1.96%,2.37%,
106/01/05,-105,0,0,-105,2855,400,21,3276,2.52%,2.93%,
106/01/04,-83,0,0,-83,2960,400,21,3381,2.61%,3.02%,
106/01/03,-80,0,0,-80,3043,400,21,3464,2.68%,3.09%,
105/12/30,-181,0,-4,-185,3123,400,21,3544,2.75%,3.16%,
105/12/29,-151,0,2,-149,3262,400,25,3687,2.87%,3.28%,
105/12/28,-11,0,0,-11,3413,400,23,3836,3.01%,3.42%,
105/12/27,-3,0,0,-3,3424,400,23,3847,3.02%,3.43%,
105/12/26,-13,0,1,-12,3427,400,23,3850,3.02%,3.43%,
105/12/23,-18,0,0,-18,3390,400,22,3812,2.99%,3.40%,
105/12/22,4,0,0,4,3528,400,22,3950,3.11%,3.52%,
105/12/21,18,0,9,27,3524,400,22,3946,3.11%,3.52%,
105/12/20,57,0,2,59,3508,400,13,3921,3.09%,3.49%,
105/12/19,9,0,2,11,3451,400,11,3862,3.04%,3.44%,
105/12/16,44,0,5,49,3442,400,9,3851,3.03%,3.43%,
105/12/15,15,0,2,17,3398,400,4,3802,2.99%,3.38%,
105/12/14,23,0,0,23,3383,400,2,3785,2.98%,3.37%,
105/12/13,-20,0,0,-20,3360,400,2,3762,2.96%,3.35%,
105/12/12,-30,0,0,-30,3380,400,2,3782,2.98%,3.37%,
105/12/09,-28,0,-2,-30,3410,400,2,3812,3.01%,3.40%,
105/12/08,-2,0,0,-2,3438,400,4,3842,3.03%,3.42%,
105/12/07,1,0,-3,-2,3440,400,4,3844,3.03%,3.42%,
105/12/06,-19,0,0,-19,3494,400,7,3901,3.08%,3.47%,
105/12/05,-17,0,-2,-19,3513,400,7,3920,3.10%,3.49%,
105/12/02,-14,0,0,-14,3530,400,9,3939,3.11%,3.51%,
105/12/01,-24,0,-1,-25,3544,400,9,3953,3.12%,3.52%,
105/11/30,-3,0,0,-3,3568,400,10,3978,3.14%,3.54%,
105/11/29,-12,0,0,-12,3571,400,10,3981,3.15%,3.55%,
105/11/28,-97,0,-2,-99,3583,400,10,3993,3.16%,3.56%,
105/11/25,8,0,-1,7,3670,400,12,4082,3.23%,3.63%,
105/11/24,-30,0,-3,-33,3662,400,13,4075,3.23%,3.63%,
105/11/23,-30,0,-2,-32,3692,400,16,4108,3.25%,3.65%,
105/11/22,-4,0,2,-2,3722,400,18,4140,3.28%,3.68%,
105/11/21,-121,0,-2,-123,3726,400,16,4142,3.28%,3.68%,
105/11/18,-6,0,18,12,3847,400,18,4265,3.39%,3.79%,
105/11/17,-9,0,0,-9,3853,400,0,4253,3.40%,3.79%,
105/11/16,-38,0,-3,-41,3862,400,0,4262,3.40%,3.79%,
105/11/15,-58,0,0,-58,3900,400,2,4302,3.44%,3.83%,
105/11/14,-46,0,1,-45,3748,400,2,4150,3.30%,3.69%,
105/11/11,-190,0,1,-189,3804,400,1,4205,3.35%,3.74%,
105/11/10,240,0,0,240,3994,400,0,4394,3.52%,3.91%,
105/11/09,76,0,-27,49,3754,400,0,4154,3.31%,3.70%,
105/11/08,-52,0,-13,-65,3708,400,15,4123,3.27%,3.67%,
105/11/07,-26,0,5,-21,3750,400,28,4178,3.31%,3.72%,
105/11/04,85,0,-4,81,3776,400,23,4199,3.33%,3.74%,
105/11/03,123,0,-8,115,3691,400,27,4118,3.25%,3.66%,
105/11/02,-55,0,4,-51,3568,400,35,4003,3.14%,3.56%,
105/11/01,33,0,0,33,3623,400,31,4054,3.19%,3.61%,
105/10/31,-22,0,-2,-24,3590,400,31,4021,3.16%,3.58%,
105/10/28,-97,0,-2,-99,3612,400,33,4045,3.18%,3.60%,
105/10/27,25,0,0,25,3679,400,35,4114,3.56%,3.98%,
105/10/26,-22,0,0,-22,3654,400,35,4089,3.53%,3.95%,
105/10/25,-62,0,-1,-63,3661,400,35,4096,3.54%,3.96%,
105/10/24,-77,0,0,-77,3723,400,36,4159,3.60%,4.02%,
105/10/21,-143,0,-5,-148,3800,400,36,4236,3.67%,4.09%,
105/10/20,-160,0,-2,-162,3943,400,41,4384,3.81%,4.24%,
105/10/19,-153,0,1,-152,4103,400,43,4546,3.97%,4.40%,
105/10/18,-65,0,0,-65,4256,400,42,4698,4.12%,4.55%,
105/10/17,-109,0,-7,-116,4321,400,42,4763,4.18%,4.61%,
105/10/14,-100,0,2,-98,4430,400,49,4879,4.28%,4.71%,
105/10/13,-369,0,-1,-370,4530,400,47,4977,4.38%,4.81%,
105/10/12,-679,0,-2,-681,4899,400,48,5347,4.74%,5.17%,
105/10/11,292,0,-30,262,5498,400,50,5948,5.32%,5.76%,
105/10/07,3,0,-37,-34,5141,400,80,5621,4.97%,5.43%,
105/10/06,-2018,0,-12,-2030,5168,400,117,5685,5.00%,5.50%,
105/10/05,2487,0,55,2542,7061,400,129,7590,6.83%,7.34%,
105/10/04,-235,0,-45,-280,4564,400,74,5038,4.41%,4.87%,
105/10/03,1485,0,7,1492,4769,400,119,5288,4.61%,5.11%,
105/09/30,392,0,22,414,3284,400,112,3796,3.17%,3.67%,
105/09/29,-95,83,10,-2,2892,401,90,3383,2.79%,3.27%,
105/09/26,128,82,24,234,2987,318,80,3385,2.89%,3.28%,
105/09/23,68,235,-5,298,2859,236,56,3151,2.76%,3.04%,
105/09/22,-4,0,0,-4,2791,1,61,2853,2.70%,2.76%,
105/09/21,-36,0,0,-36,2795,1,61,2857,2.70%,2.76%,
105/09/20,-11,0,9,-2,2831,1,61,2893,2.74%,2.80%,
105/09/19,62,0,12,74,2842,1,52,2895,2.75%,2.80%,
105/09/14,-14,0,0,-14,2780,1,40,2821,2.69%,2.73%,
105/09/13,-20,0,10,-10,2794,1,40,2835,2.70%,2.74%,
105/09/12,-181,0,-19,-200,2814,1,30,2845,2.72%,2.75%,
105/09/10,0,0,-12,-12,2995,1,49,3045,2.89%,2.94%,
105/09/09,-154,0,-1,-155,2995,1,61,3057,2.89%,2.95%,
105/09/08,-170,0,0,-170,3049,1,62,3112,2.95%,3.01%,
105/09/07,-13,0,-3,-16,3189,1,62,3252,3.08%,3.14%,
105/09/06,-5,0,22,17,3202,1,65,3268,3.09%,3.15%,
105/09/05,47,0,1,48,3207,1,43,3251,3.10%,3.14%,
105/09/02,-260,0,-1,-261,3160,1,42,3203,3.05%,3.09%,
105/09/01,16,0,13,29,3381,1,43,3425,3.27%,3.31%,
105/08/31,-56,0,-47,-103,3365,1,30,3396,3.25%,3.28%,
105/08/30,-145,0,8,-137,3421,1,77,3499,3.31%,3.39%,
105/08/29,-38,0,-55,-93,3566,1,69,3636,3.45%,3.52%,
105/08/26,-180,0,0,-180,3604,1,124,3729,3.48%,3.60%,
105/08/25,75,0,119,194,3784,1,124,3909,3.66%,3.78%,
105/08/24,-55,0,-2,-57,3699,1,5,3705,3.58%,3.59%,
105/08/23,-106,0,-14,-120,3791,1,7,3799,3.67%,3.68%,
105/08/22,-113,0,-5,-118,3812,1,21,3834,3.69%,3.71%,
105/08/19,11,-99,2,-86,3880,1,26,3907,3.75%,3.78%,
105/08/18,-31,-101,-3,-135,3897,100,24,4021,3.77%,3.89%,
105/08/17,12,0,-82,-70,3928,201,27,4156,3.80%,4.02%,
105/08/16,-132,0,1,-131,3916,201,109,4226,3.79%,4.09%,
105/08/15,36,0,47,83,4048,201,108,4357,3.91%,4.21%,
105/08/12,99,0,0,99,4012,201,61,4274,3.88%,4.13%,
105/08/11,-126,0,-6,-132,3913,201,61,4175,3.78%,4.03%,
105/08/10,-1,0,0,-1,4039,201,67,4307,3.91%,4.17%,
105/08/09,-104,0,-23,-127,4040,201,67,4308,3.91%,4.17%,
105/08/08,136,0,3,139,4144,201,90,4435,4.01%,4.29%,
105/08/05,107,0,-7,100,4008,201,87,4296,3.88%,4.16%,
105/08/04,12,0,22,34,3901,201,94,4196,3.77%,4.06%,
105/08/03,-5,0,0,-5,3879,201,72,4152,3.75%,4.01%,
105/08/02,17,0,2,19,3884,201,72,4157,3.76%,4.02%,
105/08/01,61,0,0,61,3867,201,70,4138,3.74%,4.00%,
105/07/29,9,0,-5,4,3806,201,70,4077,3.68%,3.94%,
105/07/28,320,0,-5,315,3780,201,75,4056,3.65%,3.92%,
105/07/27,204,0,-1,203,3460,201,80,3741,3.34%,3.61%,
105/07/26,245,0,0,245,3256,201,81,3538,3.15%,3.42%,
105/07/25,-1,0,2,1,3011,201,81,3293,2.91%,3.18%,
105/07/22,112,0,0,112,3012,201,79,3292,2.91%,3.18%,
105/07/21,-14,0,5,-9,2900,201,79,3180,2.80%,3.07%,
105/07/20,63,0,5,68,2904,201,74,3179,2.81%,3.08%,
105/07/19,10,0,-39,-29,2841,201,69,3111,2.75%,3.01%,
105/07/18,-61,0,58,-3,2831,201,108,3140,2.74%,3.04%,
105/07/15,4,100,0,104,2892,201,50,3143,2.79%,3.03%,
105/07/14,36,0,5,41,2888,101,50,3039,2.79%,2.94%,
105/07/13,-11,0,0,-11,2852,101,45,2998,2.76%,2.90%,
105/07/12,-60,0,-5,-65,2885,101,45,3031,2.79%,2.93%,
105/07/11,8,0,5,13,3026,101,50,3177,2.92%,3.07%,
105/07/07,-25,0,10,-15,3018,101,45,3164,2.92%,3.06%,
105/07/06,-29,0,0,-29,3043,101,35,3179,2.94%,3.07%,
105/07/05,-16,0,6,-10,3073,101,35,3209,2.97%,3.10%,
105/07/04,-7,0,2,-5,3103,101,29,3233,3.00%,3.13%,
105/07/01,20,0,0,20,3110,101,27,3238,3.01%,3.13%,
105/06/30,-18,0,-2,-20,3094,101,27,3222,2.99%,3.11%,
105/06/29,-88,0,0,-88,3112,101,29,3242,3.01%,3.14%,
105/06/28,-9,0,0,-9,3210,101,29,3340,3.10%,3.23%,
105/06/27,180,0,-4,176,3209,101,29,3339,3.10%,3.23%,
105/06/24,43,0,-10,33,3029,101,33,3163,2.93%,3.06%,
105/06/23,-10,0,-43,-53,2986,101,43,3130,2.89%,3.03%,
105/06/22,-7,0,-24,-31,2986,101,86,3173,2.89%,3.07%,
105/06/21,-37,0,0,-37,2993,101,110,3204,2.89%,3.09%,
105/06/20,10,0,7,17,3029,101,110,3240,2.93%,3.13%,
105/06/17,-15,0,1,-14,3019,101,103,3223,2.92%,3.12%,
105/06/16,67,0,-9,58,3034,101,102,3237,2.93%,3.13%,
105/06/15,-118,0,-5,-123,2967,101,111,3179,2.87%,3.08%,
105/06/14,26,0,-39,-13,3085,101,116,3302,2.98%,3.19%,
105/06/13,-43,0,-19,-62,3059,101,155,3315,2.96%,3.21%,
105/06/08,-67,0,-1,-68,3103,101,174,3378,3.00%,3.27%,
105/06/07,27,0,11,38,3170,101,175,3446,3.06%,3.33%,
105/06/06,-63,0,20,-43,3152,101,164,3417,3.05%,3.31%,
105/06/04,0,50,-3,47,3227,101,144,3472,3.12%,3.36%,
105/06/03,12,50,-3,59,3227,51,147,3425,3.12%,3.31%,
105/06/02,-46,0,20,-26,3215,1,150,3366,3.11%,3.26%,
105/06/01,-49,0,35,-14,3281,1,130,3412,3.17%,3.30%,
105/05/31,-91,0,-1,-92,3330,1,95,3426,3.22%,3.31%,
105/05/30,-528,0,50,-478,3420,1,96,3517,3.31%,3.40%,
105/05/27,62,0,5,67,3948,1,46,3995,3.82%,3.87%,
105/05/26,-15,0,0,-15,3886,1,41,3928,3.76%,3.80%,
105/05/25,-74,0,0,-74,3901,1,41,3943,3.77%,3.81%,
105/05/24,-135,0,0,-135,3975,1,41,4017,3.84%,3.88%,
105/05/23,46,0,12,58,4110,1,41,4152,3.97%,4.01%,
105/05/20,29,0,0,29,4054,1,29,4084,3.92%,3.95%,
105/05/19,-95,0,-1,-96,4025,1,29,4055,3.89%,3.92%,
105/05/18,15,0,6,21,4120,1,30,4151,3.98%,4.01%,
105/05/17,-78,0,5,-73,4105,1,24,4130,3.97%,3.99%,
105/05/16,265,0,2,267,4183,1,19,4203,4.04%,4.06%,
105/05/13,247,0,0,247,3918,1,17,3936,3.79%,3.81%,
105/05/12,52,0,-7,45,3671,1,17,3689,3.55%,3.57%,
105/05/11,278,0,-7,271,3619,1,24,3644,3.50%,3.52%,
105/05/10,45,0,0,45,3341,1,31,3373,3.23%,3.26%,
105/05/09,38,0,-3,35,3296,1,31,3328,3.19%,3.22%,
105/05/06,-92,0,0,-92,3258,1,34,3293,3.15%,3.18%,
105/05/05,-124,0,-3,-127,3350,1,34,3385,3.24%,3.27%,
105/05/04,50,0,10,60,3452,1,37,3490,3.34%,3.38%,
105/05/03,105,0,0,105,3402,1,27,3430,3.29%,3.32%,
105/04/29,-128,0,0,-128,3297,1,27,3325,3.19%,3.22%,
105/04/28,-126,0,5,-121,3425,1,27,3453,3.31%,3.34%,
105/04/27,-90,0,1,-89,3551,1,22,3574,3.43%,3.45%,
105/04/26,-39,0,-8,-47,3631,1,21,3653,3.51%,3.53%,
105/04/25,161,0,1,162,3660,1,29,3690,3.54%,3.57%,
105/04/22,226,0,-15,211,3499,1,28,3528,3.38%,3.41%,
105/04/21,168,0,-25,143,3214,1,43,3258,3.11%,3.15%,
105/04/20,-11,-250,5,-256,3046,1,68,3115,2.94%,3.01%,
105/04/19,130,0,1,131,3057,251,63,3371,2.95%,3.25%,
105/04/18,-78,0,-1,-79,2927,251,62,3240,2.83%,3.13%,
105/04/15,129,0,0,129,3005,251,63,3319,2.90%,3.20%,
105/04/14,-75,0,4,-71,2876,251,63,3190,2.78%,3.08%,
105/04/13,17,0,0,17,2951,251,59,3261,2.85%,3.15%,
105/04/12,73,0,-4,69,2914,251,59,3224,2.82%,3.12%,
105/04/11,-96,0,0,-96,2830,251,63,3144,2.73%,3.03%,
105/04/08,-265,0,-1,-266,2926,251,63,3240,2.83%,3.13%,
105/04/07,95,0,1,96,3181,251,64,3496,3.07%,3.37%,
105/04/06,93,0,0,93,3086,251,63,3400,2.98%,3.28%,
105/04/01,-118,0,0,-118,2993,251,63,3307,2.89%,3.19%,
105/03/31,-126,0,0,-126,3111,251,63,3425,3.01%,3.31%,
105/03/30,274,0,0,274,3237,250,63,3550,3.13%,3.43%,
105/03/29,554,0,0,554,2963,250,63,3276,2.86%,3.16%,
105/03/28,19,-110,-30,-121,2411,250,63,2724,2.33%,2.63%,
105/03/25,353,0,0,353,2392,360,93,2845,2.31%,2.75%,
105/03/24,-79,0,54,-25,2039,360,93,2492,1.97%,2.41%,
105/03/23,582,250,25,857,2118,360,39,2517,2.05%,2.44%,
105/03/22,79,20,-10,89,1536,110,14,1660,1.48%,1.60%,
105/03/21,177,0,15,192,1457,90,24,1571,1.41%,1.52%,
105/03/18,374,0,-3,371,1317,90,9,1416,1.27%,1.37%,
105/03/17,2,0,5,7,967,90,12,1069,0.93%,1.03%,
105/03/16,206,0,0,206,965,90,7,1062,0.93%,1.02%,
105/03/15,-32,90,0,58,749,90,7,846,0.72%,0.81%,
105/03/14,-137,0,5,-132,781,0,7,788,0.75%,0.76%,
105/03/11,-22,0,-16,-38,908,0,2,910,0.87%,0.87%,
105/03/10,45,0,0,45,891,0,18,909,0.86%,0.88%,
105/03/09,-80,0,-1,-81,846,0,18,864,0.81%,0.83%,
105/03/08,45,0,-3,42,942,0,19,961,0.91%,0.93%,
105/03/07,-310,0,1,-309,897,0,22,919,0.86%,0.88%,
105/03/04,230,0,-7,223,1207,0,21,1228,1.16%,1.18%,
105/03/03,-1,0,-1,-2,987,0,28,1015,0.95%,0.98%,
105/03/02,-16,0,0,-16,988,0,29,1017,0.95%,0.98%,
105/03/01,77,0,0,77,1004,0,29,1033,0.97%,1.00%,
105/02/26,56,0,0,56,927,0,29,956,0.89%,0.92%,
105/02/25,30,0,0,30,871,0,29,900,0.84%,0.87%,
105/02/24,12,0,-1,11,841,0,29,870,0.81%,0.84%,
105/02/23,39,0,-3,36,829,0,30,859,0.80%,0.83%,
105/02/22,11,0,0,11,795,0,33,828,0.76%,0.79%,
105/02/19,4,0,0,4,784,0,33,817,0.75%,0.78%,
105/02/18,70,0,0,70,780,0,33,813,0.75%,0.78%,
105/02/17,7,-98,8,-83,710,0,33,743,0.68%,0.71%,
105/02/16,-16,-250,1,-265,703,22,25,750,0.68%,0.73%,
105/02/15,-24,-254,5,-273,719,272,24,1015,0.69%,0.98%,
105/02/03,77,-245,0,-168,743,526,19,1288,0.71%,1.24%,
105/02/02,32,-230,15,-183,656,771,19,1446,0.63%,1.39%,
105/02/01,52,0,0,52,636,1001,4,1641,0.61%,1.58%,
105/01/30,2,0,-16,-14,567,1001,4,1572,0.54%,1.51%,
105/01/29,-18,0,0,-18,565,1001,20,1586,0.54%,1.53%,
105/01/28,87,0,0,87,583,1001,20,1604,0.56%,1.55%,
105/01/27,37,0,0,37,496,1001,20,1517,0.48%,1.47%,
105/01/26,5,0,15,20,459,1001,20,1480,0.44%,1.43%,
105/01/25,46,0,0,46,454,1001,5,1460,0.43%,1.40%,
105/01/22,10,0,-7,3,408,1001,5,1414,0.39%,1.36%,
105/01/21,24,0,1,25,398,1001,12,1411,0.38%,1.36%,
105/01/20,-35,0,-4,-39,374,1001,11,1386,0.36%,1.34%,
105/01/19,1,0,-4,-3,409,1001,15,1425,0.39%,1.37%,
105/01/18,6,0,4,10,408,1001,19,1428,0.39%,1.38%,
105/01/15,-7,0,-1,-8,402,1001,15,1418,0.38%,1.36%,
105/01/14,-36,0,4,-32,409,1001,16,1426,0.39%,1.37%,
105/01/13,8,0,0,8,445,1001,12,1458,0.43%,1.41%,
105/01/12,-11,0,-1,-12,437,1001,12,1450,0.42%,1.40%,
105/01/11,-7,0,-2,-9,448,1001,13,1462,0.43%,1.41%,
105/01/08,9,0,3,12,455,1001,15,1471,0.44%,1.42%,
105/01/07,-36,0,-2,-38,446,1001,12,1459,0.43%,1.41%,
105/01/06,-5,0,-10,-15,482,1001,14,1497,0.46%,1.44%,
105/01/05,-21,0,4,-17,487,1001,24,1512,0.47%,1.46%,
105/01/04,-5,0,-3,-8,508,1001,20,1529,0.49%,1.48%,
104/12/31,-5,0,0,-5,513,1001,23,1537,0.49%,1.48%,
104/12/30,2,0,0,2,518,1001,23,1542,0.50%,1.49%,
104/12/29,-4,0,0,-4,516,1001,23,1540,0.49%,1.48%,
104/12/28,-1,0,0,-1,520,1001,23,1544,0.50%,1.49%,
104/12/25,4,0,1,5,521,1001,23,1545,0.50%,1.49%,
104/12/24,-6,0,1,-5,517,1001,22,1540,0.50%,1.49%,
104/12/23,-3,0,-1,-4,523,1001,21,1545,0.50%,1.49%,
104/12/22,3,0,0,3,542,1001,22,1565,0.52%,1.51%,
104/12/21,3,0,4,7,539,1001,22,1562,0.52%,1.51%,
104/12/18,13,0,3,16,536,1001,18,1555,0.51%,1.50%,
104/12/17,26,0,5,31,531,1001,15,1547,0.51%,1.49%,
104/12/16,-18,0,1,-17,505,1001,10,1516,0.48%,1.46%,
104/12/15,10,0,1,11,523,1001,9,1533,0.50%,1.48%,
104/12/14,29,0,-1,28,513,1001,8,1522,0.49%,1.47%,
104/12/11,-9,0,-2,-11,484,1001,9,1494,0.46%,1.44%,
104/12/10,4,0,1,5,493,1001,11,1505,0.47%,1.45%,
104/12/09,-35,0,-6,-41,489,1001,10,1500,0.47%,1.45%,
104/12/08,-3,0,0,-3,524,1001,16,1541,0.50%,1.48%,
104/12/07,21,0,0,21,527,1001,16,1544,0.51%,1.49%,
104/12/04,13,0,0,13,506,1001,16,1523,0.48%,1.46%,
104/12/03,25,0,0,25,493,1001,16,1510,0.47%,1.45%,
104/12/02,22,0,2,24,468,1001,16,1485,0.45%,1.43%,
104/12/01,7,0,0,7,446,1001,14,1461,0.43%,1.41%,
104/11/30,-4,0,0,-4,439,1001,14,1454,0.42%,1.40%,
104/11/27,-2,0,0,-2,443,1001,14,1458,0.42%,1.40%,
104/11/26,-3,0,0,-3,445,1001,14,1460,0.43%,1.41%,
104/11/25,-10,0,0,-10,448,1001,14,1463,0.43%,1.41%,
104/11/24,-16,0,0,-16,458,1001,14,1473,0.44%,1.42%,
104/11/23,8,0,0,8,474,1001,14,1489,0.45%,1.43%,
104/11/20,-10,0,0,-10,466,1001,14,1481,0.45%,1.43%,
104/11/19,23,0,0,23,476,1001,14,1491,0.46%,1.44%,
104/11/18,-1,0,0,-1,453,1001,14,1468,0.43%,1.41%,
104/11/17,36,0,0,36,454,1001,14,1469,0.43%,1.41%,
104/11/16,4,0,0,4,418,1001,14,1433,0.40%,1.38%,
104/11/13,39,0,0,39,414,1001,14,1429,0.40%,1.38%,
104/11/12,-10,0,0,-10,375,1001,14,1390,0.36%,1.34%,
104/11/11,-21,0,0,-21,385,1001,14,1400,0.37%,1.35%,
104/11/10,-8,0,0,-8,406,1001,14,1421,0.39%,1.37%,
104/11/09,-29,0,0,-29,414,1001,14,1429,0.40%,1.38%,
104/11/06,-26,0,0,-26,443,1001,14,1458,0.42%,1.40%,
104/11/05,1,0,0,1,469,1001,14,1484,0.45%,1.43%,
104/11/04,26,0,0,26,468,1001,14,1483,0.45%,1.43%,
104/11/03,0,0,0,0,442,1001,14,1457,0.42%,1.40%,
104/11/02,6,0,0,6,442,1001,14,1457,0.42%,1.40%,
104/10/30,-12,0,0,-12,436,1001,14,1451,0.42%,1.40%,
104/10/29,-7,0,0,-7,448,1001,14,1463,0.43%,1.41%,
104/10/28,2,0,0,2,455,1001,14,1470,0.44%,1.42%,
104/10/27,9,0,0,9,453,1001,14,1468,0.43%,1.41%,
104/10/26,10,0,0,10,444,1001,14,1459,0.42%,1.40%,
104/10/23,2,0,0,2,434,1001,14,1449,0.42%,1.40%,
104/10/22,-4,0,0,-4,432,1001,14,1447,0.41%,1.39%,
104/10/21,-5,0,1,-4,436,1001,14,1451,0.42%,1.40%,
104/10/20,14,0,0,14,441,1001,13,1455,0.42%,1.40%,
104/10/19,16,0,0,16,427,1001,13,1441,0.41%,1.39%,
104/10/16,7,0,0,7,411,1001,13,1425,0.39%,1.37%,
104/10/15,48,0,0,48,404,1001,13,1418,0.39%,1.37%,
104/10/14,6,0,0,6,356,1001,13,1370,0.34%,1.32%,
104/10/13,-17,0,0,-17,350,1001,13,1364,0.33%,1.31%,
104/10/12,-26,0,0,-26,367,1001,13,1381,0.35%,1.33%,
104/10/08,-52,0,0,-52,393,1001,13,1407,0.38%,1.36%,
104/10/07,2,0,0,2,445,1001,13,1459,0.43%,1.41%,
104/10/06,5,0,0,5,443,1001,13,1457,0.42%,1.40%,
104/10/05,-3,0,0,-3,438,1001,13,1452,0.42%,1.40%,
104/10/02,10,0,0,10,441,1001,13,1455,0.42%,1.40%,
104/10/01,25,0,0,25,431,1001,13,1445,0.41%,1.39%,
104/09/30,5,0,0,5,406,1001,13,1420,0.39%,1.37%,
104/09/25,13,0,0,13,401,1001,13,1415,0.38%,1.36%,
104/09/24,-29,0,0,-29,388,1001,13,1402,0.37%,1.35%,
104/09/23,-13,0,0,-13,417,1001,13,1431,0.40%,1.38%,
104/09/22,27,0,0,27,430,1001,13,1444,0.41%,1.39%,
104/09/21,-3,0,-1,-4,403,1001,13,1417,0.38%,1.36%,
104/09/18,5,0,0,5,406,1001,14,1421,0.39%,1.37%,
104/09/17,-14,0,0,-14,401,1001,14,1416,0.38%,1.36%,
104/09/16,-13,0,1,-12,415,1001,14,1430,0.40%,1.38%,
104/09/15,-12,0,0,-12,398,1001,13,1412,0.38%,1.36%,
104/09/14,-22,0,-1,-23,410,1001,13,1424,0.39%,1.37%,
104/09/11,-27,0,-2,-29,432,1001,14,1447,0.41%,1.39%,
104/09/10,51,0,0,51,459,1001,16,1476,0.44%,1.42%,
104/09/09,26,0,0,26,408,1001,16,1425,0.39%,1.37%,
104/09/08,8,0,0,8,382,1001,16,1399,0.36%,1.34%,
104/09/07,5,0,0,5,374,1001,16,1391,0.36%,1.34%,
104/09/04,5,0,0,5,369,1001,16,1386,0.35%,1.33%,
104/09/03,27,0,0,27,364,1001,16,1381,0.35%,1.33%,
104/09/02,-2,0,0,-2,337,1001,16,1354,0.32%,1.30%,
104/09/01,24,0,0,24,339,1001,16,1356,0.32%,1.30%,
104/08/31,25,0,0,25,315,1001,16,1332,0.30%,1.28%,
104/08/28,-7,0,-2,-9,290,1001,16,1307,0.28%,1.26%,
104/08/27,-5,0,-2,-7,297,1001,18,1316,0.28%,1.27%,
104/08/26,-17,0,-3,-20,302,1001,20,1323,0.29%,1.28%,
104/08/25,-15,0,0,-15,319,1001,23,1343,0.30%,1.29%,
104/08/24,-53,0,0,-53,334,1001,23,1358,0.32%,1.31%,
104/08/21,-31,0,0,-31,387,1001,23,1411,0.37%,1.36%,
104/08/20,15,0,-1,14,418,1001,23,1442,0.40%,1.39%,
104/08/19,-20,0,-1,-21,403,1001,24,1428,0.38%,1.37%,
104/08/18,0,0,0,0,423,1001,25,1449,0.40%,1.39%,
104/08/17,-1,0,0,-1,411,1001,25,1437,0.39%,1.38%,
104/08/14,8,0,-2,6,412,1001,25,1438,0.39%,1.38%,
104/08/13,3,0,-7,-4,390,1001,27,1418,0.37%,1.37%,
104/08/12,-7,0,9,2,387,1001,34,1422,0.37%,1.37%,
104/08/11,-4,0,-8,-12,394,1001,25,1420,0.38%,1.37%,
104/08/10,27,0,0,27,398,1001,33,1432,0.38%,1.38%,
104/08/07,6,0,0,6,371,1001,33,1405,0.35%,1.35%,
104/08/06,-14,0,-1,-15,365,1001,33,1399,0.35%,1.35%,
104/08/05,23,0,0,23,379,1001,34,1414,0.36%,1.36%,
104/08/04,-7,0,5,-2,356,1001,34,1391,0.34%,1.34%,
104/08/03,2,0,0,2,363,1001,29,1393,0.35%,1.35%,
104/07/31,0,0,-3,-3,361,1001,29,1391,0.34%,1.34%,
104/07/30,19,0,1,20,361,1001,32,1394,0.34%,1.34%,
104/07/29,6,0,-1,5,342,1001,31,1374,0.33%,1.33%,
104/07/28,25,0,2,27,336,1001,32,1369,0.32%,1.32%,
104/07/27,4,0,7,11,311,1001,30,1342,0.30%,1.30%,
104/07/24,0,0,-1,-1,307,1001,23,1331,0.29%,1.28%,
104/07/23,4,0,2,6,307,1001,24,1332,0.29%,1.28%,
104/07/22,-4,0,1,-3,303,1001,22,1326,0.29%,1.28%,
104/07/21,-3,0,0,-3,307,1001,21,1329,0.29%,1.28%,
104/07/20,-1,0,0,-1,310,1001,21,1332,0.29%,1.28%,
104/07/17,-23,0,0,-23,311,1001,21,1333,0.30%,1.29%,
104/07/16,-3,0,0,-3,334,1001,21,1356,0.32%,1.31%,
104/07/15,-1,0,-2,-3,337,1001,21,1359,0.32%,1.31%,
104/07/14,-7,0,0,-7,338,1001,23,1362,0.32%,1.31%,
104/07/13,2,0,-3,-1,345,1001,23,1369,0.33%,1.32%,
104/07/09,5,0,2,7,343,1001,26,1370,0.33%,1.32%,
104/07/08,8,0,3,11,338,1001,24,1363,0.32%,1.31%,
104/07/07,-5,0,0,-5,330,1001,21,1352,0.31%,1.30%,
104/07/06,-5,0,0,-5,335,1001,21,1357,0.32%,1.31%,
104/07/03,-6,0,0,-6,340,1001,21,1362,0.32%,1.31%,
104/07/02,1,0,0,1,346,1001,21,1368,0.33%,1.32%,
104/07/01,1,0,0,1,345,1001,21,1367,0.33%,1.32%,
104/06/30,7,0,-1,6,344,1001,21,1366,0.33%,1.32%,
104/06/29,-5,0,-2,-7,337,1001,22,1360,0.32%,1.31%,
104/06/26,-8,0,0,-8,342,1001,24,1367,0.33%,1.32%,
104/06/25,21,0,0,21,350,1001,24,1375,0.33%,1.32%,
104/06/24,-5,0,3,-2,329,1001,24,1354,0.31%,1.30%,
104/06/23,-1,0,5,4,334,1001,21,1356,0.32%,1.31%,
104/06/22,-37,0,0,-37,335,1001,16,1352,0.32%,1.30%,
104/06/18,-33,0,0,-33,372,1001,16,1389,0.35%,1.33%,
104/06/17,23,0,-2,21,405,1001,16,1422,0.39%,1.37%,
104/06/16,-43,0,2,-41,382,1001,18,1401,0.36%,1.35%,
104/06/15,-22,-98,0,-120,425,1001,16,1442,0.41%,1.39%,
104/06/12,-3,-96,0,-99,447,1099,16,1562,0.43%,1.51%,
104/06/11,-7,-94,0,-101,450,1195,16,1661,0.43%,1.60%,
104/06/10,-23,0,-1,-24,457,1289,16,1762,0.44%,1.70%,
104/06/09,-24,-82,1,-105,480,1289,17,1786,0.46%,1.72%,
104/06/08,1,-90,0,-89,504,1371,16,1891,0.48%,1.82%,
104/06/05,-50,-80,0,-130,503,1461,16,1980,0.48%,1.91%,
104/06/04,-39,-79,3,-115,553,1541,16,2110,0.53%,2.04%,
104/06/03,-8,-75,-1,-84,592,1620,13,2225,0.57%,2.15%,
104/06/02,27,-72,0,-45,600,1695,14,2309,0.58%,2.23%,
104/06/01,21,-70,0,-49,573,1767,14,2354,0.55%,2.27%,
104/05/29,31,0,0,31,552,1837,14,2403,0.53%,2.32%,
104/05/28,6,0,-4,2,521,1837,14,2372,0.50%,2.29%,
104/05/27,2,0,0,2,515,1837,18,2370,0.49%,2.29%,
104/05/26,-1,0,0,-1,513,1837,18,2368,0.49%,2.29%,
104/05/25,-7,0,0,-7,514,1837,18,2369,0.49%,2.29%,
104/05/22,-8,0,1,-7,521,1837,18,2376,0.50%,2.30%,
104/05/21,-15,0,0,-15,529,1837,17,2383,0.51%,2.31%,
104/05/20,-19,0,-1,-20,544,1837,17,2398,0.52%,2.32%,
104/05/19,-1,0,-1,-2,564,1837,18,2419,0.54%,2.34%,
104/05/18,-2,0,0,-2,565,1837,19,2421,0.54%,2.34%,
104/05/15,-9,0,-1,-10,567,1837,19,2423,0.54%,2.34%,
104/05/14,-1,0,-1,-2,576,1837,20,2433,0.55%,2.35%,
104/05/13,-2,0,0,-2,577,1837,21,2435,0.55%,2.35%,
104/05/12,-5,0,0,-5,579,1837,21,2437,0.56%,2.36%,
104/05/11,-14,0,-1,-15,584,1837,21,2442,0.56%,2.36%,
104/05/08,-9,0,0,-9,598,1837,22,2457,0.57%,2.37%,
104/05/07,-8,0,0,-8,607,1837,22,2466,0.58%,2.38%,
104/05/06,29,0,1,30,615,1837,22,2474,0.59%,2.39%,
104/05/05,-6,0,-3,-9,586,1837,21,2444,0.56%,2.36%,
104/05/04,-32,0,0,-32,592,1837,24,2453,0.57%,2.37%,
104/04/30,10,0,1,11,624,1837,24,2485,0.60%,2.40%,
104/04/29,30,0,2,32,614,1837,23,2474,0.59%,2.39%,
104/04/28,15,0,0,15,584,1837,21,2442,0.56%,2.36%,
104/04/27,22,0,1,23,569,1837,21,2427,0.55%,2.35%,
104/04/24,9,0,4,13,547,1837,20,2404,0.52%,2.32%,
104/04/23,-3,0,-2,-5,538,1837,16,2391,0.52%,2.31%,
104/04/22,-5,0,3,-2,541,1837,18,2396,0.52%,2.32%,
104/04/21,-27,0,0,-27,546,1837,15,2398,0.52%,2.31%,
104/04/20,-5,0,1,-4,573,1837,15,2425,0.55%,2.34%,
104/04/17,-8,0,5,-3,590,1837,14,2441,0.57%,2.36%,
104/04/16,-10,0,-6,-16,598,1837,9,2444,0.57%,2.36%,
104/04/15,-7,0,0,-7,608,1837,15,2460,0.58%,2.37%,
104/04/14,10,0,0,10,615,1837,15,2467,0.59%,2.38%,
104/04/13,0,0,-2,-2,605,1837,15,2457,0.58%,2.37%,
104/04/10,-29,0,0,-29,605,1837,17,2459,0.58%,2.38%,
104/04/09,0,0,0,0,634,1837,17,2488,0.61%,2.41%,
104/04/08,0,0,0,0,634,1837,17,2488,0.61%,2.41%,
104/04/07,17,0,0,17,634,1837,17,2488,0.61%,2.41%,
104/04/02,-5,-137,0,-142,617,1837,17,2471,0.59%,2.39%,
104/04/01,-10,0,-4,-14,622,1974,17,2613,0.60%,2.53%,
104/03/31,-5,-5,0,-10,632,1974,21,2627,0.61%,2.54%,
104/03/30,-41,-24,0,-65,637,2073,21,2731,0.61%,2.64%,
104/03/27,-11,-117,0,-128,678,2097,21,2796,0.65%,2.70%,
104/03/26,3,0,2,5,689,2214,21,2924,0.66%,2.82%,
104/03/25,-6,0,2,-4,686,2214,19,2919,0.66%,2.82%,
104/03/24,-1,0,0,-1,692,2214,17,2923,0.67%,2.83%,
104/03/23,-1,-25,-1,-27,693,2214,17,2924,0.67%,2.83%,
104/03/20,40,0,0,40,694,2239,18,2951,0.67%,2.86%,
104/03/19,3,0,1,4,668,2239,18,2925,0.64%,2.83%,
104/03/18,29,-94,0,-65,665,2239,17,2921,0.64%,2.82%,
104/03/17,5,-45,0,-40,640,2333,17,2990,0.61%,2.89%,
104/03/16,7,-100,7,-86,641,2378,17,3036,0.62%,2.94%,
104/03/13,18,-231,0,-213,634,2478,10,3122,0.61%,3.02%,
104/03/12,7,0,0,7,616,2709,10,3335,0.59%,3.22%,
104/03/11,-36,0,0,-36,609,2709,10,3328,0.58%,3.21%,
104/03/10,4,0,0,4,645,2709,10,3364,0.62%,3.25%,
104/03/09,11,0,-2,9,641,2709,10,3360,0.62%,3.25%,
104/03/06,3,0,-2,1,630,2709,12,3351,0.60%,3.23%,
104/03/05,-23,0,0,-23,627,2709,14,3350,0.60%,3.24%,
104/03/04,25,0,-5,20,650,2709,14,3373,0.62%,3.26%,
104/03/03,-1,0,0,-1,625,2709,19,3353,0.60%,3.24%,
104/03/02,2,0,-1,1,626,2709,19,3354,0.60%,3.24%,
104/02/26,-4,0,0,-4,624,2709,20,3353,0.60%,3.24%,
104/02/25,8,0,0,8,628,2709,20,3357,0.60%,3.24%,
104/02/24,3,0,-2,1,620,2709,20,3349,0.59%,3.23%,
104/02/13,2,0,0,2,617,2709,22,3348,0.59%,3.23%,
104/02/12,-2,0,0,-2,615,2709,22,3346,0.59%,3.23%,
104/02/11,2,0,0,2,617,2709,22,3348,0.59%,3.23%,
104/02/10,-21,0,4,-17,615,2709,22,3346,0.59%,3.23%,
104/02/09,-3,0,-3,-6,636,2709,18,3363,0.61%,3.25%,
104/02/06,-3,0,0,-3,639,2709,21,3369,0.61%,3.25%,
104/02/05,3,0,0,3,642,2709,21,3372,0.62%,3.26%,
104/02/04,2,0,0,2,639,2709,21,3369,0.61%,3.25%,
104/02/03,2,0,0,2,637,2709,21,3367,0.61%,3.25%,
104/02/02,-3,0,0,-3,635,2709,21,3365,0.61%,3.25%,
104/01/30,2,0,8,10,638,2709,21,3368,0.61%,3.25%,
104/01/29,1,0,1,2,636,2709,13,3358,0.61%,3.25%,
104/01/28,5,0,-2,3,635,2709,12,3356,0.61%,3.24%,
104/01/27,-3,0,0,-3,630,2709,14,3353,0.60%,3.24%,
104/01/26,-11,0,0,-11,705,2709,14,3428,0.68%,3.32%,
104/01/23,27,0,0,27,716,2709,14,3439,0.69%,3.33%,
104/01/22,11,0,0,11,689,2709,14,3412,0.66%,3.30%,
104/01/21,3,0,0,3,678,2709,14,3401,0.65%,3.29%,
104/01/20,14,0,0,14,675,2709,14,3398,0.65%,3.29%,
104/01/19,-2,0,0,-2,661,2709,14,3384,0.63%,3.27%,
104/01/16,-12,0,-1,-13,663,2709,14,3386,0.64%,3.28%,
104/01/15,-5,0,0,-5,675,2709,15,3399,0.65%,3.29%,
104/01/14,4,0,0,4,680,2709,15,3404,0.65%,3.29%,
104/01/13,2,0,0,2,676,2709,15,3400,0.65%,3.29%,
104/01/12,1,0,0,1,674,2709,15,3398,0.65%,3.29%,
104/01/09,26,0,1,27,620,2709,15,3344,0.59%,3.23%,
104/01/08,4,0,0,4,594,2709,14,3317,0.57%,3.21%,
104/01/07,-1,0,0,-1,590,2709,14,3313,0.57%,3.21%,
104/01/06,-4,0,0,-4,591,2709,14,3314,0.57%,3.21%,
104/01/05,-4,0,-1,-5,595,2709,14,3318,0.57%,3.21%,
