日期,外資買賣超,投信買賣超,自營商買賣超,單日合計買賣超,外資估計持股,投信估計持股,自營商估計持股,單日合計估計持股,外資持股比重,三大法人持股比重,
107/03/31,0,0,-302,-302,123493,1310,8028,132831,29.66%,31.81%,
107/03/30,-407,39,111,-257,123493,1310,8330,133133,29.66%,31.88%,
107/03/29,-1922,0,-70,-1992,123900,1271,8219,133390,29.75%,31.94%,
107/03/28,237,0,-191,46,125820,1271,8289,135380,30.21%,32.41%,
107/03/27,-22,-4,294,268,125583,1271,8480,135334,30.16%,32.41%,
107/03/26,-338,0,58,-280,125605,1275,8186,135066,30.16%,32.34%,
107/03/23,118,0,-437,-319,125943,1275,8128,135346,30.24%,32.41%,
107/03/22,-2316,0,-371,-2687,125825,1275,8565,135665,30.22%,32.49%,
107/03/21,-292,0,348,56,128141,1275,8936,138352,30.77%,33.12%,
107/03/20,-751,-3,-95,-849,128433,1275,8588,138296,30.84%,33.11%,
107/03/19,-351,-2,162,-191,129163,1278,8683,139124,31.02%,33.31%,
107/03/16,-422,-372,-56,-850,129514,1280,8521,139315,31.10%,33.36%,
107/03/15,-174,2,23,-149,129937,1652,8577,140166,31.20%,33.56%,
107/03/14,650,0,18,668,130111,1650,8554,140315,31.24%,33.59%,
107/03/13,372,-2,19,389,129417,1650,8536,139603,31.08%,33.43%,
107/03/12,124,0,-137,-13,129171,1652,8517,139340,31.02%,33.36%,
107/03/09,-498,0,61,-437,129147,1652,8654,139453,31.01%,33.38%,
107/03/08,-283,0,110,-173,129621,1652,8593,139866,31.13%,33.49%,
107/03/07,812,0,131,943,129904,1652,8483,140039,31.19%,33.52%,
107/03/06,118,0,-45,73,128844,1652,8352,138848,30.94%,33.24%,
107/03/05,-347,15,-64,-396,128725,1652,8397,138774,30.91%,33.22%,
107/03/02,-598,2,-169,-765,129064,1637,8461,139162,30.99%,33.32%,
107/03/01,-692,0,-78,-770,129659,1635,8630,139924,31.14%,33.50%,
107/02/27,-186,0,-143,-329,130331,1635,8708,140674,31.30%,33.68%,
107/02/26,-1054,0,-331,-1385,130537,1635,8851,141023,31.35%,33.77%,
107/02/23,796,0,594,1390,131433,1635,9182,142250,31.56%,34.05%,
107/02/22,-83,-3,-9,-95,130636,1635,8588,140859,31.37%,33.72%,
107/02/21,937,0,-66,871,130720,1638,8597,140955,31.39%,33.75%,
107/02/12,-710,0,-92,-802,129773,1638,8663,140074,31.16%,33.53%,
107/02/09,-175,1,-347,-521,130483,1638,8755,140876,31.33%,33.72%,
107/02/08,2609,0,105,2714,130658,1637,9102,141397,31.38%,33.85%,
107/02/07,-267,347,-218,-138,128209,1637,8997,138843,30.79%,33.24%,
107/02/06,-1387,85,-918,-2220,128476,1290,9215,138981,30.85%,33.27%,
107/02/05,-2150,0,-1053,-3203,129837,1205,10133,141175,31.18%,33.79%,
107/02/02,1220,0,1373,2593,131973,1205,11186,144364,31.69%,34.54%,
107/02/01,788,0,-47,741,130749,1205,9813,141767,31.40%,33.94%,
107/01/31,-57,-42,-67,-166,129961,1205,9860,141026,31.21%,33.76%,
107/01/30,696,0,236,932,130018,1247,9927,141192,31.22%,33.79%,
107/01/29,416,0,243,659,129322,1247,9691,140260,31.06%,33.58%,
107/01/26,-147,-10,30,-127,128892,1247,9448,139587,30.95%,33.41%,
107/01/25,292,0,74,366,129039,1257,9418,139714,30.99%,33.45%,
107/01/24,-21,-8,-82,-111,128742,1257,9344,139343,30.92%,33.36%,
107/01/23,-1171,0,-106,-1277,128763,1265,9426,139454,30.92%,33.38%,
107/01/22,2222,0,552,2774,129933,1265,9532,140730,31.20%,33.69%,
107/01/19,340,0,-155,185,127711,1265,8980,137956,30.67%,33.03%,
107/01/18,49,0,-37,12,127291,1265,9135,137691,30.57%,32.97%,
107/01/17,-7,0,-44,-51,127223,1265,9172,137660,30.55%,32.95%,
107/01/16,-12,-9,183,162,127230,1265,9216,137711,30.55%,32.96%,
107/01/15,669,0,318,987,127232,1274,9033,137539,30.55%,32.92%,
107/01/12,69,0,33,102,126563,1274,8715,136552,30.39%,32.69%,
107/01/11,-421,0,-904,-1325,126494,1274,8682,136450,30.38%,32.67%,
107/01/10,-1482,-8,60,-1430,126915,1274,9586,137775,30.48%,32.98%,
107/01/09,85,0,40,125,128382,1282,9526,139190,30.83%,33.32%,
107/01/08,-1799,0,-348,-2147,128297,1282,9486,139065,30.81%,33.29%,
107/01/05,-1080,-8,617,-471,130079,1282,9834,141195,31.24%,33.80%,
107/01/04,29,-70,-117,-158,131159,1290,9217,141666,31.50%,33.92%,
107/01/03,-89,0,30,-59,131404,1360,9334,142098,31.56%,34.02%,
107/01/02,-850,0,-295,-1145,131493,1360,9304,142157,31.58%,34.04%,
106/12/29,-515,0,-6,-521,132343,1360,9599,143302,31.78%,34.30%,
106/12/28,-207,-1,46,-162,132858,1432,9605,143895,31.90%,34.44%,
106/12/27,90,-3,-33,54,133065,1433,9559,144057,31.95%,34.48%,
106/12/26,167,-0,-694,-527,132975,1436,9592,144003,31.93%,34.47%,
106/12/25,21,0,-284,-263,132808,1436,10286,144530,31.89%,34.59%,
106/12/22,-142,0,-146,-288,132787,1436,10570,144793,31.89%,34.66%,
106/12/21,-52,0,-114,-166,132929,1436,10716,145081,31.92%,34.72%,
106/12/20,346,0,-433,-87,132981,1436,10830,145247,31.93%,34.76%,
106/12/19,-1395,0,-1,-1396,132635,1436,11263,145334,31.85%,34.78%,
106/12/18,213,0,237,450,134005,1436,11264,146705,32.18%,35.11%,
106/12/15,233,0,-140,93,133771,1436,11027,146234,32.12%,34.99%,
106/12/14,-81,0,-98,-179,133538,1436,11167,146141,32.07%,34.97%,
106/12/13,-246,0,-558,-804,133619,1436,11265,146320,32.09%,35.02%,
106/12/12,-265,0,250,-15,133865,1436,11823,147124,32.15%,35.20%,
106/12/11,584,0,346,930,134130,1436,11573,147139,32.21%,35.21%,
106/12/08,-178,0,-430,-608,133543,1436,11227,146206,32.07%,34.99%,
106/12/07,-773,0,94,-679,133732,1436,11657,146825,32.11%,35.13%,
106/12/06,1447,0,-260,1187,134089,1436,11563,147088,32.20%,35.19%,
106/12/05,531,-49,-336,146,132642,1436,11823,145901,31.85%,34.90%,
106/12/04,713,0,-811,-98,132111,1485,12159,145755,31.72%,34.86%,
106/12/01,63,0,-514,-451,131408,1485,12970,145863,31.56%,34.89%,
106/11/30,665,0,-112,553,131435,1485,13484,146404,31.56%,35.01%,
106/11/29,1625,0,762,2387,131118,1485,13596,146199,31.49%,34.96%,
106/11/28,2468,0,-496,1972,129493,1485,12834,143812,31.10%,34.40%,
106/11/27,-391,0,14,-377,127025,1485,13330,141840,30.50%,33.91%,
106/11/24,1177,0,-141,1036,127056,1485,13316,141857,30.51%,33.92%,
106/11/23,473,0,-51,422,125879,1485,13457,140821,30.23%,33.67%,
106/11/22,3433,0,403,3836,125406,1485,13508,140399,30.11%,33.56%,
106/11/21,1531,0,-292,1239,121972,1485,13105,136562,29.29%,32.65%,
106/11/20,882,0,-968,-86,120442,1485,13397,135324,28.92%,32.35%,
106/11/17,-334,0,-944,-1278,119560,1485,14365,135410,28.71%,32.36%,
106/11/16,1845,80,3181,5106,119894,1485,15309,136688,28.79%,32.66%,
106/11/15,605,0,-304,301,118049,1405,12128,131582,28.35%,31.47%,
106/11/14,2870,0,-126,2744,117444,1405,12432,131281,28.20%,31.39%,
106/11/13,878,0,161,1039,114574,1405,12558,128537,27.51%,30.73%,
106/11/10,1782,0,-29,1753,113696,1405,12397,127498,27.30%,30.48%,
106/11/09,540,0,-1039,-499,111914,1405,12426,125745,26.87%,30.06%,
106/11/08,2450,0,410,2860,111374,1405,13465,126244,26.74%,30.17%,
106/11/07,-701,0,36,-665,108924,1405,13055,123384,26.16%,29.49%,
106/11/06,2271,0,261,2532,109626,1405,13019,124050,26.32%,29.64%,
106/11/03,-2701,250,-2431,-4882,107355,1405,12758,121518,25.78%,29.04%,
106/11/02,8502,0,3688,12190,110049,1155,15189,126393,26.43%,30.19%,
106/11/01,3069,0,-1150,1919,101614,1155,11501,114270,24.40%,27.32%,
106/10/31,1934,0,2171,4105,98546,1155,12651,112352,23.66%,26.84%,
106/10/30,778,0,-552,226,96570,1155,10480,108205,23.19%,25.87%,
106/10/27,700,0,-309,391,95787,1155,11032,107974,23.00%,25.81%,
106/10/26,-944,0,-773,-1717,95062,1155,11341,107558,22.83%,25.71%,
106/10/25,308,0,704,1012,95961,1155,12114,109230,23.04%,26.10%,
106/10/24,629,0,507,1136,95671,1155,11410,108236,22.97%,25.86%,
106/10/23,-70,67,747,744,95042,1155,10903,107100,22.82%,25.60%,
106/10/20,268,0,-195,73,95119,1088,10156,106363,22.84%,25.43%,
106/10/19,390,-3,53,440,94852,1088,10351,106291,22.78%,25.42%,
106/10/18,681,0,-558,123,94462,1091,10298,105851,22.68%,25.30%,
106/10/17,-1154,0,-384,-1538,93780,1091,10856,105727,22.52%,25.27%,
106/10/16,150,0,647,797,94934,1091,11240,107265,22.80%,25.64%,
106/10/13,876,122,133,1131,94784,1091,10593,106468,22.76%,25.45%,
106/10/12,-407,0,411,4,93908,969,10460,105337,22.55%,25.18%,
106/10/11,577,0,-340,237,94314,969,10049,105332,22.65%,25.19%,
106/10/06,-119,0,-462,-581,93737,969,10389,105095,22.51%,25.13%,
106/10/05,178,0,289,467,93856,969,10851,105676,22.54%,25.26%,
106/10/03,339,0,254,593,93655,969,10562,105186,22.49%,25.15%,
106/10/02,48,0,193,241,93316,969,10308,104593,22.41%,25.01%,
106/09/30,-33,0,68,35,92268,969,10115,103352,22.16%,24.71%,
106/09/29,214,0,-109,105,92301,728,10047,103076,22.16%,24.64%,
106/09/28,-61,0,-293,-354,92077,728,10156,102961,22.11%,24.62%,
106/09/27,-32,0,305,273,92138,728,10449,103315,22.12%,24.69%,
106/09/26,-378,0,-490,-868,92170,728,10144,103042,22.13%,24.63%,
106/09/25,-46,70,13,37,92548,728,10634,103910,22.22%,24.84%,
106/09/22,256,0,-359,-103,92594,658,10621,103873,22.23%,24.83%,
106/09/21,-11,0,132,121,92338,658,10980,103976,22.17%,24.85%,
106/09/20,-62,0,-56,-118,92349,658,10848,103855,22.18%,24.83%,
106/09/19,223,0,-843,-620,92411,658,10904,103973,22.19%,24.85%,
106/09/18,-87,0,-591,-678,92188,658,11747,104593,22.14%,25.00%,
106/09/15,-293,0,1358,1065,92275,658,12338,105271,22.16%,25.15%,
106/09/14,-182,0,-15,-197,92568,658,10980,104206,22.23%,24.91%,
106/09/13,193,0,-299,-106,92750,658,10995,104403,22.27%,24.95%,
106/09/12,-46,0,590,544,92557,658,11294,104509,22.22%,24.97%,
106/09/11,-186,128,-125,-183,92603,658,10704,103965,22.24%,24.86%,
106/09/08,-71,-3,-613,-687,92788,530,10829,104147,22.28%,24.90%,
106/09/07,-325,0,-116,-441,92824,533,11442,104799,22.29%,25.05%,
106/09/06,-121,0,-1129,-1250,93139,533,11558,105230,22.36%,25.15%,
106/09/05,-1130,0,1860,730,93243,533,12687,106463,22.39%,25.44%,
106/09/04,-293,0,433,140,94373,533,10827,105733,22.66%,25.28%,
106/09/01,77,0,-317,-240,94666,533,10394,105593,22.73%,25.25%,
106/08/31,-992,0,247,-745,94589,533,10711,105833,22.71%,25.30%,
106/08/30,-3,0,345,342,95583,533,10464,106580,22.95%,25.48%,
106/08/29,-263,0,-354,-617,95569,533,10119,106221,22.95%,25.40%,
106/08/28,-181,0,76,-105,95832,533,10473,106838,23.01%,25.55%,
106/08/25,-158,0,118,-40,96013,533,10397,106943,23.06%,25.58%,
106/08/24,-64,6,-448,-506,96171,533,10279,106983,23.09%,25.58%,
106/08/23,-383,5,-852,-1230,96235,527,10727,107489,23.11%,25.70%,
106/08/22,-807,0,1215,408,96608,522,11579,108709,23.20%,25.99%,
106/08/21,-284,0,-85,-369,97415,522,10364,108301,23.39%,25.90%,
106/08/18,-320,0,-356,-676,97699,522,10449,108670,23.46%,25.99%,
106/08/17,-52,0,627,575,98019,522,10805,109346,23.54%,26.15%,
106/08/16,-138,0,-1,-139,98071,522,10178,108771,23.55%,26.01%,
106/08/15,12,0,9,21,98209,522,10179,108910,23.58%,26.05%,
106/08/14,50,0,-254,-204,98234,522,10170,108926,23.59%,26.05%,
106/08/11,612,0,-14,598,98184,522,10424,109130,23.58%,26.10%,
106/08/10,-776,-25,-1369,-2170,97572,522,10438,108532,23.43%,25.95%,
106/08/09,-512,0,-15,-527,98348,547,11807,110702,23.62%,26.47%,
106/08/08,-328,0,-409,-737,98860,547,11822,111229,23.74%,26.59%,
106/08/07,-710,0,-624,-1334,99188,547,12231,111966,23.82%,26.76%,
106/08/04,167,0,-25,142,99898,547,12855,113300,23.99%,27.08%,
106/08/03,-1534,0,-1213,-2747,99731,547,12880,113158,23.95%,27.04%,
106/08/02,420,-70,739,1089,101264,547,14093,115904,24.32%,27.69%,
106/08/01,104,-2,1864,1966,101043,617,13354,115014,24.26%,27.48%,
106/07/31,236,0,53,289,100939,619,11490,113048,24.24%,27.03%,
106/07/28,914,0,-713,201,100703,619,11437,112759,24.18%,26.96%,
106/07/27,-429,0,-507,-936,100390,619,12150,113159,24.11%,27.05%,
106/07/26,1996,70,-147,1919,100859,619,12657,114135,24.22%,27.28%,
106/07/25,1625,25,938,2588,98813,549,12804,112166,23.73%,26.81%,
106/07/24,1695,-90,-606,999,97188,524,11866,109578,23.34%,26.19%,
106/07/21,2695,0,1060,3755,95503,614,12472,108589,22.93%,25.94%,
106/07/20,1072,0,153,1225,92854,614,11412,104880,22.30%,25.07%,
106/07/19,1247,0,-850,397,91782,614,11259,103655,22.04%,24.77%,
106/07/18,1346,0,731,2077,90535,614,12109,103258,21.74%,24.67%,
106/07/17,86,-0,-315,-229,89189,614,11378,101181,21.42%,24.18%,
106/07/14,1190,0,449,1639,89804,614,11693,102111,21.56%,24.39%,
106/07/13,805,0,-178,627,88624,614,11244,100482,21.28%,24.01%,
106/07/12,97,0,234,331,87899,614,11422,99935,21.11%,23.88%,
106/07/11,1139,0,543,1682,87801,614,11188,99603,21.08%,23.80%,
106/07/10,81,0,20,101,86662,614,10645,97921,20.81%,23.40%,
106/07/07,494,0,-15,479,86581,614,10625,97820,20.79%,23.38%,
106/07/06,258,0,-210,48,86087,614,10640,97341,20.67%,23.26%,
106/07/05,178,0,-437,-259,85819,614,10850,97283,20.61%,23.25%,
106/07/04,426,0,47,473,85641,614,11287,97542,20.56%,23.30%,
106/07/03,-2,600,284,882,85216,614,11240,97070,20.46%,23.19%,
106/06/30,-179,4,-675,-850,85218,14,10956,96188,20.46%,22.99%,
106/06/29,-740,0,880,140,85317,457,11631,97405,20.49%,23.27%,
106/06/28,116,450,-91,475,86057,457,10751,97265,20.66%,23.24%,
106/06/27,1583,0,129,1712,85941,7,10842,96790,20.64%,23.14%,
106/06/26,778,0,157,935,84358,7,10713,95078,20.26%,22.73%,
106/06/23,-398,0,20,-378,83629,7,10556,94192,20.08%,22.51%,
106/06/22,19,0,-25,-6,84027,7,10536,94570,20.18%,22.61%,
106/06/21,590,0,-205,385,84008,7,10561,94576,20.17%,22.60%,
106/06/20,27,0,3,30,83418,7,10766,94191,20.03%,22.51%,
106/06/19,501,0,-45,456,83566,7,10763,94336,20.07%,22.55%,
106/06/16,-330,0,107,-223,83065,7,10808,93880,19.95%,22.44%,
106/06/15,633,0,18,651,83395,7,10701,94103,20.02%,22.49%,
106/06/14,471,0,-315,156,82762,7,10683,93452,19.87%,22.33%,
106/06/13,793,0,-42,751,82300,7,10998,93305,19.76%,22.30%,
106/06/12,-1169,0,-275,-1444,81507,7,11040,92554,19.57%,22.11%,
106/06/09,449,0,-266,183,82676,7,11315,93998,19.85%,22.46%,
106/06/08,1294,0,207,1501,82227,7,11581,93815,19.74%,22.41%,
106/06/07,793,0,-1499,-706,80933,7,11374,92314,19.43%,22.05%,
106/06/06,-534,-1,283,-252,80158,7,12873,93038,19.25%,22.22%,
106/06/05,239,0,-1871,-1632,80692,8,12590,93290,19.38%,22.28%,
106/06/03,200,0,3334,3534,80453,8,14461,94922,19.32%,22.65%,
106/06/02,1524,0,10,1534,80253,8,11127,91388,19.27%,21.83%,
106/06/01,257,0,-490,-233,78729,8,11117,89854,18.90%,21.46%,
106/05/31,531,0,133,664,78472,8,11607,90087,18.84%,21.52%,
106/05/26,399,0,-170,229,77941,8,11474,89423,18.71%,21.35%,
106/05/25,244,0,47,291,77542,8,11644,89194,18.62%,21.30%,
106/05/24,789,0,-177,612,77298,8,11597,88903,18.56%,21.23%,
106/05/23,1374,0,250,1624,76509,8,11774,88291,18.37%,21.08%,
106/05/22,202,0,-245,-43,75135,8,11524,86667,18.04%,20.70%,
106/05/19,519,0,450,969,74933,8,11769,86710,17.99%,20.70%,
106/05/18,199,0,-147,52,74414,8,11319,85741,17.87%,20.48%,
106/05/17,770,0,-1075,-305,74215,8,11466,85689,17.82%,20.46%,
106/05/16,2417,0,1399,3816,73435,8,12541,85984,17.63%,20.52%,
106/05/15,1267,0,445,1712,71406,8,11142,82556,17.14%,19.71%,
106/05/12,356,0,-70,286,70439,8,10697,81144,16.91%,19.38%,
106/05/11,442,0,-187,255,70206,8,10767,80981,16.86%,19.34%,
106/05/10,2558,0,-192,2366,69764,8,10954,80726,16.75%,19.28%,
106/05/09,873,0,339,1212,67206,8,11146,78360,16.14%,18.71%,
106/05/08,1116,0,-51,1065,66717,8,10807,77532,16.02%,18.51%,
106/05/05,560,0,-535,25,65630,8,10858,76496,15.76%,18.26%,
106/05/04,2220,0,364,2584,65052,8,11393,76453,14.98%,17.61%,
106/05/03,961,0,-182,779,62890,8,11029,73927,14.48%,17.02%,
106/05/02,258,0,-958,-700,62593,8,11211,73812,14.41%,16.99%,
106/04/28,5862,0,1847,7709,62395,8,12169,74572,14.37%,17.18%,
106/04/27,3018,0,-286,2732,56536,8,10322,66866,13.02%,15.40%,
106/04/26,5778,0,818,6596,53518,8,10608,64134,12.32%,14.77%,
106/04/25,31,-0,145,176,47718,8,9790,57516,10.99%,13.25%,
106/04/24,-53,0,42,-11,48237,8,9645,57890,11.11%,13.33%,
106/04/21,155,0,-131,24,47831,8,9603,57442,11.01%,13.22%,
106/04/20,425,0,85,510,47876,8,9734,57618,11.02%,13.26%,
106/04/19,-227,0,-400,-627,47193,8,9649,56850,10.87%,13.09%,
106/04/18,210,0,-254,-44,47037,8,10049,57094,10.83%,13.15%,
106/04/17,-99,0,-320,-419,46743,8,10303,57054,10.76%,13.14%,
106/04/14,280,-2,-617,-339,46990,8,10623,57621,10.82%,13.27%,
106/04/13,106,0,-1280,-1174,46692,10,11240,57942,10.75%,13.34%,
106/04/12,1171,0,1176,2347,46392,10,12520,58922,10.68%,13.57%,
106/04/11,1457,0,-1577,-120,45310,10,11344,56664,10.43%,13.05%,
106/04/10,796,0,3112,3908,43819,10,12921,56750,10.09%,13.07%,
106/04/07,713,0,-85,628,43212,10,9809,53031,9.95%,12.21%,
106/04/06,112,0,37,149,42618,10,9894,52522,9.81%,12.09%,
106/04/05,1343,0,-61,1282,42536,10,9857,52403,9.79%,12.06%,
106/03/31,-123,0,-35,-158,41193,10,9918,51121,9.48%,11.77%,
106/03/30,513,0,487,1000,41505,63,9953,51521,9.56%,11.87%,
106/03/29,1221,0,-95,1126,40992,63,9466,50521,9.44%,11.64%,
106/03/28,238,0,-128,110,40498,63,9561,50122,9.32%,11.54%,
106/03/27,395,0,-121,274,40669,63,9689,50421,9.36%,11.61%,
106/03/24,149,0,-192,-43,40274,63,9810,50147,9.27%,11.54%,
106/03/23,120,0,-497,-377,40160,63,10002,50225,9.25%,11.57%,
106/03/22,690,0,827,1517,40597,63,10499,51159,9.35%,11.78%,
106/03/21,732,27,51,810,39814,63,9672,49549,9.17%,11.41%,
106/03/20,435,26,52,513,39582,36,9621,49239,9.11%,11.33%,
106/03/17,304,0,-9,295,39451,10,9569,49030,9.08%,11.29%,
106/03/16,390,0,-310,80,39447,10,9578,49035,9.08%,11.29%,
106/03/15,622,0,349,971,39057,10,9888,48955,8.99%,11.27%,
106/03/14,411,0,236,647,38435,10,9539,47984,8.85%,11.05%,
106/03/13,26,0,-1,25,38324,10,9303,47637,8.82%,10.97%,
106/03/10,396,0,-26,370,38297,10,9304,47611,8.82%,10.97%,
106/03/09,681,0,-621,60,38094,10,9330,47434,8.77%,10.92%,
106/03/08,470,0,-378,92,37413,10,9951,47374,8.61%,10.90%,
106/03/07,862,0,-133,729,36943,10,10329,47282,8.51%,10.89%,
106/03/06,361,0,1141,1502,36611,10,10462,47083,8.43%,10.84%,
106/03/03,545,0,-256,289,35480,10,9321,44811,8.17%,10.32%,
106/03/02,2136,0,-945,1191,35256,10,9577,44843,8.12%,10.33%,
106/03/01,1146,0,1138,2284,33420,10,10522,43952,7.69%,10.12%,
106/02/24,1367,0,9,1376,32787,10,9384,42181,7.55%,9.71%,
106/02/23,686,0,-613,73,31508,10,9375,40893,7.25%,9.41%,
106/02/22,577,0,376,953,30832,10,9988,40830,7.10%,9.40%,
106/02/21,465,0,-259,206,30255,10,9612,39877,6.96%,9.18%,
106/02/20,529,0,-59,470,29790,10,9871,39671,6.86%,9.14%,
106/02/18,-10,0,718,708,29511,10,9930,39451,6.79%,9.08%,
106/02/17,765,0,106,871,29769,10,9212,38991,6.85%,8.97%,
106/02/16,7,0,-238,-231,29004,10,9106,38120,6.68%,8.78%,
106/02/15,401,0,656,1057,28947,10,9344,38301,6.66%,8.81%,
106/02/14,496,0,-125,371,28472,10,8688,37170,6.55%,8.55%,
106/02/13,310,0,112,422,28962,10,8813,37785,6.67%,8.70%,
106/02/10,226,0,-333,-107,28391,10,8701,37102,6.54%,8.55%,
106/02/09,995,0,-10,985,29124,10,9034,38168,6.70%,8.78%,
106/02/08,-57,0,-623,-680,28129,10,9044,37183,6.47%,8.56%,
106/02/07,951,0,1302,2253,28555,10,9667,38232,6.57%,8.80%,
106/02/06,314,0,-50,264,27604,10,8365,35979,6.35%,8.28%,
106/02/03,165,0,36,201,27303,10,8415,35728,6.28%,8.22%,
106/02/02,527,0,103,630,27138,10,8379,35527,6.25%,8.18%,
106/01/24,261,0,-30,231,26611,10,8276,34897,6.13%,8.04%,
106/01/23,180,-1,-2,177,26525,10,8306,34841,6.11%,8.03%,
106/01/20,54,0,-62,-8,26345,11,8308,34664,6.06%,7.98%,
106/01/19,291,0,-11,280,26291,11,8370,34672,6.05%,7.98%,
106/01/18,158,0,-36,122,26000,11,8381,34392,5.98%,7.91%,
106/01/17,95,0,-17,78,25842,11,8417,34270,5.95%,7.89%,
106/01/16,-37,0,-60,-97,25747,11,8434,34192,5.93%,7.88%,
106/01/13,88,0,0,88,25974,11,8494,34479,5.98%,7.94%,
106/01/12,191,0,-48,143,25886,11,8494,34391,5.96%,7.92%,
106/01/11,-2,0,-6,-8,25693,11,8542,34246,5.91%,7.88%,
106/01/10,163,0,-103,60,25730,11,8548,34289,5.92%,7.89%,
106/01/09,-32,0,-655,-687,25601,11,8651,34263,5.89%,7.89%,
106/01/06,56,-2,468,522,25624,11,9306,34941,5.90%,8.05%,
106/01/05,-27,0,-39,-66,25763,13,8838,34614,5.93%,7.97%,
106/01/04,-54,0,-132,-186,26480,13,8877,35370,6.09%,8.14%,
106/01/03,-20,0,-194,-214,26769,13,9009,35791,6.16%,8.24%,
105/12/30,427,0,708,1135,26770,13,9203,35986,6.16%,8.28%,
105/12/29,99,0,-6,93,26343,13,8495,34851,6.06%,8.02%,
105/12/28,129,0,-2,127,26167,13,8501,34681,6.02%,7.98%,
105/12/27,33,0,-5,28,25837,13,8503,34353,5.95%,7.91%,
105/12/26,48,0,-34,14,25784,13,8508,34305,5.93%,7.89%,
105/12/23,-2,0,-38,-40,25736,13,8542,34291,5.92%,7.89%,
105/12/22,-393,0,70,-323,25623,13,8580,34216,5.90%,7.88%,
105/12/21,-37,0,168,131,25773,13,8510,34296,5.93%,7.89%,
105/12/20,-123,0,20,-103,25684,13,8342,34039,5.91%,7.83%,
105/12/19,-28,0,6,-22,25707,13,8322,34042,5.92%,7.84%,
105/12/16,66,0,97,163,25713,13,8316,34042,5.92%,7.84%,
105/12/15,-65,0,-22,-87,25486,13,8219,33718,5.87%,7.77%,
105/12/14,-218,0,-58,-276,25444,13,8241,33698,5.86%,7.76%,
105/12/13,56,0,-33,23,25290,13,8299,33602,5.82%,7.73%,
105/12/12,-310,0,-92,-402,25221,13,8332,33566,5.80%,7.72%,
105/12/09,-457,0,-175,-632,25479,13,8424,33916,5.86%,7.80%,
105/12/08,26,0,363,389,25864,13,8599,34476,5.95%,7.93%,
105/12/07,-60,0,-75,-135,25730,13,8236,33979,5.92%,7.82%,
105/12/06,-160,0,42,-118,25666,13,8311,33990,5.91%,7.83%,
105/12/05,-198,0,-28,-226,25377,13,8269,33659,5.84%,7.75%,
105/12/02,-135,0,-50,-185,25525,13,8297,33835,5.87%,7.78%,
105/12/01,-220,0,-46,-266,25661,13,8347,34021,5.91%,7.84%,
105/11/30,108,0,14,122,25799,13,8393,34205,5.94%,7.88%,
105/11/29,-195,0,-32,-227,25664,13,8379,34056,5.91%,7.84%,
105/11/28,-183,0,17,-166,25422,13,8411,33846,5.85%,7.79%,
105/11/25,-211,0,-109,-320,25566,13,8394,33973,5.88%,7.82%,
105/11/24,-443,0,236,-207,25260,13,8503,33776,5.81%,7.77%,
105/11/23,-655,0,5,-650,25677,13,8267,33957,5.91%,7.82%,
105/11/22,-552,0,29,-523,26307,13,8262,34582,6.06%,7.97%,
105/11/21,-505,0,-34,-539,26844,13,8233,35090,6.18%,8.08%,
105/11/18,-721,0,2,-719,26419,13,8267,34699,6.08%,7.99%,
105/11/17,-542,0,-474,-1016,27077,13,8265,35355,6.23%,8.14%,
105/11/16,-261,0,27,-234,26960,13,8739,35712,6.21%,8.23%,
105/11/15,-394,0,44,-350,27189,13,8712,35914,6.26%,8.27%,
105/11/14,-488,0,-11,-499,27552,13,8668,36233,6.34%,8.34%,
105/11/11,-116,0,-45,-161,27342,13,8679,36034,6.29%,8.29%,
105/11/10,-194,-284,-11,-489,27432,13,8724,36169,6.31%,8.32%,
105/11/09,131,0,-148,-17,27587,297,8735,36619,6.35%,8.43%,
105/11/08,-44,0,26,-18,27444,297,8883,36624,6.32%,8.43%,
105/11/07,-317,-284,36,-565,27477,297,8857,36631,6.32%,8.43%,
105/11/04,-65,0,2,-63,27784,581,8821,37186,6.40%,8.57%,
105/11/03,-9,1,-10,-18,27849,581,8819,37249,6.41%,8.58%,
105/11/02,-70,0,-55,-125,27858,580,8829,37267,6.41%,8.58%,
105/11/01,-0,0,-25,-25,28150,580,8884,37614,6.48%,8.66%,
105/10/31,-31,0,-60,-91,27986,580,8909,37475,6.44%,8.63%,
105/10/28,-145,0,-100,-245,28007,580,8969,37556,6.45%,8.65%,
105/10/27,-301,0,172,-129,28141,580,9069,37790,6.48%,8.70%,
105/10/26,74,-100,-27,-53,28530,580,8897,38007,6.57%,8.75%,
105/10/25,-282,-222,-6,-510,28457,680,8924,38061,6.55%,8.76%,
105/10/24,-95,0,-22,-117,28739,902,8930,38571,6.62%,8.88%,
105/10/21,-156,0,-53,-209,28834,902,8952,38688,6.64%,8.91%,
105/10/20,-39,-1,-137,-177,28980,902,9005,38887,6.67%,8.95%,
105/10/19,-334,0,182,-152,29009,903,9142,39054,6.68%,8.99%,
105/10/18,37,0,50,87,29343,903,8960,39206,6.75%,9.02%,
105/10/17,27,0,-72,-45,29306,903,8910,39119,6.75%,9.01%,
105/10/14,-345,0,-88,-433,29279,903,8982,39164,6.74%,9.02%,
105/10/13,-334,0,-153,-487,29658,903,9070,39631,6.83%,9.13%,
105/10/12,-211,0,3,-208,29983,903,9223,40109,6.90%,9.23%,
105/10/11,-327,0,-28,-355,30374,903,9220,40497,6.99%,9.32%,
105/10/07,-550,0,-159,-709,30701,903,9248,40852,7.07%,9.41%,
105/10/06,-239,0,-761,-1000,30807,903,9407,41117,7.09%,9.46%,
105/10/05,-487,0,942,455,31087,903,10168,42158,7.16%,9.71%,
105/10/04,820,0,-24,796,31753,903,9226,41882,7.31%,9.64%,
105/10/03,-344,0,7,-337,30590,903,9250,40743,7.04%,9.38%,
105/09/30,135,-1,-335,-201,30722,903,9243,40868,7.07%,9.41%,
105/09/29,-32,0,-16,-48,30611,906,9578,41095,7.05%,9.47%,
105/09/26,28,0,-26,2,30929,906,9594,41429,7.12%,9.54%,
105/09/23,-36,0,-22,-58,30901,906,9620,41427,7.11%,9.53%,
105/09/22,-65,0,-19,-84,31312,906,9642,41860,7.21%,9.64%,
105/09/21,397,0,-35,362,31437,906,9661,42004,7.24%,9.67%,
105/09/20,-303,0,-343,-646,31048,906,9696,41650,7.15%,9.59%,
105/09/19,-466,0,402,-64,31351,906,10039,42296,7.22%,9.74%,
105/09/14,267,0,-36,231,31957,906,9637,42500,7.36%,9.79%,
105/09/13,-127,0,-259,-386,31159,906,9673,41738,7.17%,9.61%,
105/09/12,-418,0,7,-411,30564,906,9932,41402,7.04%,9.54%,
105/09/10,7,0,-122,-115,30712,906,9925,41543,7.07%,9.56%,
105/09/09,-163,0,-60,-223,30705,906,10047,41658,7.07%,9.59%,
105/09/08,543,0,-1123,-580,30868,906,10107,41881,7.11%,9.65%,
105/09/07,740,0,1049,1789,30768,906,11230,42904,7.08%,9.88%,
105/09/06,338,0,186,524,30789,906,10181,41876,7.09%,9.64%,
105/09/05,1061,0,102,1163,30451,906,9995,41352,7.01%,9.52%,
105/09/02,121,0,-50,71,29887,906,9893,40686,6.88%,9.33%,
105/09/01,-261,214,-110,-157,29766,906,9943,40615,6.85%,9.31%,
105/08/31,390,0,81,471,29977,692,10053,40722,6.90%,9.34%,
105/08/30,-7,0,-47,-54,29808,692,9972,40472,6.86%,9.28%,
105/08/29,-45,0,-132,-177,29814,692,10019,40525,6.86%,9.29%,
105/08/26,522,0,-423,99,29859,692,10151,40702,6.87%,9.33%,
105/08/25,341,0,639,980,29737,692,10574,41003,6.85%,9.40%,
105/08/24,21,0,-284,-263,29605,692,9935,40232,6.81%,9.22%,
105/08/23,291,-2,468,757,29884,692,10219,40795,6.88%,9.35%,
105/08/22,69,0,-108,-39,32543,694,9751,42988,7.49%,9.86%,
105/08/19,1242,0,-84,1158,32474,694,9859,43027,7.48%,9.87%,
105/08/18,120,0,117,237,32052,694,9943,42689,7.38%,9.79%,
105/08/17,855,0,-63,792,32890,694,9826,43410,7.57%,9.95%,
105/08/16,544,0,-530,14,32251,694,9889,42834,7.31%,9.71%,
105/08/15,3242,0,884,4126,32187,694,10419,43300,7.29%,9.81%,
105/08/12,2144,0,-141,2003,29372,694,9535,39601,6.65%,8.97%,
105/08/11,1883,444,-605,1722,27255,694,9676,37625,6.17%,8.52%,
105/08/10,721,0,818,1539,25336,250,10281,35867,5.74%,8.13%,
105/08/09,496,232,16,744,24595,250,9463,34308,5.57%,7.77%,
105/08/08,288,0,147,435,24509,18,9447,33974,5.55%,7.70%,
105/08/05,8,0,-243,-235,24088,18,9300,33406,5.46%,7.57%,
105/08/04,20,-1,5,24,24080,18,9543,33641,5.45%,7.62%,
105/08/03,-337,0,78,-259,23500,19,9538,33057,5.32%,7.49%,
105/08/02,-57,0,107,50,23935,19,9460,33414,5.42%,7.57%,
105/08/01,149,0,56,205,23767,19,9353,33139,5.38%,7.50%,
105/07/29,-156,-1,33,-124,23582,19,9297,32898,5.34%,7.45%,
105/07/28,399,0,438,837,23721,20,9264,33005,5.37%,7.47%,
105/07/27,186,0,-50,136,23229,20,8826,32075,5.26%,7.27%,
105/07/26,-137,0,-16,-153,23437,20,8876,32333,5.31%,7.33%,
105/07/25,-249,0,-42,-291,23549,20,8892,32461,5.33%,7.35%,
105/07/22,272,0,-186,86,23688,20,8934,32642,5.36%,7.39%,
105/07/21,179,0,317,496,23417,20,9120,32557,5.30%,7.37%,
105/07/20,131,0,-96,35,23230,20,8803,32053,5.26%,7.26%,
105/07/19,-88,-1,41,-48,23098,20,8899,32017,5.23%,7.25%,
105/07/18,56,0,-15,41,23483,21,8858,32362,5.32%,7.33%,
105/07/15,-432,0,64,-368,23594,21,8873,32488,5.34%,7.36%,
105/07/14,-156,0,197,41,23978,21,8809,32808,5.43%,7.43%,
105/07/13,20,0,-24,-4,24067,21,8612,32700,5.45%,7.41%,
105/07/12,-270,0,-40,-310,24519,21,8636,33176,5.55%,7.51%,
105/07/11,183,0,-101,82,24889,21,8676,33586,5.64%,7.61%,
105/07/07,113,0,70,183,25360,21,8777,34158,5.74%,7.73%,
105/07/06,48,0,-152,-104,25247,21,8707,33975,5.72%,7.70%,
105/07/05,-35,0,-298,-333,25248,21,8859,34128,5.72%,7.73%,
105/07/04,-86,0,895,809,25394,21,9157,34572,5.75%,7.83%,
105/07/01,169,0,-212,-43,25480,21,8262,33763,5.77%,7.65%,
105/06/30,34,0,286,320,25725,21,8474,34220,5.83%,7.76%,
105/06/29,-442,0,-76,-518,25640,2,8188,33830,5.81%,7.67%,
105/06/28,236,0,71,307,26043,2,8264,34309,5.90%,7.77%,
105/06/27,-185,0,9,-176,25429,2,8193,33624,5.76%,7.62%,
105/06/24,-313,0,5,-308,26076,2,8184,34262,5.91%,7.77%,
105/06/23,1,0,11,12,26168,2,8179,34349,5.93%,7.78%,
105/06/22,-23,0,9,-14,26180,2,8168,34350,5.93%,7.78%,
105/06/21,-176,0,-3,-179,25798,2,8159,33959,5.84%,7.69%,
105/06/20,-342,0,10,-332,25962,2,8162,34126,5.88%,7.73%,
105/06/17,-641,0,1,-640,25980,2,8152,34134,5.88%,7.73%,
105/06/16,-1121,0,-18,-1139,26303,2,8151,34456,5.96%,7.81%,
105/06/15,-630,0,237,-393,26719,2,8169,34890,6.05%,7.90%,
105/06/14,-646,0,292,-354,27453,2,7932,35387,6.22%,8.02%,
105/06/13,-971,0,-123,-1094,27738,2,7640,35380,6.28%,8.01%,
105/06/08,-766,0,-118,-884,28509,2,7763,36274,6.46%,8.22%,
105/06/07,-587,0,274,-313,29809,2,7881,37692,6.75%,8.54%,
105/06/06,-80,0,-97,-177,30371,2,7607,37980,6.88%,8.60%,
105/06/04,0,0,50,50,30413,2,7704,38119,6.89%,8.64%,
105/06/03,-540,0,-13,-553,30413,2,7654,38069,6.89%,8.63%,
105/06/02,-662,0,-142,-804,30388,2,7667,38057,6.88%,8.62%,
105/06/01,-751,0,217,-534,30404,2,7809,38215,6.89%,8.66%,
105/05/31,-751,0,-8,-759,30982,2,7592,38576,7.02%,8.74%,
105/05/30,-904,0,57,-847,30855,2,7600,38457,6.99%,8.71%,
105/05/27,-1581,0,-115,-1696,31759,2,7543,39304,7.19%,8.90%,
105/05/26,91,1,-7,85,32723,2,7658,40383,7.41%,9.15%,
105/05/25,-80,0,-15,-95,32772,1,7665,40438,7.42%,9.16%,
105/05/24,1316,0,236,1552,32842,1,7680,40523,7.44%,9.18%,
105/05/23,331,0,233,564,31526,1,7444,38971,7.14%,8.83%,
105/05/20,-445,0,-128,-573,30917,1,7211,38129,7.00%,8.63%,
105/05/19,92,0,-49,43,31621,1,7339,38961,7.16%,8.82%,
105/05/18,-25,0,318,293,31529,1,7388,38918,7.14%,8.81%,
105/05/17,735,0,133,868,31369,1,7070,38440,7.11%,8.71%,
105/05/16,598,0,80,678,30734,1,6937,37672,6.96%,8.53%,
105/05/13,-1131,0,-211,-1342,30033,1,6857,36891,6.80%,8.35%,
105/05/12,-387,0,123,-264,31504,1,7068,38573,7.14%,8.74%,
105/05/11,-529,0,-77,-606,31881,1,6945,38827,7.22%,8.79%,
105/05/10,-117,1,26,-90,32411,1,7022,39434,7.34%,8.93%,
105/05/09,-292,0,-79,-371,32518,0,6996,39514,7.37%,8.96%,
105/05/06,529,0,-46,483,32810,0,7075,39885,7.43%,9.03%,
105/05/05,1088,0,140,1228,32391,0,7121,39512,7.34%,8.95%,
105/05/04,291,0,46,337,31303,0,6981,38284,7.09%,8.67%,
105/05/03,110,0,0,110,31012,0,6935,37947,7.02%,8.59%,
105/04/29,-79,-163,-21,-263,30902,0,6935,37837,7.00%,8.57%,
105/04/28,-425,-250,-16,-691,30881,0,6956,37837,7.00%,8.58%,
105/04/27,-157,0,24,-133,30326,0,6972,37298,6.87%,8.45%,
105/04/26,-1003,0,67,-936,30328,0,6948,37276,6.87%,8.44%,
105/04/25,781,0,-38,743,31331,0,6881,38212,7.10%,8.66%,
105/04/22,41,-300,-15,-274,30400,0,6919,37319,6.89%,8.46%,
105/04/21,-120,0,144,24,30249,0,6934,37183,6.85%,8.42%,
105/04/20,76,-154,-123,-201,30259,0,6790,37049,6.85%,8.39%,
105/04/19,-626,0,-320,-946,30161,0,6913,37074,6.83%,8.40%,
105/04/18,363,0,71,434,30633,0,7233,37866,6.94%,8.58%,
105/04/15,-1277,-698,-121,-2096,30151,0,7162,37313,6.83%,8.45%,
105/04/14,-551,0,27,-524,31302,164,7283,38749,7.09%,8.78%,
105/04/13,-202,0,29,-173,31819,164,7256,39239,7.21%,8.89%,
105/04/12,-389,0,-75,-464,31987,164,7227,39378,7.25%,8.93%,
105/04/11,841,0,-79,762,32359,164,7302,39825,7.33%,9.02%,
105/04/08,100,0,61,161,31469,164,7381,39014,7.13%,8.84%,
105/04/07,-288,0,-153,-441,31269,164,7320,38753,7.08%,8.78%,
105/04/06,-409,-405,-138,-952,31541,164,7473,39178,7.14%,8.87%,
105/04/01,-178,0,22,-156,31713,569,7611,39893,7.18%,9.03%,
105/03/31,45,0,5,50,31891,569,7589,40049,7.22%,9.07%,
105/03/30,133,0,59,192,31846,1477,7584,40907,7.21%,9.26%,
105/03/29,-229,1,-70,-298,31713,1477,7525,40715,7.18%,9.22%,
105/03/28,213,0,-35,178,32775,1476,7595,41846,7.42%,9.48%,
105/03/25,-605,0,-302,-907,32451,1476,7630,41557,7.35%,9.41%,
105/03/24,87,0,-51,36,33056,1476,7932,42464,7.49%,9.62%,
105/03/23,-121,0,-331,-452,32969,1476,7983,42428,7.47%,9.61%,
105/03/22,35,-49,-214,-228,32640,1476,8314,42430,7.39%,9.61%,
105/03/21,-350,0,327,-23,32020,1525,8528,42073,7.25%,9.53%,
105/03/18,-1300,-603,74,-1829,32370,1525,8201,42096,7.33%,9.53%,
105/03/17,-2813,-140,-296,-3249,33024,2128,8127,43279,7.48%,9.80%,
105/03/16,-2524,-588,-577,-3689,34989,2268,8423,45680,7.93%,10.35%,
105/03/15,-1548,0,114,-1434,37244,2856,9000,49100,8.44%,11.13%,
105/03/14,-316,-65,20,-361,38229,2856,8886,49971,8.66%,11.32%,
105/03/11,-44,0,-19,-63,38490,2921,8866,50277,8.72%,11.39%,
105/03/10,-474,-550,-188,-1212,38548,2921,8885,50354,8.73%,11.41%,
105/03/09,-317,-650,-703,-1670,39011,3471,9073,51555,8.84%,11.68%,
105/03/08,-749,-696,-258,-1703,39326,4121,9776,53223,8.91%,12.06%,
105/03/07,-72,0,-109,-181,40064,4817,10034,54915,9.08%,12.45%,
105/03/04,-492,-2271,-3,-2766,39985,4817,10143,54945,9.06%,12.45%,
105/03/03,-78,0,-53,-131,40858,7088,10146,58092,9.26%,13.17%,
105/03/02,-239,117,325,203,40853,7088,10199,58140,9.26%,13.18%,
105/03/01,701,473,706,1880,41255,6971,9874,58100,9.35%,13.17%,
105/02/26,194,0,-790,-596,40544,6498,9168,56210,9.19%,12.74%,
105/02/25,-38,-50,913,825,40340,6498,9958,56796,9.14%,12.87%,
105/02/24,-43,390,-264,83,40834,6548,9045,56427,9.25%,12.78%,
105/02/23,-1727,0,-151,-1878,40867,6158,9309,56334,9.26%,12.77%,
105/02/22,1315,0,866,2181,42614,6158,9460,58232,9.65%,13.19%,
105/02/19,32,-81,0,-49,41289,6158,8594,56041,9.35%,12.69%,
105/02/18,-550,0,6,-544,41265,6239,8594,56098,9.35%,12.71%,
105/02/17,-193,-344,-13,-550,41815,6239,8588,56642,9.47%,12.83%,
105/02/16,-81,-325,549,143,42008,6583,8601,57192,9.52%,12.96%,
105/02/15,295,-143,0,152,42089,6908,8052,57049,9.54%,12.93%,
105/02/03,-371,0,-35,-406,41794,7051,8052,56897,9.47%,12.89%,
105/02/02,-110,0,-12,-122,42307,7051,8087,57445,9.59%,13.02%,
105/02/01,347,-140,16,223,42407,7051,8099,57557,9.61%,13.04%,
105/01/30,-6,-16,-319,-341,41884,7191,8083,57158,9.49%,12.95%,
105/01/29,-1186,30,161,-995,41890,7207,8402,57499,9.49%,13.03%,
105/01/28,593,0,112,705,42679,7177,8241,58097,9.67%,13.17%,
105/01/27,-299,0,-58,-357,42086,7177,8129,57392,9.54%,13.01%,
105/01/26,-87,44,-139,-182,42685,7177,8187,58049,9.67%,13.15%,
105/01/25,-59,203,331,475,42772,7133,8326,58231,9.69%,13.19%,
105/01/22,-26,0,0,-26,42831,6930,7995,57756,9.70%,13.08%,
105/01/21,266,0,-142,124,42857,6930,7995,57782,9.71%,13.09%,
105/01/20,-865,0,-49,-914,42837,6930,8137,57904,9.71%,13.13%,
105/01/19,-581,-1,7,-575,44152,6930,8186,59268,10.00%,13.43%,
105/01/18,121,43,84,248,44733,6931,8179,59843,10.14%,13.57%,
105/01/15,570,0,-147,423,44612,6888,8095,59595,10.11%,13.51%,
105/01/14,45,0,-19,26,44122,6888,8242,59252,10.00%,13.43%,
105/01/13,524,-210,-18,296,44077,6888,8261,59226,9.99%,13.42%,
105/01/12,688,0,-148,540,43553,7098,8279,58930,9.87%,13.36%,
105/01/11,444,-1375,-12,-943,42865,7098,8427,58390,9.71%,13.23%,
105/01/08,-1267,-1716,-55,-3038,42341,8473,8439,59253,9.59%,13.42%,
105/01/07,1213,65,-286,992,43093,10189,8494,61776,9.76%,14.00%,
105/01/06,299,-107,-622,-430,41880,10124,8780,60784,9.49%,13.78%,
105/01/05,1404,250,-204,1450,41823,10231,9402,61456,9.48%,13.93%,
105/01/04,-1189,0,31,-1158,40374,9981,9606,59961,9.15%,13.59%,
104/12/31,356,-460,103,-1,41739,9981,9575,61295,9.46%,13.89%,
104/12/30,59,0,-215,-156,41083,10462,9472,61017,9.31%,13.83%,
104/12/29,690,88,156,934,41455,10462,9687,61604,9.39%,13.96%,
104/12/28,-361,30,-3,-334,40765,10374,9531,60670,9.24%,13.75%,
104/12/25,1615,-937,-29,649,41126,10344,9534,61004,9.32%,13.83%,
104/12/24,1052,-683,-272,97,39511,11281,9563,60355,8.95%,13.67%,
104/12/23,-128,-443,-160,-731,38316,11964,9835,60115,8.68%,13.62%,
104/12/22,52,360,-20,392,38850,12407,9995,61252,8.80%,13.88%,
104/12/21,-1287,115,12,-1160,38884,12047,10015,60946,8.81%,13.81%,
104/12/18,-300,1633,-424,909,39074,11932,10003,61009,8.85%,13.82%,
104/12/17,1349,989,18,2356,38655,10299,10427,59381,8.76%,13.46%,
104/12/16,-61,199,99,237,37496,9310,10409,57215,8.49%,12.96%,
104/12/15,5027,436,1026,6489,37897,9111,10310,57318,8.59%,12.99%,
104/12/14,13,308,-322,-1,32870,8675,9284,50829,7.45%,11.52%,
104/12/11,-107,1677,688,2258,32630,8367,9606,50603,7.39%,11.46%,
104/12/10,396,258,7,661,33698,6690,8918,49306,7.63%,11.17%,
104/12/09,210,43,-239,14,33827,6432,8911,49170,7.66%,11.14%,
104/12/08,-175,1205,-186,844,33617,6389,9150,49156,7.62%,11.14%,
104/12/07,2186,1944,76,4206,33662,5184,9337,48183,7.63%,10.92%,
104/12/04,-1019,0,-79,-1098,31426,3240,9261,43927,7.12%,9.95%,
104/12/03,-1244,0,-1435,-2679,32336,3240,9340,44916,7.32%,10.17%,
104/12/02,285,259,2708,3252,33565,3240,10775,47580,7.60%,10.78%,
104/12/01,44,0,-108,-64,33267,2981,8067,44315,7.54%,10.04%,
104/11/30,-126,0,-84,-210,33357,2981,8175,44513,7.56%,10.09%,
104/11/27,-233,0,-434,-667,33451,2981,8259,44691,7.58%,10.13%,
104/11/26,435,178,749,1362,33674,2981,8693,45348,7.63%,10.28%,
104/11/25,32,353,-126,259,33239,2803,7944,43986,7.53%,9.97%,
104/11/24,187,0,-38,149,33214,2450,8070,43734,7.52%,9.90%,
104/11/23,-104,0,79,-25,33279,2450,8108,43837,7.54%,9.93%,
104/11/20,219,0,-57,162,33394,2450,8029,43873,7.56%,9.94%,
104/11/19,211,0,-46,165,33325,2450,8086,43861,7.55%,9.94%,
104/11/18,96,0,-288,-192,33146,2450,8132,43728,7.51%,9.91%,
104/11/17,114,0,617,731,32998,2450,8420,43868,7.48%,9.94%,
104/11/16,719,0,-23,696,32697,2450,7803,42950,7.41%,9.73%,
104/11/13,151,0,-68,83,31794,2450,7826,42070,7.20%,9.53%,
104/11/12,-286,0,-94,-380,31463,2450,7894,41807,7.13%,9.47%,
104/11/11,-265,-150,-16,-431,32091,2450,7988,42529,7.27%,9.64%,
104/11/10,141,-100,-36,5,32353,2600,8004,42957,7.33%,9.73%,
104/11/09,13,0,-90,-77,32239,2700,8040,42979,7.30%,9.73%,
104/11/06,-25,0,-267,-292,32189,2700,8130,43019,7.29%,9.74%,
104/11/05,281,0,-451,-170,32537,2700,8397,43634,7.37%,9.89%,
104/11/04,-10,3,467,460,32256,2700,8848,43804,7.31%,9.93%,
104/11/03,1170,0,572,1742,32266,2697,8381,43344,7.31%,9.82%,
104/11/02,201,0,-41,160,31096,2697,7809,41602,7.04%,9.42%,
104/10/30,87,0,-96,-9,30688,2697,7850,41235,6.95%,9.34%,
104/10/29,175,0,-90,85,30635,2697,7946,41278,6.94%,9.35%,
104/10/28,299,0,-86,213,30428,2697,8036,41161,6.89%,9.32%,
104/10/27,180,0,-169,11,30129,2697,8122,40948,6.82%,9.27%,
104/10/26,267,0,-216,51,29949,2697,8291,40937,6.78%,9.27%,
104/10/23,-400,0,-539,-939,29652,2697,8507,40856,6.72%,9.26%,
104/10/22,528,0,1082,1610,30192,2697,9046,41935,6.84%,9.50%,
104/10/21,343,0,319,662,29044,2697,7964,39705,6.58%,9.00%,
104/10/20,465,0,-4,461,28701,2697,7645,39043,6.50%,8.84%,
104/10/19,28,0,-95,-67,28328,2697,7649,38674,6.42%,8.77%,
104/10/16,1020,0,69,1089,28300,2697,7744,38741,6.41%,8.78%,
104/10/15,-38,0,-124,-162,27280,2697,7675,37652,6.18%,8.53%,
104/10/14,-58,0,187,129,27578,2697,7799,38074,6.25%,8.63%,
104/10/13,538,0,8,546,27636,2697,7612,37945,6.26%,8.60%,
104/10/12,643,0,-79,564,27098,2697,7604,37399,6.14%,8.48%,
104/10/08,-255,0,74,-181,26605,2697,7683,36985,6.03%,8.38%,
104/10/07,-475,0,33,-442,26860,2697,7609,37166,6.08%,8.42%,
104/10/06,468,0,-19,449,27453,2697,7576,37726,6.22%,8.55%,
104/10/05,481,135,0,616,26985,2697,7595,37277,6.11%,8.44%,
104/10/02,105,2,-13,94,26564,2562,7595,36721,6.02%,8.32%,
104/10/01,144,0,97,241,26433,2560,7608,36601,5.99%,8.29%,
104/09/30,-104,0,-7,-111,26289,2560,7511,36360,5.95%,8.23%,
104/09/25,-198,0,-25,-223,26411,3062,7518,36991,5.98%,8.38%,
104/09/24,-99,0,-80,-179,26209,3062,7543,36814,5.94%,8.34%,
104/09/23,11,0,-28,-17,26308,3062,7623,36993,5.96%,8.38%,
104/09/22,33,-3,27,57,26247,3062,7651,36960,5.94%,8.37%,
104/09/21,-89,1,-77,-165,26188,3064,7624,36876,5.93%,8.35%,
104/09/18,-571,0,-53,-624,26277,3063,7701,37041,5.95%,8.39%,
104/09/17,299,350,128,777,26848,3063,7754,37665,6.08%,8.53%,
104/09/16,-345,479,2,136,26159,2713,7626,36498,5.92%,8.26%,
104/09/15,-349,0,17,-332,26310,2234,7624,36168,5.96%,8.19%,
104/09/14,149,0,-172,-23,26517,2234,7607,36358,6.01%,8.24%,
104/09/11,-42,640,40,638,26368,2234,7779,36381,5.97%,8.24%,
104/09/10,99,0,-219,-120,26499,1594,7739,35832,6.00%,8.12%,
104/09/09,-91,0,380,289,26438,1594,7958,35990,5.99%,8.16%,
104/09/08,-50,0,7,-43,26529,1594,7578,35701,6.01%,8.09%,
104/09/07,-7,0,-5,-12,26614,1594,7571,35779,6.03%,8.11%,
104/09/04,-416,70,-314,-660,26621,1594,7576,35791,6.03%,8.11%,
104/09/03,371,150,405,926,27110,1524,7890,36524,6.14%,8.27%,
104/09/02,41,0,21,62,26439,1374,7485,35298,5.99%,8.00%,
104/09/01,30,-3,-39,-12,26398,1374,7464,35236,5.98%,7.98%,
104/08/31,-104,-2,4,-102,26404,1377,7503,35284,5.98%,7.99%,
104/08/28,-742,1,-169,-910,29194,1379,7499,38072,6.61%,8.62%,
104/08/27,2391,0,170,2561,30156,1378,7668,39202,6.83%,8.88%,
104/08/26,121,0,37,158,29780,1378,7498,38656,6.75%,8.76%,
104/08/25,194,0,10,204,28999,1378,7461,37838,6.57%,8.57%,
104/08/24,25,0,18,43,28160,1378,7451,36989,6.38%,8.38%,
104/08/21,-516,0,-49,-565,28232,1378,7432,37042,6.39%,8.39%,
104/08/20,-401,0,24,-377,28646,1378,7481,37505,6.49%,8.50%,
104/08/19,-601,0,-2,-603,29093,1378,7457,37928,6.59%,8.59%,
104/08/18,-240,0,-1,-241,28759,1378,7459,37596,6.51%,8.51%,
104/08/17,-179,0,83,-96,28331,1378,7460,37169,6.42%,8.42%,
104/08/14,-68,0,16,-52,27464,1378,7377,36219,6.22%,8.20%,
104/08/13,-282,0,6,-276,27568,1378,7361,36307,6.24%,8.22%,
104/08/12,-15,1,29,15,27841,1378,7355,36574,6.31%,8.29%,
104/08/11,-166,0,-32,-198,28158,1377,7326,36861,6.38%,8.35%,
104/08/10,-327,0,-4,-331,27779,1377,7358,36514,6.29%,8.27%,
104/08/07,-859,0,5,-854,28133,1377,7362,36872,6.37%,8.35%,
104/08/06,-298,0,-23,-321,28477,1377,7357,37211,6.45%,8.43%,
104/08/05,-1588,0,-13,-1601,28001,1377,7380,36758,6.34%,8.33%,
104/08/04,301,0,-10,291,29106,1377,7393,37876,6.59%,8.58%,
104/08/03,401,0,-56,345,28780,1377,7403,37560,6.52%,8.51%,
104/07/31,69,0,-108,-39,28607,1377,7459,37443,6.48%,8.48%,
104/07/30,-30,-117,33,-114,28505,1377,7567,37449,6.46%,8.49%,
104/07/29,-204,0,-15,-219,28610,1494,7534,37638,6.48%,8.53%,
104/07/28,526,-217,37,346,28697,1494,7549,37740,6.50%,8.55%,
104/07/27,383,0,45,428,27877,1711,7512,37100,6.31%,8.40%,
104/07/24,24,1,7,32,27494,1711,7467,36672,6.23%,8.31%,
104/07/23,590,0,-5,585,27941,1710,7460,37111,6.33%,8.41%,
104/07/22,160,-761,12,-589,27440,1710,7465,36615,6.22%,8.30%,
104/07/21,-42,-100,-39,-181,27326,2471,7453,37250,6.19%,8.44%,
104/07/20,86,0,7,93,27368,2571,7492,37431,6.20%,8.48%,
104/07/17,-3,12,1,10,27263,2571,7485,37319,6.18%,8.46%,
104/07/16,80,0,7,87,27335,2559,7484,37378,6.19%,8.47%,
104/07/15,-232,3,-19,-248,27265,2559,7477,37301,6.18%,8.45%,
104/07/14,-270,0,31,-239,27545,2556,7496,37597,6.24%,8.52%,
104/07/13,-104,0,23,-81,28234,2556,7465,38255,6.40%,8.67%,
104/07/09,10,0,32,42,28217,2556,7442,38215,6.39%,8.66%,
104/07/08,-801,0,-33,-834,28207,2556,7410,38173,6.39%,8.65%,
104/07/07,-161,0,-24,-185,29303,2556,7443,39302,6.64%,8.91%,
104/07/06,-77,0,-28,-105,29543,2556,7467,39566,6.69%,8.96%,
104/07/03,-793,0,-18,-811,29672,2556,7495,39723,6.72%,9.00%,
104/07/02,-946,0,-113,-1059,29752,2556,7513,39821,6.74%,9.02%,
104/07/01,-85,205,193,313,30698,2556,7626,40880,6.95%,9.26%,
104/06/30,307,185,74,566,30800,2351,7433,40584,6.98%,9.20%,
104/06/29,-1451,0,-224,-1675,29637,2088,7359,39084,6.71%,8.85%,
104/06/26,58,100,-182,-24,31170,2088,7583,40841,7.06%,9.25%,
104/06/25,-610,0,321,-289,31106,1988,7765,40859,7.05%,9.26%,
104/06/24,75,0,-12,63,31641,1988,7444,41073,7.17%,9.31%,
104/06/23,-1293,0,15,-1278,31550,1988,7456,40994,7.15%,9.29%,
104/06/22,725,-3,43,765,32835,1988,7441,42264,7.44%,9.58%,
104/06/18,340,0,74,414,32773,1991,7398,42162,7.42%,9.55%,
104/06/17,-1041,0,60,-981,34355,1991,7324,43670,7.78%,9.89%,
104/06/16,-374,0,8,-366,35114,1991,7264,44369,7.95%,10.05%,
104/06/15,-402,0,-21,-423,35869,1991,7256,45116,8.13%,10.23%,
104/06/12,-757,0,-31,-788,34685,1991,7277,43953,7.86%,9.96%,
104/06/11,-850,0,9,-841,35483,1991,7308,44782,8.04%,10.15%,
104/06/10,-778,0,57,-721,35872,1991,7299,45162,8.13%,10.24%,
104/06/09,-534,0,-185,-719,36403,1991,7242,45636,8.25%,10.34%,
104/06/08,-1390,0,-5,-1395,36939,1991,7427,46357,8.37%,10.50%,
104/06/05,-777,2,-91,-866,37964,1991,7432,47387,8.60%,10.74%,
104/06/04,-1826,3,-683,-2506,38623,1989,7523,48135,8.75%,10.91%,
104/06/03,-576,360,-732,-948,38454,1986,8206,48646,8.71%,11.02%,
104/06/02,-2244,0,1137,-1107,38799,1626,8938,49363,8.79%,11.18%,
104/06/01,-660,0,6,-654,40612,1626,7801,50039,9.20%,11.34%,
104/05/29,-1550,0,-405,-1955,41128,1626,7795,50549,9.32%,11.46%,
104/05/28,-1300,0,689,-611,42633,1626,8200,52459,9.66%,11.89%,
104/05/27,-1795,0,43,-1752,43509,1626,7511,52646,9.86%,11.93%,
104/05/26,-1778,0,-68,-1846,45188,1626,7468,54282,10.24%,12.30%,
104/05/25,-1057,0,41,-1016,46813,1626,7536,55975,10.61%,12.69%,
104/05/22,-3597,0,-47,-3644,46921,1626,7495,56042,10.63%,12.70%,
104/05/21,-2729,-556,-175,-3460,50173,1626,7542,59341,11.37%,13.45%,
104/05/20,3,-393,348,-42,52892,2182,7717,62791,11.98%,14.22%,
104/05/19,215,-300,-315,-400,52879,2575,7369,62823,11.98%,14.23%,
104/05/18,-233,0,-18,-251,52647,2875,7684,63206,11.93%,14.32%,
104/05/15,125,-250,-18,-143,53028,2875,7702,63605,12.09%,14.49%,
104/05/14,-131,0,-200,-331,52893,3125,7720,63738,12.05%,14.51%,
104/05/13,-864,-135,832,-167,53024,3125,7920,64069,12.08%,14.58%,
104/05/12,308,0,145,453,53878,3260,7088,64226,12.28%,14.63%,
104/05/11,376,0,107,483,53570,3260,6943,63773,12.21%,14.52%,
104/05/08,-680,-394,-122,-1196,53194,3260,6836,63290,12.12%,14.41%,
104/05/07,113,0,47,160,53874,3654,6958,64486,12.28%,14.69%,
104/05/06,-915,0,-34,-949,53775,3654,6911,64340,12.26%,14.65%,
104/05/05,156,0,-240,-84,54680,3654,6945,65279,12.46%,14.86%,
104/05/04,-248,0,-113,-361,54514,3654,7185,65353,12.42%,14.88%,
104/04/30,325,100,-6,419,54747,3654,7298,65699,12.48%,14.96%,
104/04/29,-229,-1,111,-119,54392,3554,7304,65250,12.40%,14.86%,
104/04/28,22,0,-20,2,54621,3555,7193,65369,12.45%,14.89%,
104/04/27,208,0,-63,145,54599,3555,7213,65367,12.44%,14.88%,
104/04/24,-428,0,59,-369,54391,3555,7276,65222,12.40%,14.86%,
104/04/23,-151,-262,-29,-442,54819,3555,7217,65591,12.49%,14.93%,
104/04/22,-585,-260,-45,-890,54970,3817,7246,66033,12.53%,15.04%,
104/04/21,241,-106,-125,10,55555,4077,7291,66923,12.66%,15.24%,
104/04/20,-595,-420,-298,-1313,55314,4183,7416,66913,12.61%,15.24%,
104/04/17,-865,0,-58,-923,55909,4603,7714,68226,12.74%,15.53%,
104/04/16,-543,-110,97,-556,56769,4603,7772,69144,12.94%,15.75%,
104/04/15,-189,-52,-166,-407,57312,4713,7675,69700,13.06%,15.87%,
104/04/14,-336,0,62,-274,57507,4765,7841,70113,13.11%,15.97%,
104/04/13,98,-250,22,-130,57843,4765,7779,70387,13.18%,16.02%,
104/04/10,472,-1215,79,-664,57745,5015,7757,70517,13.16%,16.06%,
104/04/09,82,-171,-10,-99,57273,6230,7678,71181,13.05%,16.20%,
104/04/08,-621,-470,-120,-1211,57191,6401,7688,71280,13.03%,16.22%,
104/04/07,-629,-650,32,-1247,57802,6871,7808,72481,13.17%,16.50%,
104/04/02,-682,0,88,-594,58431,7521,7776,73728,13.32%,16.79%,
104/04/01,651,-650,-224,-223,59177,7521,7688,74386,13.49%,16.94%,
104/03/31,297,-800,-997,-1500,58526,8171,7912,74609,13.34%,16.99%,
104/03/30,275,-1670,-439,-1834,58229,8975,8909,76113,13.27%,17.32%,
104/03/27,316,-200,-336,-220,57892,10645,9348,77885,13.19%,17.72%,
104/03/26,640,-623,-74,-57,57576,10845,9684,78105,13.12%,17.77%,
104/03/25,555,-400,-227,-72,56936,11468,9758,78162,12.98%,17.79%,
104/03/24,263,0,8,271,56381,11868,9985,78234,12.85%,17.80%,
104/03/23,1333,-350,-237,746,56118,11868,9977,77963,12.79%,17.74%,
104/03/20,583,-201,120,502,54785,12218,10214,77217,12.49%,17.57%,
104/03/19,1507,-135,-405,967,54202,12419,10094,76715,12.35%,17.45%,
104/03/18,1000,-78,-1405,-483,52695,12554,10499,75748,12.01%,17.24%,
104/03/17,731,934,1518,3183,51695,12632,11904,76231,11.78%,17.34%,
104/03/16,1408,-8,29,1429,50964,11698,10386,73048,11.61%,16.62%,
104/03/13,1149,-280,-626,243,49556,11706,10357,71619,11.29%,16.29%,
104/03/12,1419,-31,103,1491,48407,11986,10983,71376,11.03%,16.24%,
104/03/11,1377,-300,-311,766,46987,12017,10880,69884,10.71%,15.90%,
104/03/10,1016,25,-265,776,45610,12317,11191,69118,10.39%,15.72%,
104/03/09,1609,-800,-234,575,44907,12292,11456,68655,10.23%,15.61%,
104/03/06,2954,-750,494,2698,43367,13092,11690,68149,9.88%,15.50%,
104/03/05,50,827,-398,479,40534,13842,11196,65572,9.24%,14.92%,
104/03/04,609,51,-1094,-434,40484,13015,11594,65093,9.23%,14.81%,
104/03/03,-27,510,440,923,39883,12964,12688,65535,9.09%,14.90%,
104/03/02,453,100,533,1086,39854,12454,12248,64556,9.08%,14.68%,
104/02/26,-1184,650,-901,-1435,39266,12354,11715,63335,8.95%,14.41%,
104/02/25,-327,100,2135,1908,40122,11704,12616,64442,9.14%,14.65%,
104/02/24,-11,30,-33,-14,40549,11604,10481,62634,9.24%,14.25%,
104/02/13,-391,0,-528,-919,40560,11574,10514,62648,9.24%,14.25%,
104/02/12,905,0,201,1106,41022,11574,11042,63638,9.35%,14.48%,
104/02/11,-494,0,-227,-721,40117,11574,10841,62532,9.14%,14.22%,
104/02/10,372,0,-34,338,41038,11574,11068,63680,9.35%,14.48%,
104/02/09,296,387,151,834,40666,11574,11102,63342,9.27%,14.41%,
104/02/06,736,468,-205,999,40360,11187,10951,62498,9.20%,14.22%,
104/02/05,-347,528,-234,-53,39583,10719,11156,61458,9.02%,13.98%,
104/02/04,1077,2071,-1075,2073,39864,10191,11390,61445,9.08%,13.97%,
104/02/03,213,2026,979,3218,38658,8120,12465,59243,8.81%,13.50%,
104/02/02,-105,2376,1084,3355,38396,6094,11486,55976,8.75%,12.75%,
104/01/30,-132,1148,659,1675,38384,3718,10402,52504,8.75%,11.96%,
104/01/29,124,0,3,127,38516,2570,9743,50829,8.78%,11.58%,
104/01/28,26,0,-79,-53,38392,2570,9740,50702,8.75%,11.55%,
104/01/27,-70,0,-6,-76,38366,2570,9819,50755,8.74%,11.56%,
104/01/26,132,0,-15,117,38596,2570,9825,50991,8.79%,11.61%,
104/01/23,-149,0,-187,-336,38464,2570,9840,50874,8.76%,11.58%,
104/01/22,-28,-27,57,2,38613,2570,10027,51210,8.80%,11.67%,
104/01/21,-148,0,-801,-949,38641,2597,9970,51208,8.81%,11.67%,
104/01/20,395,0,1347,1742,38789,2597,10771,52157,8.84%,11.88%,
104/01/19,146,-1,-9,136,38394,2597,9424,50415,8.75%,11.49%,
104/01/16,-77,0,-152,-229,38248,2598,9433,50279,8.72%,11.46%,
104/01/15,-14,-40,171,117,38325,2598,9585,50508,8.73%,11.50%,
104/01/14,-394,0,-4,-398,38339,2638,9414,50391,8.74%,11.48%,
104/01/13,689,0,-24,665,38537,2638,9418,50593,8.78%,11.52%,
104/01/12,-586,0,-9,-595,37829,2638,9442,49909,8.62%,11.37%,
104/01/09,-107,0,-49,-156,38373,2638,9451,50462,8.74%,11.49%,
104/01/08,-376,900,-824,-300,38441,2638,9500,50579,8.76%,11.52%,
104/01/07,-183,-1,902,718,38777,1738,10324,50839,8.84%,11.59%,
104/01/06,64,0,-6,58,38960,1739,9422,50121,8.88%,11.42%,
104/01/05,-229,0,-5,-234,38896,1739,9428,50063,8.86%,11.40%,
