日期,外資買賣超,投信買賣超,自營商買賣超,單日合計買賣超,外資估計持股,投信估計持股,自營商估計持股,單日合計估計持股,外資持股比重,三大法人持股比重,
107/03/31,485,0,-58,427,429664,3189,8851,441704,30.37%,31.22%,
107/03/30,692,0,179,871,428929,3189,8909,441027,30.32%,31.18%,
107/03/29,-762,0,-3,-765,428215,3189,8730,440134,30.27%,31.11%,
107/03/28,-144,0,-51,-195,428977,3189,8733,440899,30.32%,31.16%,
107/03/27,-821,-40,8,-853,429481,3189,8784,441454,30.36%,31.21%,
107/03/26,-622,-35,0,-657,430121,3229,8776,442126,30.40%,31.25%,
107/03/23,-425,-45,-141,-611,430232,3264,8776,442272,30.41%,31.26%,
107/03/22,7,-30,20,-3,430548,3309,8917,442774,30.43%,31.29%,
107/03/21,597,0,-79,518,430467,3339,8897,442703,30.43%,31.30%,
107/03/20,-1304,-1,-12,-1317,429688,3339,8976,442003,30.37%,31.24%,
107/03/19,-366,-6,-23,-395,430968,3340,8988,443296,30.46%,31.33%,
107/03/16,-2053,-3,-38,-2094,431169,3346,9011,443526,30.48%,31.35%,
107/03/15,-2694,0,59,-2635,433085,3349,9049,445483,30.61%,31.49%,
107/03/14,-2763,0,-95,-2858,435402,3349,8990,447741,30.78%,31.65%,
107/03/13,-272,0,119,-153,438155,3349,9085,450589,30.97%,31.85%,
107/03/12,-126,0,-33,-159,438367,3349,8966,450682,30.99%,31.86%,
107/03/09,-713,0,61,-652,438492,3349,8999,450840,31.00%,31.87%,
107/03/08,-1058,0,17,-1041,439525,3349,8938,451812,31.07%,31.94%,
107/03/07,24,0,85,109,440583,3349,8921,452853,31.14%,32.01%,
107/03/06,-292,0,-6,-298,440559,3349,8836,452744,31.14%,32.00%,
107/03/05,-1215,0,-74,-1289,440851,3349,8842,453042,31.16%,32.02%,
107/03/02,-826,0,22,-804,441953,3349,8916,454218,31.24%,32.11%,
107/03/01,-133,0,-25,-158,442779,3349,8894,455022,31.30%,32.17%,
107/02/27,-771,0,-6,-777,442871,3349,8919,455139,31.30%,32.17%,
107/02/26,300,1,-103,198,443641,3349,8925,455915,31.36%,32.23%,
107/02/23,-211,0,56,-155,443332,3348,9028,455708,31.34%,32.21%,
107/02/22,-2408,0,-43,-2451,443538,3348,8972,455858,31.35%,32.22%,
107/02/21,503,0,77,580,445948,3348,9015,458311,31.52%,32.39%,
107/02/12,-1815,-3,-56,-1874,445467,3348,8938,457753,31.49%,32.36%,
107/02/09,-418,0,-43,-461,447272,3351,8994,459617,31.62%,32.49%,
107/02/08,-413,1,-16,-428,447650,3351,9037,460038,31.64%,32.52%,
107/02/07,-81,6,-32,-107,448090,3350,9053,460493,31.67%,32.55%,
107/02/06,-3082,0,-790,-3872,448211,3344,9085,460640,31.68%,32.56%,
107/02/05,-825,7,-104,-922,451401,3344,9875,464620,31.91%,32.84%,
107/02/02,-1540,0,-110,-1650,452213,3337,9979,465529,31.97%,32.91%,
107/02/01,27,0,25,52,453986,3337,10089,467412,32.09%,33.04%,
107/01/31,-589,0,51,-538,453959,3337,10064,467360,32.09%,33.04%,
107/01/30,-1599,0,-210,-1809,454528,3337,10013,467878,32.13%,33.07%,
107/01/29,-2036,0,-139,-2175,456035,3337,10223,469595,32.24%,33.20%,
107/01/26,-894,-66,-146,-1106,458021,3337,10362,471720,32.38%,33.35%,
107/01/25,716,0,73,789,458915,3403,10508,472826,32.44%,33.42%,
107/01/24,70,-3,8,75,458178,3403,10435,472016,32.39%,33.37%,
107/01/23,-463,0,-45,-508,458102,3406,10427,471935,32.38%,33.36%,
107/01/22,-84,0,-311,-395,458565,3406,10472,472443,32.41%,33.39%,
107/01/19,-296,0,487,191,458650,3406,10783,472839,32.42%,33.42%,
107/01/18,77,0,86,163,458851,3406,10296,472553,32.43%,33.40%,
107/01/17,794,0,86,880,458774,3406,10210,472390,32.43%,33.39%,
107/01/16,640,-1,49,688,457980,3406,10124,471510,32.37%,33.33%,
107/01/15,150,-1,-41,108,457341,3407,10075,470823,32.33%,33.28%,
107/01/12,-813,0,220,-593,457190,3408,10116,470714,32.32%,33.28%,
107/01/11,-353,0,-18,-371,458003,3408,9896,471307,32.37%,33.31%,
107/01/10,-609,0,-286,-895,458356,3408,9914,471678,32.40%,33.34%,
107/01/09,131,0,98,229,458965,3408,10200,472573,32.44%,33.40%,
107/01/08,423,0,45,468,459141,3408,10102,472651,32.45%,33.41%,
107/01/05,197,0,20,217,458596,3408,10057,472061,32.42%,33.37%,
107/01/04,-83,0,22,-61,458399,3408,10037,471844,32.40%,33.35%,
107/01/03,388,0,3,391,458482,3408,10015,471905,32.41%,33.36%,
107/01/02,51,0,-40,11,458494,3408,10012,471914,32.41%,33.36%,
106/12/29,124,0,46,170,458443,3408,10052,471903,32.41%,33.36%,
106/12/28,325,15,159,499,458320,3328,10006,471654,32.40%,33.34%,
106/12/27,47,12,13,72,458829,3313,9847,471989,32.43%,33.36%,
106/12/26,-318,12,-293,-599,458782,3301,9834,471917,32.43%,33.36%,
106/12/25,-268,-100,-345,-713,459100,3289,10127,472516,32.45%,33.40%,
106/12/22,162,0,-132,30,458768,3389,10472,472629,32.43%,33.41%,
106/12/21,-2272,0,-183,-2455,458605,3389,10604,472598,32.42%,33.41%,
106/12/20,-550,0,66,-484,461889,3389,10787,476065,32.65%,33.65%,
106/12/19,-327,0,-273,-600,462466,3389,10721,476576,32.69%,33.69%,
106/12/18,437,0,57,494,462793,3389,10994,477176,32.71%,33.73%,
106/12/15,-100,17,-131,-214,462378,3389,10937,476704,32.68%,33.69%,
106/12/14,116,0,6,122,462278,3372,11068,476718,32.68%,33.70%,
106/12/13,1096,0,12,1108,462162,3372,11062,476596,32.67%,33.69%,
106/12/12,-41,-135,-131,-307,461171,3372,11050,475593,32.60%,33.62%,
106/12/11,478,0,30,508,461493,3507,11181,476181,32.62%,33.66%,
106/12/08,-307,0,-285,-592,461615,3507,11151,476273,32.63%,33.67%,
106/12/07,2339,0,400,2739,461878,3507,11436,476821,32.65%,33.71%,
106/12/06,92,-47,359,404,459347,3507,11036,473890,32.47%,33.50%,
106/12/05,-187,0,40,-147,459394,3554,10677,473625,32.47%,33.48%,
106/12/04,-56,-100,-177,-333,459737,3554,10637,473928,32.50%,33.50%,
106/12/01,-835,1,-190,-1024,459887,3654,10814,474355,32.51%,33.53%,
106/11/30,-1627,-28,-528,-2183,461035,3653,11004,475692,32.59%,33.63%,
106/11/29,-1779,-9,-392,-2180,462662,3681,11532,477875,32.70%,33.78%,
106/11/28,-2995,-2,-475,-3472,463541,3690,11924,479155,32.77%,33.87%,
106/11/27,-2902,-302,-527,-3731,466487,3692,12399,482578,32.97%,34.11%,
106/11/24,-2908,0,-81,-2989,469547,3994,12926,486467,33.19%,34.39%,
106/11/23,-86,-82,106,-62,472310,3994,13007,489311,33.39%,34.59%,
106/11/22,-1786,-240,-66,-2092,472397,4076,12901,489374,33.39%,34.59%,
106/11/21,-407,-100,-12,-519,474166,4316,12967,491449,33.52%,34.74%,
106/11/20,-1511,-55,-354,-1920,474536,4416,12979,491931,33.54%,34.77%,
106/11/17,387,-35,433,785,475972,4471,13333,493776,33.64%,34.90%,
106/11/16,-748,-100,-98,-946,475407,4506,12900,492813,33.60%,34.83%,
106/11/15,-1821,-445,-789,-3055,475835,4606,12998,493439,33.64%,34.88%,
106/11/14,1170,-173,-1518,-521,477656,5051,13787,496494,33.76%,35.09%,
106/11/13,-308,-40,-679,-1027,476286,5224,15305,496815,33.67%,35.12%,
106/11/10,454,0,-242,212,476521,5264,15984,497769,33.68%,35.18%,
106/11/09,-1196,-148,-256,-1600,476067,5264,16226,497557,33.65%,35.17%,
106/11/08,-21,-222,671,428,477263,5412,16482,499157,33.74%,35.29%,
106/11/07,601,-25,95,671,477682,5634,15811,499127,33.77%,35.29%,
106/11/06,83,16,-193,-94,476963,5659,15716,498338,33.71%,35.22%,
106/11/03,-289,-49,262,-76,476896,5643,15909,498448,33.71%,35.23%,
106/11/02,-150,-29,-183,-362,477159,5692,15647,498498,33.73%,35.24%,
106/11/01,-3397,-79,-394,-3870,477380,5720,15830,498930,33.74%,35.26%,
106/10/31,-83,-115,2231,2033,480647,5799,16224,502670,33.98%,35.54%,
106/10/30,2001,0,-330,1671,480622,5914,13993,500529,33.97%,35.38%,
106/10/27,-150,-192,-1088,-1430,478689,5914,14323,498926,33.84%,35.27%,
106/10/26,1776,-1,1296,3071,478803,6106,15411,500320,33.84%,35.36%,
106/10/25,11,-445,117,-317,477051,6107,14115,497273,33.72%,35.15%,
106/10/24,180,-1223,-145,-1188,476765,6552,13998,497315,33.70%,35.15%,
106/10/23,-736,0,270,-466,476653,7775,14143,498571,33.69%,35.24%,
106/10/20,423,0,585,1008,477315,7775,13873,498963,33.74%,35.27%,
106/10/19,315,-8,114,421,476822,7775,13288,497885,33.70%,35.19%,
106/10/18,477,-7,-277,193,476706,7783,13174,497663,33.70%,35.18%,
106/10/17,539,0,-354,185,476359,7790,13451,497600,33.67%,35.17%,
106/10/16,-423,-6,144,-285,476168,7790,13805,497763,33.66%,35.19%,
106/10/13,2001,0,-71,1930,476454,7796,13661,497911,33.68%,35.20%,
106/10/12,6839,-31,790,7598,474400,7796,13732,495928,33.53%,35.05%,
106/10/11,105,-51,423,477,467605,7827,12942,488374,33.05%,34.52%,
106/10/06,-569,0,-186,-755,467313,7878,12519,487710,33.03%,34.47%,
106/10/05,852,-28,169,993,467461,7878,12705,488044,33.04%,34.50%,
106/10/03,839,-240,-54,545,466580,7906,12536,487022,32.98%,34.43%,
106/10/02,-1759,-110,36,-1833,465693,8146,12590,486429,32.92%,34.39%,
106/09/30,0,0,95,95,467442,8256,12554,488252,33.04%,34.51%,
106/09/29,174,-206,-272,-304,467442,9347,12459,489248,33.04%,34.58%,
106/09/28,-1208,0,-131,-1339,467280,9553,12731,489564,33.03%,34.61%,
106/09/27,-3355,-57,-53,-3465,468510,9553,12862,490925,33.12%,34.70%,
106/09/26,180,-225,-499,-544,472107,9610,12915,494632,33.37%,34.96%,
106/09/25,-1437,-583,-638,-2658,471927,9835,13414,495176,33.36%,35.00%,
106/09/22,-1549,-89,-595,-2233,473358,10418,14052,497828,33.46%,35.19%,
106/09/21,-3552,-182,254,-3480,474907,10507,14647,500061,33.57%,35.35%,
106/09/20,-1219,-48,-1390,-2657,478459,10689,14393,503541,33.82%,35.59%,
106/09/19,-1341,-207,-392,-1940,480306,10737,15783,506826,33.95%,35.82%,
106/09/18,-383,57,-362,-688,481637,10944,16175,508756,34.05%,35.97%,
106/09/15,404,209,485,1098,481985,10887,16537,509409,34.07%,36.01%,
106/09/14,1287,-27,156,1416,481504,10678,16052,508234,34.04%,35.93%,
106/09/13,-794,-64,-534,-1392,480177,10705,15896,506778,33.94%,35.82%,
106/09/12,-1244,-31,-85,-1360,480881,10769,16430,508080,33.99%,35.91%,
106/09/11,-41,824,17,800,482037,10800,16515,509352,34.07%,36.00%,
106/09/08,-1715,-153,52,-1816,482040,9976,16498,508514,34.07%,35.94%,
106/09/07,-2906,-450,-204,-3560,483672,10129,16446,510247,34.19%,36.07%,
106/09/06,715,-95,452,1072,486529,10579,16650,513758,34.39%,36.32%,
106/09/05,-290,0,40,-250,485611,10674,16198,512483,34.33%,36.23%,
106/09/04,-190,0,171,-19,485876,10674,16158,512708,34.35%,36.25%,
106/09/01,-256,89,60,-107,486050,10674,15987,512711,34.36%,36.24%,
106/08/31,-494,167,581,254,486292,10585,15927,512804,34.37%,36.24%,
106/08/30,260,0,64,324,486832,10418,15346,512596,34.41%,36.23%,
106/08/29,-967,60,-492,-1399,486606,10418,15282,512306,34.40%,36.22%,
106/08/28,-97,-1,329,231,487573,10358,15774,513705,34.47%,36.32%,
106/08/25,-828,-1,180,-649,487670,10359,15445,513474,34.47%,36.29%,
106/08/24,94,-68,274,300,488492,10360,15265,514117,34.53%,36.34%,
106/08/23,-259,-166,-422,-847,488397,10428,14991,513816,34.52%,36.32%,
106/08/22,282,-34,604,852,488584,10594,15413,514591,34.54%,36.38%,
106/08/21,-428,0,-40,-468,488434,10628,14809,513871,34.53%,36.33%,
106/08/18,-1436,0,-553,-1989,488863,10628,14849,514340,34.56%,36.36%,
106/08/17,866,200,893,1959,490298,10628,15402,516328,34.66%,36.50%,
106/08/16,880,71,-421,530,489433,10428,14509,514370,34.60%,36.36%,
106/08/15,-168,-217,123,-262,488884,10357,14930,514171,34.56%,36.35%,
106/08/14,431,-1,-534,-104,489059,10574,14807,514440,34.57%,36.36%,
106/08/11,-1422,63,58,-1301,488658,10575,15341,514574,34.54%,36.37%,
106/08/10,-676,233,107,-336,489670,10512,15283,515465,34.61%,36.43%,
106/08/09,-300,1045,-740,5,490310,10279,15176,515765,34.66%,36.46%,
106/08/08,-4122,504,-606,-4224,490595,9234,15916,515745,34.68%,36.46%,
106/08/07,2280,713,3322,6315,494686,8730,16522,519938,34.97%,36.76%,
106/08/04,-1324,81,-498,-1741,492385,8017,13200,513602,34.81%,36.31%,
106/08/03,-321,63,532,274,493397,7936,13698,515031,34.88%,36.41%,
106/08/02,429,130,1742,2301,493786,7873,13166,514825,34.90%,36.39%,
106/08/01,-241,4,150,-87,493348,7743,11424,512515,34.87%,36.23%,
106/07/31,-731,1,-168,-898,493558,7739,11274,512571,34.89%,36.23%,
106/07/28,-377,89,-154,-442,494279,7738,11442,513459,34.94%,36.30%,
106/07/27,451,197,124,772,494562,7649,11596,513807,34.96%,36.32%,
106/07/26,-647,-76,-147,-870,493942,7452,11472,512866,34.92%,36.26%,
106/07/25,-526,1,158,-367,494135,7528,11619,513282,34.93%,36.28%,
106/07/24,-151,0,-88,-239,494469,7527,11461,513457,34.95%,36.29%,
106/07/21,-1610,10,-461,-2061,494532,7527,11549,513608,34.96%,36.31%,
106/07/20,198,49,-4,243,496116,7517,12010,515643,35.07%,36.45%,
106/07/19,-448,-25,-388,-861,495918,7468,12014,515400,35.05%,36.43%,
106/07/18,-346,29,-40,-357,496356,7493,12402,516251,35.09%,36.50%,
106/07/17,-1354,-30,-300,-1684,495202,7464,12442,515108,35.00%,36.41%,
106/07/14,-1603,58,-428,-1973,496556,7494,12742,516792,35.10%,36.53%,
106/07/13,-1933,179,-2714,-4468,498169,7436,13170,518775,35.21%,36.67%,
106/07/12,1508,55,3941,5504,500216,7257,15884,523357,35.36%,37.00%,
106/07/11,7203,358,1478,9039,498697,7202,11943,517842,35.25%,36.60%,
106/07/10,372,-2,184,554,491495,6844,10465,508804,34.74%,35.96%,
106/07/07,-494,0,4,-490,491123,6846,10281,508250,34.72%,35.93%,
106/07/06,-3024,0,12,-3012,491617,6846,10277,508740,34.75%,35.96%,
106/07/05,-891,0,42,-849,494641,6846,10265,511752,34.96%,36.17%,
106/07/04,-688,-577,-106,-1371,495532,6846,10223,512601,35.03%,36.24%,
106/07/03,280,-518,-15,-253,496539,7423,10329,514291,35.10%,36.36%,
106/06/30,-1563,-586,-72,-2221,496259,7941,10344,514544,35.08%,36.37%,
106/06/29,-1167,174,-30,-1023,498080,7134,10416,515630,35.21%,36.45%,
106/06/28,-4184,-25,91,-4118,499247,6960,10446,516653,35.29%,36.52%,
106/06/27,-1632,-24,405,-1251,503430,6984,10355,520769,35.59%,36.82%,
106/06/26,443,-95,96,444,504985,7008,9950,521943,35.70%,36.90%,
106/06/23,-2140,-91,-116,-2347,504747,7103,9854,521704,35.68%,36.88%,
106/06/22,-73,44,-1,-30,507006,7194,9970,524170,35.84%,37.05%,
106/06/21,134,0,-82,52,505710,7150,9971,522831,35.75%,36.96%,
106/06/20,-4899,-6,287,-4618,503204,7150,10053,520407,35.57%,36.79%,
106/06/19,-2363,335,1571,-457,508119,7156,9766,525041,35.92%,37.12%,
106/06/16,-1317,218,27,-1072,510483,6821,8195,525499,36.08%,37.14%,
106/06/15,-4198,-66,52,-4212,512107,6603,8168,526878,36.20%,37.24%,
106/06/14,-3958,-1,51,-3908,516689,6669,8116,531474,36.52%,37.57%,
106/06/13,-1516,0,-6,-1522,520975,6670,8065,535710,36.83%,37.87%,
106/06/12,-3084,0,-58,-3142,522755,6670,8071,537496,36.95%,37.99%,
106/06/09,-3097,-2,90,-3009,525898,6670,8129,540697,37.17%,38.22%,
106/06/08,-4320,0,-45,-4365,528995,6672,8039,543706,37.39%,38.43%,
106/06/07,-2510,-2,-11,-2523,533549,6672,8084,548305,37.72%,38.76%,
106/06/06,-1371,-26,-42,-1439,536060,6674,8094,550828,37.89%,38.93%,
106/06/05,-1910,-180,76,-2014,537376,6700,8136,552212,37.99%,39.04%,
106/06/03,0,-224,-23,-247,539286,6880,8060,554226,38.12%,39.18%,
106/06/02,-5922,-17,62,-5877,539286,7104,8083,554473,38.12%,39.19%,
106/06/01,-919,-125,-81,-1125,545211,7121,8021,560353,38.54%,39.61%,
106/05/31,-3484,-257,-163,-3904,546130,7246,8102,561478,38.60%,39.69%,
106/05/26,-3532,-163,23,-3672,549614,7503,8265,565382,38.85%,39.96%,
106/05/25,-1482,-345,24,-1803,553146,7666,8242,569054,39.10%,40.22%,
106/05/24,-3484,-201,33,-3652,554619,8011,8218,570848,39.20%,40.35%,
106/05/23,-3103,-65,78,-3090,557965,8212,8185,574362,39.44%,40.60%,
106/05/22,-3690,-1,31,-3660,561140,8277,8107,577524,39.67%,40.83%,
106/05/19,-2782,-364,4,-3142,564814,8278,8076,581168,39.93%,41.09%,
106/05/18,-2061,-5,5,-2061,567581,8642,8072,584295,40.12%,41.30%,
106/05/17,-3270,-53,-132,-3455,569857,8647,8067,586571,40.28%,41.46%,
106/05/16,-1267,234,-300,-1333,573106,8700,8199,590005,40.51%,41.70%,
106/05/15,-678,55,201,-422,574361,8466,8499,591326,40.60%,41.80%,
106/05/12,-2397,-193,-59,-2649,575028,8411,8298,591737,40.65%,41.83%,
106/05/11,-2857,-40,-266,-3163,577171,8604,8357,594132,40.80%,42.00%,
106/05/10,94,0,0,94,580028,8644,8623,597295,41.00%,42.22%,
106/05/09,785,105,147,1037,579924,8644,8623,597191,40.99%,42.21%,
106/05/08,16,30,-78,-32,579185,8539,8477,596201,40.94%,42.14%,
106/05/05,-22,20,40,38,579157,8509,8555,596221,40.94%,42.15%,
106/05/04,58,29,-3,84,579138,8489,8515,596142,40.94%,42.14%,
106/05/03,350,0,54,404,579066,8461,8518,596045,40.93%,42.13%,
106/05/02,886,331,2,1219,578716,8461,8464,595641,40.91%,42.11%,
106/04/28,883,-22,38,899,577821,8130,8462,594413,40.85%,42.02%,
106/04/27,2309,-20,104,2393,576925,8152,8424,593501,40.78%,41.95%,
106/04/26,678,-125,62,615,574636,8172,8320,591128,40.62%,41.79%,
106/04/25,-220,-21,38,-203,573958,8297,8258,590513,40.57%,41.74%,
106/04/24,-254,-19,-38,-311,574175,8318,8220,590713,40.59%,41.76%,
106/04/21,914,0,-139,775,574682,8337,8258,591277,40.62%,41.79%,
106/04/20,3577,50,213,3840,573768,8337,8397,590502,40.56%,41.74%,
106/04/19,-870,-192,-540,-1602,570205,8287,8184,586676,40.31%,41.47%,
106/04/18,-809,1,17,-791,571074,8478,8724,588276,40.37%,41.59%,
106/04/17,-695,0,-43,-738,571849,8477,8707,589033,40.42%,41.63%,
106/04/14,-719,-3,-112,-834,572489,8477,8750,589716,40.47%,41.69%,
106/04/13,-412,20,19,-373,573209,8480,8862,590551,40.52%,41.75%,
106/04/12,-1702,-67,-129,-1898,573543,8460,8843,590846,40.54%,41.76%,
106/04/11,-894,0,-122,-1016,575246,8527,8972,592745,40.66%,41.90%,
106/04/10,-176,26,-9,-159,576023,8527,9094,593644,40.72%,41.97%,
106/04/07,-1462,-201,-47,-1710,576188,8501,9103,593792,40.73%,41.97%,
106/04/06,-1802,-132,-244,-2178,577671,8702,9150,595523,40.83%,42.09%,
106/04/05,-845,-302,510,-637,579462,8834,9394,597690,40.96%,42.25%,
106/03/31,-656,4,24,-628,580402,9136,8884,598422,41.03%,42.30%,
106/03/30,-161,2,-204,-363,581058,9718,8860,599636,41.07%,42.38%,
106/03/29,-35,56,61,82,581219,9716,9064,599999,41.09%,42.42%,
106/03/28,708,0,-32,676,581253,9660,9003,599916,41.09%,42.41%,
106/03/27,494,1,-242,253,580545,9660,9035,599240,41.04%,42.36%,
106/03/24,-589,80,-141,-650,580051,9659,9277,598987,41.00%,42.34%,
106/03/23,-335,64,-46,-317,580640,9579,9418,599637,41.04%,42.38%,
106/03/22,205,15,-153,67,580975,9515,9464,599954,41.07%,42.41%,
106/03/21,260,218,-232,246,580770,9500,9617,599887,41.05%,42.40%,
106/03/20,609,-94,428,943,580510,9282,9849,599641,41.04%,42.39%,
106/03/17,345,2,142,489,579901,9376,9421,598698,40.99%,42.32%,
106/03/16,-392,189,-48,-251,579556,9374,9279,598209,40.97%,42.29%,
106/03/15,-342,171,-55,-226,579948,9185,9327,598460,41.00%,42.31%,
106/03/14,173,28,176,377,580291,9014,9382,598687,41.02%,42.32%,
106/03/13,372,0,-31,341,580118,8986,9206,598310,41.01%,42.30%,
106/03/10,299,24,254,577,579746,8986,9237,597969,40.98%,42.27%,
106/03/09,-207,0,-113,-320,579448,8962,8983,597393,40.96%,42.23%,
106/03/08,-248,82,126,-40,579655,8962,9096,597713,40.97%,42.25%,
106/03/07,29,135,19,183,579903,8880,8970,597753,40.99%,42.25%,
106/03/06,1083,22,-62,1043,579874,8745,8951,597570,40.99%,42.24%,
106/03/03,-740,-17,7,-750,578791,8723,9013,596527,40.91%,42.16%,
106/03/02,-1405,-395,-298,-2098,579531,8740,9006,597277,40.97%,42.22%,
106/03/01,-294,528,74,308,580935,9135,9304,599374,41.07%,42.37%,
106/02/24,-427,95,47,-285,581229,8607,9230,599066,41.09%,42.35%,
106/02/23,-4118,-120,160,-4078,581656,8512,9183,599351,41.12%,42.37%,
106/02/22,843,130,-4,969,585774,8632,9023,603429,41.41%,42.66%,
106/02/21,339,176,-348,167,584931,8502,9027,602460,41.35%,42.59%,
106/02/20,899,-12,-66,821,584592,8326,9375,602293,41.32%,42.57%,
106/02/18,0,24,6,30,583693,8338,9441,601472,41.26%,42.52%,
106/02/17,421,104,-33,492,583693,8314,9435,601442,41.26%,42.51%,
106/02/16,738,404,-286,856,583271,8210,9468,600949,41.23%,42.48%,
106/02/15,2232,424,-465,2191,582533,7806,9754,600093,41.18%,42.42%,
106/02/14,903,500,324,1727,580301,7382,10219,597902,41.02%,42.26%,
106/02/13,2267,511,374,3152,579388,6882,9895,596165,40.96%,42.15%,
106/02/10,717,132,102,951,577107,6371,9521,592999,40.79%,41.91%,
106/02/09,-346,346,-881,-881,576350,6239,9419,592008,40.74%,41.85%,
106/02/08,582,0,1823,2405,576686,5893,10300,592879,40.77%,41.91%,
106/02/07,764,36,-85,715,576094,5893,8477,590464,40.72%,41.74%,
106/02/06,28,12,-211,-171,575286,5857,8562,589705,40.67%,41.69%,
106/02/03,-2154,8,-90,-2236,575258,5845,8773,589876,40.66%,41.69%,
106/02/02,134,14,364,512,577401,5837,8863,592101,40.82%,41.86%,
106/01/24,421,36,-174,283,577150,5823,8499,591472,40.80%,41.81%,
106/01/23,1397,-87,359,1669,576912,5787,8672,591371,40.78%,41.80%,
106/01/20,-903,12,4,-887,575754,5874,8313,589941,40.70%,41.70%,
106/01/19,123,12,-83,52,576638,5862,8309,590809,40.76%,41.76%,
106/01/18,237,0,62,299,576467,5850,8392,590709,40.75%,41.76%,
106/01/17,734,0,13,747,576197,5850,8330,590377,40.73%,41.73%,
106/01/16,249,-203,-1,45,575453,5850,8317,589620,40.68%,41.68%,
106/01/13,630,0,71,701,575193,6053,8318,589564,40.66%,41.68%,
106/01/12,701,-403,-142,156,574563,6053,8247,588863,40.61%,41.62%,
106/01/11,737,-445,-102,190,573604,6456,8389,588449,40.55%,41.60%,
106/01/10,-39,0,-37,-76,572855,6901,8491,588247,40.49%,41.58%,
106/01/09,237,-30,-37,170,572883,6901,8528,588312,40.50%,41.59%,
106/01/06,-600,-52,-45,-697,572646,6931,8565,588142,40.48%,41.58%,
106/01/05,-723,-173,-11,-907,573246,6983,8610,588839,40.52%,41.62%,
106/01/04,-277,0,16,-261,573959,7156,8621,589736,40.57%,41.69%,
106/01/03,198,20,-6,212,574237,7156,8605,589998,40.59%,41.70%,
105/12/30,279,120,-172,227,574039,7136,8611,589786,40.58%,41.69%,
105/12/29,-207,0,2,-205,573800,7016,8783,589599,40.56%,41.68%,
105/12/28,-77,84,25,32,574060,7016,8781,589857,40.58%,41.70%,
105/12/27,-76,0,36,-40,574127,6932,8756,589815,40.58%,41.69%,
105/12/26,-123,-5,-1,-129,574193,6932,8720,589845,40.59%,41.70%,
105/12/23,-415,0,4,-411,574306,6937,8721,589964,40.60%,41.71%,
105/12/22,-352,0,-55,-407,574710,6937,8717,590364,40.63%,41.74%,
105/12/21,133,-28,231,336,575049,6937,8772,590758,40.65%,41.76%,
105/12/20,-180,-387,70,-497,575145,6965,8541,590651,40.66%,41.76%,
105/12/19,-840,-36,-63,-939,575636,7352,8471,591459,40.69%,41.81%,
105/12/16,-539,186,78,-275,576466,7388,8534,592388,40.75%,41.88%,
105/12/15,-3,100,-27,70,576995,7202,8456,592653,40.79%,41.90%,
105/12/14,276,488,-119,645,576960,7102,8483,592545,40.78%,41.88%,
105/12/13,136,300,131,567,576740,6614,8602,591956,40.77%,41.85%,
105/12/12,759,0,-137,622,576416,6314,8471,591201,40.75%,41.80%,
105/12/09,70,0,-152,-82,575582,6314,8608,590504,40.69%,41.74%,
105/12/08,1714,0,357,2071,575512,6314,8760,590586,40.68%,41.75%,
105/12/07,554,0,-31,523,573799,6314,8403,588516,40.56%,41.60%,
105/12/06,-1024,0,-28,-1052,573934,6314,8434,588682,40.57%,41.61%,
105/12/05,-373,0,49,-324,575248,6314,8462,590024,40.66%,41.70%,
105/12/02,1095,-538,-152,405,575730,6314,8413,590457,40.70%,41.74%,
105/12/01,-1706,-50,166,-1590,574635,6852,8565,590052,40.62%,41.71%,
105/11/30,-2031,-436,-446,-2913,576341,6902,8399,591642,40.74%,41.82%,
105/11/29,-271,-40,437,126,577957,7338,8844,594139,40.85%,41.99%,
105/11/28,1155,-1433,314,36,577977,7378,8407,593762,40.86%,41.98%,
105/11/25,-12,-898,-224,-1134,576782,8811,8093,593686,40.77%,41.97%,
105/11/24,-513,0,-44,-557,576791,9709,8317,594817,40.77%,42.04%,
105/11/23,-430,-101,91,-440,577530,9709,8361,595600,40.82%,42.10%,
105/11/22,38,-100,117,55,577939,9810,8270,596019,40.85%,42.13%,
105/11/21,-964,0,21,-943,577894,9910,8154,595958,40.85%,42.13%,
105/11/18,-1500,-63,35,-1528,578768,9910,8133,596811,40.91%,42.19%,
105/11/17,-700,-315,-152,-1167,580111,9973,8098,598182,41.01%,42.29%,
105/11/16,-528,-19,192,-355,580813,10288,8250,599351,41.06%,42.38%,
105/11/15,-1272,-86,13,-1345,581427,10307,8058,599792,41.10%,42.40%,
105/11/14,-596,-378,29,-945,582649,10393,8045,601087,41.19%,42.50%,
105/11/11,-2144,-1143,-337,-3624,583235,10771,8016,602022,41.23%,42.56%,
105/11/10,752,-190,94,656,585264,11914,8353,605531,41.37%,42.81%,
105/11/09,1151,-81,-376,694,584396,12104,8259,604759,41.31%,42.76%,
105/11/08,1578,-202,-4,1372,583123,12185,8635,603943,41.22%,42.70%,
105/11/07,-542,-27,177,-392,576007,12387,8639,597033,41.29%,42.78%,
105/11/04,-179,-49,-21,-249,576472,12414,8462,597348,41.32%,42.80%,
105/11/03,709,0,-38,671,576650,12463,8483,597596,41.33%,42.82%,
105/11/02,5,-276,-132,-403,575931,12463,8521,596915,41.28%,42.77%,
105/11/01,-149,0,77,-72,575915,12739,8653,597307,41.28%,42.80%,
105/10/31,716,0,-37,679,576031,12739,8576,597346,41.29%,42.80%,
105/10/28,290,-24,-292,-26,575315,12739,8613,596667,41.24%,42.76%,
105/10/27,884,0,-71,813,574984,12763,8905,596652,41.21%,42.75%,
105/10/26,-1967,0,-184,-2151,574078,12763,8976,595817,41.15%,42.69%,
105/10/25,346,0,-87,259,575853,12763,9160,597776,41.27%,42.83%,
105/10/24,-266,436,-25,145,575510,12763,9247,597520,41.25%,42.81%,
105/10/21,327,1298,-378,1247,575776,12327,9272,597375,41.27%,42.80%,
105/10/20,-256,337,-68,13,575311,11029,9650,595990,41.24%,42.71%,
105/10/19,7571,20,653,8244,575421,10692,9718,595831,41.24%,42.69%,
105/10/18,1541,0,80,1621,567889,10672,9065,587626,40.70%,42.10%,
105/10/17,1036,0,-67,969,566288,10672,8985,585945,40.59%,41.99%,
105/10/14,1762,0,-340,1422,565242,10672,9052,584966,40.51%,41.91%,
105/10/13,-1270,200,83,-987,563470,10672,9392,583534,40.39%,41.81%,
105/10/12,1007,0,-188,819,564739,10472,9309,584520,40.48%,41.88%,
105/10/11,2344,553,-141,2756,563723,10472,9497,583692,40.40%,41.82%,
105/10/07,685,-16,-114,555,561466,9919,9638,581023,40.24%,41.63%,
105/10/06,461,188,-229,420,560771,9935,9752,580458,40.19%,41.59%,
105/10/05,2004,225,-47,2182,560310,9747,9981,580038,40.16%,41.56%,
105/10/04,4193,0,-61,4132,558262,9522,10028,577812,40.01%,41.40%,
105/10/03,-578,0,40,-538,554038,9522,10089,573649,39.71%,41.10%,
105/09/30,776,699,533,2008,554616,9522,10049,574187,39.75%,41.14%,
105/09/29,6036,202,190,6428,553298,12297,9516,575111,39.66%,41.21%,
105/09/26,848,-59,-157,632,547262,12095,9325,568682,39.22%,40.74%,
105/09/23,1413,251,-622,1042,546413,12154,9482,568049,39.16%,40.70%,
105/09/22,-156,1007,950,1801,544995,11903,10104,567002,39.06%,40.62%,
105/09/21,2065,-60,-320,1685,545387,10896,9154,565437,39.09%,40.51%,
105/09/20,1561,214,-124,1651,543260,10956,9474,563690,38.94%,40.39%,
105/09/19,1821,1107,438,3366,541677,10742,9598,562017,38.82%,40.26%,
105/09/14,1233,529,322,2084,539781,9635,9160,558576,38.69%,40.02%,
105/09/13,886,-308,-121,457,538508,9106,8838,556452,38.60%,39.87%,
105/09/12,-478,95,-40,-423,537832,9414,8959,556205,38.55%,39.85%,
105/09/10,-169,0,-137,-306,538254,9319,8999,556572,38.58%,39.88%,
105/09/09,663,-34,-330,299,538423,9319,9136,556878,38.59%,39.90%,
105/09/08,1021,100,-934,187,537737,9353,9466,556556,38.54%,39.88%,
105/09/07,-70,105,-477,-442,536631,9253,10400,556284,38.46%,39.85%,
105/09/06,901,188,78,1167,536619,9148,10877,556644,38.46%,39.88%,
105/09/05,1604,0,-325,1279,535677,8960,10799,555436,38.39%,39.79%,
105/09/02,3876,91,-2657,1310,533781,8960,11124,553865,38.26%,39.69%,
105/09/01,548,87,2966,3601,529888,8869,13781,552538,37.98%,39.60%,
105/08/31,6027,-5,80,6102,529341,8782,10816,548939,37.94%,39.34%,
105/08/30,843,367,-28,1182,523412,8787,10736,542935,37.51%,38.91%,
105/08/29,928,0,351,1279,523319,8420,10764,542503,37.51%,38.89%,
105/08/26,2038,407,-332,2113,522793,8420,10413,541626,37.47%,38.82%,
105/08/25,3556,202,-57,3701,520353,8013,10745,539111,37.30%,38.64%,
105/08/24,2046,289,1286,3621,516796,7811,10802,535409,37.04%,38.37%,
105/08/23,708,0,-136,572,514978,7522,9516,532016,36.91%,38.13%,
105/08/22,1548,0,-270,1278,514214,7522,9652,531388,36.86%,38.09%,
105/08/19,3558,20,-133,3445,512585,7522,9922,530029,36.74%,37.99%,
105/08/18,1675,125,-88,1712,508963,7502,10055,526520,36.48%,37.74%,
105/08/17,1613,0,212,1825,507306,7377,10143,524826,36.36%,37.62%,
105/08/16,1368,-4,-223,1141,505684,7377,9931,522992,36.24%,37.48%,
105/08/15,3616,189,1532,5337,504314,7381,10154,521849,36.15%,37.41%,
105/08/12,4215,-2,144,4357,500698,7192,8622,516512,35.89%,37.02%,
105/08/11,607,0,-28,579,496483,7194,8478,512155,35.58%,36.70%,
105/08/10,1502,0,-126,1376,495873,7194,8506,511573,35.54%,36.67%,
105/08/09,1119,-1,-579,539,494371,7194,8632,510197,35.43%,36.56%,
105/08/08,194,-2,764,956,493252,7195,9211,509658,35.35%,36.53%,
105/08/05,876,-177,-21,678,493058,7197,8447,508702,35.34%,36.46%,
105/08/04,984,6,-85,905,492181,7374,8468,508023,35.28%,36.42%,
105/08/03,546,0,61,607,491195,7368,8553,507116,35.21%,36.35%,
105/08/02,658,-1,-31,626,490648,7368,8492,506508,35.17%,36.31%,
105/08/01,1036,0,14,1050,490168,7369,8523,506060,35.13%,36.27%,
105/07/29,-379,-5,-28,-412,489320,7369,8509,505198,35.07%,36.21%,
105/07/28,1277,-32,-28,1217,489861,7374,8537,505772,35.11%,36.25%,
105/07/27,1003,-287,-110,606,488584,7406,8565,504555,35.02%,36.16%,
105/07/26,885,-113,-87,685,487581,7693,8675,503949,34.95%,36.12%,
105/07/25,193,-356,-151,-314,485831,7806,8762,502399,34.82%,36.01%,
105/07/22,426,8,-13,421,485393,8162,8913,502468,34.79%,36.01%,
105/07/21,1902,-7,58,1953,484239,8154,8926,501319,34.71%,35.93%,
105/07/20,1244,-596,-42,606,482109,8161,8868,499138,34.55%,35.77%,
105/07/19,1419,-878,-517,24,480559,8757,8910,498226,34.44%,35.71%,
105/07/18,890,70,445,1405,479126,9635,9427,498188,34.34%,35.71%,
105/07/15,1459,32,231,1722,477892,9565,8982,496439,34.25%,35.58%,
105/07/14,105,-1,-9,95,476411,9533,8751,494695,34.15%,35.46%,
105/07/13,605,20,416,1041,476298,9534,8760,494592,34.14%,35.45%,
105/07/12,1043,735,82,1860,475691,9514,8344,493549,34.09%,35.37%,
105/07/11,682,0,164,846,474648,8779,8262,491689,34.02%,35.24%,
105/07/07,204,0,-85,119,473966,8779,8098,490843,33.97%,35.18%,
105/07/06,-203,-10,-72,-285,473762,8779,8183,490724,33.96%,35.18%,
105/07/05,-180,-10,-23,-213,473966,8789,8255,491010,33.97%,35.19%,
105/07/04,928,0,10,938,474146,8799,8278,491223,33.98%,35.20%,
105/07/01,-359,90,-112,-381,473218,8799,8268,490285,33.92%,35.14%,
105/06/30,3184,85,191,3460,473577,8709,8380,490666,33.94%,35.16%,
105/06/29,379,0,-100,279,470959,8628,8189,487776,33.75%,34.96%,
105/06/28,-954,0,19,-935,470610,8628,8289,487527,33.73%,34.94%,
105/06/27,-928,487,4,-437,471563,8628,8270,488461,33.80%,35.01%,
105/06/24,-1434,516,-106,-1024,472461,8141,8266,488868,33.86%,35.04%,
105/06/23,816,260,-49,1027,474376,7625,8372,490373,34.00%,35.15%,
105/06/22,2269,0,-81,2188,473561,7365,8421,489347,33.94%,35.07%,
105/06/21,146,45,-4,187,471318,7365,8502,487185,33.78%,34.92%,
105/06/20,156,-2,48,202,470622,7320,8506,486448,33.73%,34.86%,
105/06/17,-880,-13,-46,-939,467803,7322,8458,483583,33.53%,34.66%,
105/06/16,-805,-4,17,-792,468396,7335,8504,484235,33.57%,34.71%,
105/06/15,1049,100,-133,1016,469255,7339,8487,485081,33.63%,34.76%,
105/06/14,2652,0,268,2920,467912,7239,8620,483771,33.54%,34.68%,
105/06/13,2761,0,-146,2615,465326,7239,8352,480917,33.35%,34.47%,
105/06/08,1842,63,-4,1901,462621,7239,8498,478358,33.16%,34.29%,
105/06/07,4396,0,7,4403,460862,7176,8502,476540,33.03%,34.15%,
105/06/06,553,-26,52,579,456575,7176,8495,472246,32.72%,33.84%,
105/06/04,21,0,-5,16,456022,7202,8443,471667,32.68%,33.80%,
105/06/03,2263,0,12,2275,456057,7202,8448,471707,32.69%,33.81%,
105/06/02,2287,0,6,2293,453929,7202,8436,469567,32.53%,33.65%,
105/06/01,1438,0,-172,1266,451698,7202,8430,467330,32.37%,33.49%,
105/05/31,3603,0,450,4053,450313,7202,8602,466117,32.27%,33.40%,
105/05/30,2349,5,-16,2338,446881,7202,8152,462235,32.03%,33.13%,
105/05/27,2289,0,-46,2243,444032,7197,8168,459397,31.82%,32.92%,
105/05/26,452,542,-61,933,441743,7197,8214,457154,31.66%,32.76%,
105/05/25,2281,0,335,2616,441291,6655,8275,456221,31.63%,32.70%,
105/05/24,4306,0,-155,4151,439008,6655,7940,453603,31.46%,32.51%,
105/05/23,1440,107,262,1809,434702,6655,8095,449452,31.16%,32.22%,
105/05/20,1409,14,32,1455,433241,6548,7833,447622,31.05%,32.08%,
105/05/19,2138,0,-177,1961,431811,6534,7801,446146,30.95%,31.98%,
105/05/18,4811,25,104,4940,429620,6534,7978,444132,30.79%,31.83%,
105/05/17,2914,0,112,3026,424722,6509,7874,439105,30.44%,31.47%,
105/05/16,2351,0,-25,2326,421918,6509,7762,436189,30.24%,31.26%,
105/05/13,3172,0,151,3323,420463,6509,7787,434759,30.14%,31.16%,
105/05/12,215,0,-26,189,417291,6509,7636,431436,29.91%,30.92%,
105/05/11,1354,0,-23,1331,416943,6509,7662,431114,29.88%,30.90%,
105/05/10,-149,-1,131,-19,415017,6509,7685,429211,29.74%,30.76%,
105/05/09,1108,0,5,1113,415164,6510,7554,429228,29.76%,30.77%,
105/05/06,-510,0,-56,-566,414109,6510,7549,428168,29.68%,30.69%,
105/05/05,-1351,-45,-107,-1503,414672,6510,7605,428787,29.72%,30.73%,
105/05/04,336,0,18,354,416050,6555,7712,430317,29.82%,30.84%,
105/05/03,619,0,-35,584,415714,6555,7694,429963,29.79%,30.81%,
105/04/29,801,-550,-21,230,415083,6555,7729,429367,29.75%,30.77%,
105/04/28,-822,-60,-169,-1051,414282,7105,7750,429137,29.69%,30.75%,
105/04/27,358,0,6,364,415104,7165,7919,430188,29.75%,30.83%,
105/04/26,193,0,18,211,414774,7165,7913,429852,29.73%,30.81%,
105/04/25,581,0,13,594,414581,7165,7895,429641,29.71%,30.79%,
105/04/22,1219,0,-59,1160,413975,7165,7882,429022,29.67%,30.75%,
105/04/21,2260,0,-19,2241,412779,7165,7941,427885,29.58%,30.66%,
105/04/20,173,0,-250,-77,410519,7165,7960,425644,29.42%,30.50%,
105/04/19,-312,0,-233,-545,410443,7165,8210,425818,29.42%,30.52%,
105/04/18,1347,0,33,1380,410792,7165,8443,426400,29.44%,30.56%,
105/04/15,1569,135,79,1783,409404,7165,8410,424979,29.34%,30.46%,
105/04/14,4021,0,-110,3911,407915,7030,8331,423276,29.24%,30.34%,
105/04/13,3743,-10,107,3840,403939,7030,8441,419410,28.95%,30.06%,
105/04/12,2040,-3,39,2076,400116,7040,8334,415490,28.68%,29.78%,
105/04/11,1970,0,-47,1923,398030,7043,8295,413368,28.53%,29.63%,
105/04/08,1419,0,-89,1330,396237,7043,8342,411622,28.40%,29.50%,
105/04/07,-162,0,-126,-288,394767,7043,8431,410241,28.29%,29.40%,
105/04/06,1849,0,-81,1768,394712,7043,8557,410312,28.29%,29.41%,
105/04/01,1879,-40,-34,1805,392892,7043,8638,408573,28.16%,29.28%,
105/03/31,1359,0,-1463,-104,391117,7083,8672,406872,28.03%,29.16%,
105/03/30,0,0,0,0,389715,7452,10135,407302,27.93%,29.19%,
105/03/29,288,0,-303,-15,389727,7452,10135,407314,27.93%,29.19%,
105/03/28,849,0,-3,846,389177,7452,10438,407067,27.89%,29.17%,
105/03/25,-23,0,-25,-48,388152,7452,10441,406045,27.82%,29.10%,
105/03/24,809,0,111,920,388117,7452,10466,406035,27.82%,29.10%,
105/03/23,1198,-18,-207,973,387208,7452,10355,405015,27.75%,29.03%,
105/03/22,99,0,-135,-36,386000,7470,10562,404032,27.66%,28.95%,
105/03/21,962,0,-112,850,385779,7470,10697,403946,27.65%,28.95%,
105/03/18,1138,10,-256,892,384991,7470,10809,403270,27.59%,28.90%,
105/03/17,1490,0,-303,1187,383634,7460,11065,402159,27.50%,28.83%,
105/03/16,1260,-13,467,1714,383447,7460,11368,402275,27.48%,28.83%,
105/03/15,1667,99,-906,860,383068,7473,10901,401442,27.45%,28.77%,
105/03/14,597,0,1251,1848,381346,7374,11807,400527,27.33%,28.70%,
105/03/11,721,0,52,773,380739,7374,10556,398669,27.29%,28.58%,
105/03/10,397,0,26,423,379968,7374,10504,397846,27.23%,28.51%,
105/03/09,-153,-6,-148,-307,379546,7374,10478,397398,27.20%,28.48%,
105/03/08,1498,-2,520,2016,379572,7380,10626,397578,27.20%,28.49%,
105/03/07,67,0,-73,-6,377906,7382,10106,395394,27.08%,28.33%,
105/03/04,1280,0,-272,1008,377654,7382,10179,395215,27.07%,28.33%,
105/03/03,-849,0,-656,-1505,376178,7382,10451,394011,26.96%,28.24%,
105/03/02,-229,-1,1110,880,376674,7382,11107,395163,27.00%,28.33%,
105/03/01,76,0,59,135,376758,7383,9997,394138,27.00%,28.25%,
105/02/26,174,0,118,292,376672,7383,9938,393993,27.00%,28.24%,
105/02/25,-1499,0,33,-1466,376365,7383,9820,393568,26.97%,28.20%,
105/02/24,-1694,0,-84,-1778,377842,7383,9787,395012,27.08%,28.31%,
105/02/23,260,-183,-27,50,379429,7383,9871,396683,27.19%,28.43%,
105/02/22,2106,0,29,2135,379007,7566,9898,396471,27.16%,28.41%,
105/02/19,-2681,2,-50,-2729,377392,7566,9869,394827,27.05%,28.30%,
105/02/18,206,0,-34,172,380049,7564,9919,397532,27.24%,28.49%,
105/02/17,-151,0,-27,-178,379791,7564,9953,397308,27.22%,28.48%,
105/02/16,877,0,208,1085,379875,7564,9980,397419,27.23%,28.49%,
105/02/15,-1370,0,-41,-1411,378928,7564,9772,396264,27.16%,28.40%,
105/02/03,186,0,23,209,380246,7564,9813,397623,27.25%,28.50%,
105/02/02,904,0,-92,812,380940,7564,9790,398294,27.30%,28.54%,
105/02/01,98,0,-65,33,380186,7564,9882,397632,27.25%,28.50%,
105/01/30,116,4,-304,-184,380003,7564,9947,397514,27.23%,28.49%,
105/01/29,3039,0,838,3877,379887,7560,10251,397698,27.23%,28.51%,
105/01/28,-635,0,-81,-716,375794,7560,9413,392767,26.93%,28.15%,
105/01/27,376,0,-17,359,376324,7560,9494,393378,26.97%,28.19%,
105/01/26,-689,20,-107,-776,375987,7560,9511,393058,26.95%,28.17%,
105/01/25,-62,-1,119,56,376645,7540,9618,393803,26.99%,28.22%,
105/01/22,503,0,46,549,376696,7541,9499,393736,27.00%,28.22%,
105/01/21,-4022,0,-66,-4088,376112,7541,9453,393106,26.96%,28.18%,
105/01/20,-943,-3,-176,-1122,380267,7541,9519,397327,27.25%,28.47%,
105/01/19,-272,48,38,-186,382322,7544,9695,399561,27.40%,28.64%,
105/01/18,638,0,63,701,382989,7496,9657,400142,27.45%,28.68%,
105/01/15,-741,-55,-408,-1204,382352,7496,9594,399442,27.40%,28.63%,
105/01/14,-1324,-40,80,-1284,384512,7550,10002,402064,27.56%,28.82%,
105/01/13,-5783,0,153,-5630,385834,7590,9922,403346,27.65%,28.91%,
105/01/12,-3144,0,-541,-3685,391541,7590,9769,408900,28.06%,29.30%,
105/01/11,-2751,-171,-51,-2973,394291,7590,10310,412191,28.26%,29.54%,
105/01/08,-3012,-170,33,-3149,396624,7761,10361,414746,28.43%,29.73%,
105/01/07,-1618,-419,309,-1728,399716,7931,10328,417975,28.65%,29.96%,
105/01/06,-2537,-340,-458,-3335,401353,8350,10019,419722,28.77%,30.09%,
105/01/05,-2166,-1,66,-2101,403822,8690,10477,422989,28.94%,30.31%,
105/01/04,-2154,-131,-74,-2359,405204,8691,10411,424306,29.04%,30.41%,
104/12/31,37,0,-7,30,406957,8822,10485,426264,29.17%,30.55%,
104/12/30,-1052,0,-81,-1133,406920,6904,10492,424316,29.16%,30.41%,
104/12/29,-1283,-125,108,-1300,407746,6904,10573,425223,29.22%,30.47%,
104/12/28,-1166,-55,2,-1219,409165,7029,10465,426659,29.33%,30.58%,
104/12/25,-317,-65,-64,-446,410282,7084,10463,427829,29.41%,30.67%,
104/12/24,-41,0,-7,-48,410692,7149,10527,428368,29.43%,30.70%,
104/12/23,-619,0,2,-617,410906,7149,10534,428589,29.45%,30.72%,
104/12/22,-643,0,-241,-884,411502,7149,10532,429183,29.49%,30.76%,
104/12/21,-1685,0,-32,-1717,412114,7149,10773,430036,29.54%,30.82%,
104/12/18,-3361,-50,9,-3402,413833,7149,10805,431787,29.66%,30.95%,
104/12/17,-2745,-59,681,-2123,417172,7199,10796,435167,29.90%,31.19%,
104/12/16,1004,-313,41,732,420554,7258,10115,437927,30.14%,31.39%,
104/12/15,-1586,-335,105,-1816,418671,7571,10074,436316,30.01%,31.27%,
104/12/14,-252,90,-62,-224,421018,7906,9969,438893,30.17%,31.45%,
104/12/11,-1821,0,95,-1726,421199,7816,10031,439046,30.19%,31.47%,
104/12/10,-2440,-6,253,-2193,423403,7816,9936,441155,30.35%,31.62%,
104/12/09,-3269,0,-311,-3580,425662,7822,9683,443167,30.51%,31.76%,
104/12/08,-2209,0,-227,-2436,428702,7822,9994,446518,30.73%,32.01%,
104/12/07,-747,-215,228,-734,430682,7822,10221,448725,30.87%,32.16%,
104/12/04,-1216,-1220,82,-2354,431419,8038,9993,449450,30.92%,32.21%,
104/12/03,-2475,-700,48,-3127,432635,9258,9911,451804,31.01%,32.38%,
104/12/02,-3285,-270,308,-3247,435153,9958,9863,454974,31.19%,32.61%,
104/12/01,-3056,-500,127,-3429,438270,10228,9555,458053,31.41%,32.83%,
104/11/30,-2894,0,-108,-3002,441326,10728,9428,461482,31.63%,33.07%,
104/11/27,-264,0,-10,-274,443990,10728,9536,464254,31.82%,33.27%,
104/11/26,1077,0,423,1500,444382,10728,9546,464656,31.85%,33.30%,
104/11/25,-3926,-626,-86,-4638,445018,10728,9123,464869,31.90%,33.32%,
104/11/24,-2989,0,-144,-3133,449166,11354,9209,469729,32.19%,33.66%,
104/11/23,-2260,-75,268,-2067,452150,11354,9353,472857,32.41%,33.89%,
104/11/20,-5746,81,304,-5361,454400,11429,9085,474914,32.57%,34.04%,
104/11/19,-4887,-984,354,-5517,460007,11348,8781,480136,32.97%,34.41%,
104/11/18,-5661,-640,-97,-6398,464485,12333,8427,485245,33.29%,34.78%,
104/11/17,-5660,-50,-14,-5724,467438,12973,8524,488935,33.50%,35.04%,
104/11/16,-3994,-690,-24,-4708,472932,13023,8539,494494,33.90%,35.45%,
104/11/13,-486,-118,28,-576,476927,13713,8563,499203,34.18%,35.78%,
104/11/12,-1811,-187,589,-1409,477466,13831,8535,499832,34.22%,35.82%,
104/11/11,460,-1271,-660,-1471,479277,14018,7946,501241,34.35%,35.92%,
104/11/10,-2065,-200,-265,-2530,478849,15289,8606,502744,34.32%,36.03%,
104/11/09,-355,-352,-60,-767,480936,15489,8871,505296,34.47%,36.22%,
104/11/06,-3086,-635,-233,-3954,481845,15841,8931,506617,34.54%,36.32%,
104/11/05,-880,-100,424,-556,484921,16476,9164,510561,34.76%,36.60%,
104/11/04,-3107,-221,68,-3260,486109,16576,8740,511425,34.84%,36.65%,
104/11/03,-1924,-476,38,-2362,489204,16797,8672,514673,35.06%,36.89%,
104/11/02,-623,-178,236,-565,491181,17274,8634,517089,35.20%,37.06%,
104/10/30,1750,-778,-85,887,491899,17452,8398,517749,35.26%,37.11%,
104/10/29,-2002,-2102,-333,-4437,490202,18229,8483,516914,35.13%,37.04%,
104/10/28,-1630,-396,1,-2025,491545,20331,8816,520692,35.23%,37.32%,
104/10/27,-1385,-1223,-65,-2673,493351,20728,8815,522894,35.36%,37.48%,
104/10/26,1265,-609,114,770,494673,21951,8880,525504,35.45%,37.66%,
104/10/23,-1919,-235,89,-2065,493390,22560,8766,524716,35.36%,37.61%,
104/10/22,-505,-329,38,-796,495435,22795,8677,526907,35.51%,37.77%,
104/10/21,-1117,-555,134,-1538,496179,23124,8639,527942,35.56%,37.84%,
104/10/20,85,-3454,-62,-3431,497073,23679,8505,529257,35.63%,37.94%,
104/10/19,-1942,-2116,-265,-4323,496990,27134,8567,532691,35.62%,38.18%,
104/10/16,1238,-606,-51,581,499048,29250,8832,537130,35.77%,38.50%,
104/10/15,880,-1413,114,-419,497941,29856,8883,536680,35.69%,38.48%,
104/10/14,465,-1342,-189,-1066,497030,31269,8769,537068,35.62%,38.50%,
104/10/13,-1693,-926,-46,-2665,496405,32611,8958,537974,35.58%,38.57%,
104/10/12,-2153,-548,-547,-3248,497872,33537,9004,540413,35.68%,38.74%,
104/10/08,-2209,0,-172,-2381,499936,34085,9551,543572,35.83%,38.97%,
104/10/07,-2656,332,731,-1593,503418,34085,9723,547226,36.08%,39.23%,
104/10/06,-1333,506,845,18,506010,33753,8992,548755,36.27%,39.34%,
104/10/05,-1109,-689,44,-1754,505939,33247,8147,547333,36.26%,39.24%,
104/10/02,524,-600,63,-13,507048,33936,8103,549087,36.34%,39.36%,
104/10/01,-460,531,116,187,506524,34536,8040,549100,36.30%,39.36%,
104/09/30,3136,0,52,3188,507084,34005,7924,549013,36.34%,39.36%,
104/09/25,148,-128,-123,-103,503946,40368,7872,552186,36.12%,39.59%,
104/09/24,-768,-233,-798,-1799,503603,40496,7995,552094,36.09%,39.58%,
104/09/23,-1117,-165,6,-1276,498930,40729,8793,548452,36.24%,39.80%,
104/09/22,52,-899,-48,-895,499814,40894,8787,549495,36.30%,39.87%,
104/09/21,-266,-532,-394,-1192,499761,41793,8835,550389,36.30%,39.94%,
104/09/18,-293,-11,144,-160,500027,42325,9229,551581,36.32%,40.03%,
104/09/17,2514,-18,94,2590,500316,42336,9085,551737,36.34%,40.04%,
104/09/16,1053,-59,-33,961,497802,42354,8991,549147,36.15%,39.84%,
104/09/15,-54,-78,43,-89,496748,42413,9024,548185,36.08%,39.78%,
104/09/14,2127,-931,53,1249,496748,42491,8981,548220,36.08%,39.78%,
104/09/11,1494,-380,-188,926,494621,43422,8928,546971,35.92%,39.68%,
104/09/10,1386,-1047,-232,107,493127,43802,9116,546045,35.81%,39.62%,
104/09/09,3998,-161,997,4834,491741,44849,9348,545938,35.71%,39.61%,
104/09/08,-422,-51,-96,-569,487743,45010,8352,541105,35.42%,39.26%,
104/09/07,440,-1592,177,-975,488165,45061,8448,541674,35.45%,39.30%,
104/09/04,2280,-1105,-195,980,487636,46653,8271,542560,35.41%,39.36%,
104/09/03,174,-606,-237,-669,484846,47758,8466,541070,35.21%,39.25%,
104/09/02,1490,29,67,1586,485098,48364,8703,542165,35.23%,39.33%,
104/09/01,2050,-95,-68,1887,483580,48335,8636,540551,35.12%,39.22%,
104/08/31,311,-24,-158,129,481387,48430,8704,538521,34.96%,39.07%,
104/08/28,671,-52,20,639,480576,48454,8862,537892,34.90%,39.02%,
104/08/27,456,-76,-598,-218,479973,48506,8842,537321,34.86%,38.98%,
104/08/26,249,419,949,1617,479517,48582,9440,537539,34.83%,39.04%,
104/08/25,1024,-179,226,1071,479389,48163,8491,536043,34.82%,38.94%,
104/08/24,997,-1528,-243,-774,478428,48342,8265,535035,34.75%,38.86%,
104/08/21,654,-1000,-574,-920,477333,49870,8508,535711,34.67%,38.91%,
104/08/20,-178,-359,-107,-644,476633,50870,9082,536585,34.62%,38.97%,
104/08/19,-2464,150,-300,-2614,476633,51229,9189,537051,34.62%,39.01%,
104/08/18,1205,-149,91,1147,479097,51079,9489,539665,34.79%,39.19%,
104/08/17,-94,150,-47,9,477892,51228,9398,538518,34.71%,39.11%,
104/08/14,-856,399,-358,-815,477501,51078,9445,538024,34.68%,39.08%,
104/08/13,1678,888,738,3304,477480,50679,9803,537962,34.68%,39.07%,
104/08/12,470,55,-439,86,475944,49791,9065,534800,34.57%,38.85%,
104/08/11,-2852,437,-126,-2541,475473,49736,9504,534713,34.53%,38.83%,
104/08/10,-756,393,208,-155,478197,49299,9630,537126,34.73%,39.01%,
104/08/07,-666,206,39,-421,478815,48906,9422,537143,34.77%,39.01%,
104/08/06,4545,-44,-280,4221,479481,48700,9383,537564,34.82%,39.04%,
104/08/05,2909,-1664,561,1806,475055,48744,9663,533462,34.50%,38.74%,
104/08/04,2078,89,-417,1750,472146,50408,9102,531656,34.29%,38.61%,
104/08/03,-346,253,-165,-258,469991,50319,9519,529829,34.13%,38.48%,
104/07/31,-467,56,-23,-434,469877,50066,9684,529627,34.13%,38.47%,
104/07/30,-1208,44,-35,-1199,470305,50010,9707,530022,34.16%,38.50%,
104/07/29,-655,271,112,-272,471321,49966,9742,531029,34.23%,38.57%,
104/07/28,161,642,206,1009,471552,49695,9630,530877,34.25%,38.56%,
104/07/27,1357,153,-949,561,471238,49053,9424,529715,34.22%,38.47%,
104/07/24,-88,-675,231,-532,469871,48900,10373,529144,34.12%,38.43%,
104/07/23,-305,252,-192,-245,469797,49575,10142,529514,34.12%,38.46%,
104/07/22,-4712,288,-689,-5113,470104,49323,10334,529761,34.14%,38.47%,
104/07/21,324,612,76,1012,474763,49035,11023,534821,34.48%,38.84%,
104/07/20,-907,202,-542,-1247,474439,48423,10947,533809,34.46%,38.77%,
104/07/17,283,-30,-101,152,475377,48221,11489,535087,34.52%,38.86%,
104/07/16,-1583,352,383,-848,475312,48251,11590,535153,34.52%,38.87%,
104/07/15,2114,197,-845,1466,476883,47899,11207,535989,34.63%,38.92%,
104/07/14,-1199,3539,-174,2166,474772,47702,12052,534526,34.48%,38.82%,
104/07/13,56,-824,-1523,-2291,476067,44163,12226,532456,34.57%,38.67%,
104/07/09,153,345,397,895,475778,44987,13749,534514,34.55%,38.82%,
104/07/08,815,93,-1865,-957,475509,44642,13352,533503,34.53%,38.74%,
104/07/07,1700,19,-507,1212,474658,44549,15217,534424,34.47%,38.81%,
104/07/06,757,230,-266,721,472972,44530,15724,533226,34.35%,38.73%,
104/07/03,216,52,-298,-30,472153,44300,15990,532443,34.29%,38.67%,
104/07/02,-1213,310,-636,-1539,471865,44248,16288,532401,34.27%,38.67%,
104/07/01,-296,2015,2057,3776,473017,43938,16924,533879,34.35%,38.77%,
104/06/30,2924,643,-1073,2494,473249,41923,14867,530039,34.37%,38.50%,
104/06/29,1416,44,-502,958,470312,35176,15940,521428,34.16%,37.87%,
104/06/26,78,419,15,512,469342,35132,16442,520916,34.09%,37.84%,
104/06/25,-237,452,873,1088,470527,34713,16427,521667,34.17%,37.88%,
104/06/24,-535,381,199,45,471796,34261,15554,521611,34.26%,37.88%,
104/06/23,-187,546,161,520,473713,33880,15355,522948,34.40%,37.98%,
104/06/22,703,520,1187,2410,473485,33334,15194,522013,34.39%,37.91%,
104/06/18,-226,166,540,480,472931,32814,14007,519752,34.35%,37.75%,
104/06/17,-177,759,124,706,473203,32648,13467,519318,34.37%,37.72%,
104/06/16,-1235,-150,475,-910,473343,31889,13343,518575,34.38%,37.67%,
104/06/15,-84,153,244,313,474626,32039,12868,519533,34.47%,37.73%,
104/06/12,1660,50,-291,1419,475487,31886,12624,519997,34.53%,37.76%,
104/06/11,-1576,-50,546,-1080,474254,31836,12915,519005,34.44%,37.69%,
104/06/10,-1067,510,212,-345,476034,31886,12369,520289,34.57%,37.78%,
104/06/09,-1364,479,-498,-1383,477146,31376,12157,520679,34.65%,37.81%,
104/06/08,-435,1041,-119,487,478834,30897,12655,522386,34.78%,37.94%,
104/06/05,915,163,-397,681,479125,29856,12774,521755,34.80%,37.90%,
104/06/04,504,926,-911,519,478009,29693,13171,520873,34.72%,37.83%,
104/06/03,3268,584,-1056,2796,477241,28767,14082,520090,34.66%,37.77%,
104/06/02,1510,1659,1159,4328,473844,28183,15138,517165,34.41%,37.56%,
104/06/01,-597,482,164,49,472311,26524,13979,512814,34.30%,37.24%,
104/05/29,-21,193,-448,-276,472897,26042,13815,512754,34.34%,37.24%,
104/05/28,-553,1495,126,1068,472918,25849,14263,513030,34.35%,37.26%,
104/05/27,-758,715,217,174,473471,24354,14137,511962,34.39%,37.19%,
104/05/26,-2076,1590,-429,-915,474219,23639,13920,511778,34.44%,37.17%,
104/05/25,-3129,3505,807,1183,476295,22049,14349,512693,34.59%,37.23%,
104/05/22,2692,344,104,3140,479424,18544,13542,511510,34.82%,37.15%,
104/05/21,-97,160,278,341,476732,18200,13438,508370,34.62%,36.92%,
104/05/20,1488,209,-551,1146,476829,18040,13160,508029,34.63%,36.90%,
104/05/19,3176,2653,-1675,4154,475351,17831,13711,506893,34.52%,36.81%,
104/05/18,4053,306,1199,5558,472175,15178,15386,502739,34.29%,36.51%,
104/05/15,1357,47,-1058,346,468174,14872,14187,497233,34.00%,36.11%,
104/05/14,1567,431,-1497,501,466817,14825,15245,496887,33.90%,36.08%,
104/05/13,1825,1071,2613,5509,465241,14394,16742,496377,33.79%,36.05%,
104/05/12,-1152,627,-493,-1018,463415,13323,14129,490867,33.66%,35.65%,
104/05/11,-13,675,2381,3043,464567,12696,14622,491885,33.74%,35.72%,
104/05/08,-825,360,-12,-477,464580,12021,12241,488842,33.74%,35.50%,
104/05/07,665,400,399,1464,465405,11661,12253,489319,33.80%,35.54%,
104/05/06,60,99,49,208,464740,11261,11854,487855,33.75%,35.43%,
104/05/05,149,-1,-132,16,464680,11162,11805,487647,33.75%,35.42%,
104/05/04,1060,5,-298,767,464531,11163,11937,487631,33.74%,35.42%,
104/04/30,-22,-1,91,68,463471,11158,12235,486864,33.66%,35.36%,
104/04/29,1641,-1,-723,917,463493,11159,12144,486796,33.66%,35.35%,
104/04/28,2235,9,-356,1888,461852,11160,12867,485879,33.54%,35.29%,
104/04/27,1043,10,1237,2290,459617,11151,13223,483991,33.38%,35.15%,
104/04/24,1246,-1,-995,250,458574,11141,11986,481701,33.30%,34.98%,
104/04/23,1097,0,732,1829,457328,11142,12981,481451,33.21%,34.96%,
104/04/22,-54,10,-535,-579,456231,11142,12249,479622,33.13%,34.83%,
104/04/21,967,-17,437,1387,456285,11132,12784,480201,33.14%,34.88%,
104/04/20,318,7,-226,99,455318,11149,12347,478814,33.07%,34.78%,
104/04/17,359,188,-86,461,455000,11142,12573,478715,33.04%,34.76%,
104/04/16,2344,239,185,2768,454640,10954,12659,478253,33.02%,34.74%,
104/04/15,541,117,-650,8,452296,10715,12474,475485,32.85%,34.53%,
104/04/14,1486,-498,234,1222,451755,10598,13124,475477,32.81%,34.53%,
104/04/13,462,18,-62,418,450269,11096,12890,474255,32.70%,34.44%,
104/04/10,1955,0,120,2075,449827,11078,12952,473857,32.67%,34.42%,
104/04/09,2252,0,-715,1537,447871,11078,12832,471781,32.53%,34.27%,
104/04/08,1510,34,-291,1253,445599,11078,13547,470224,32.36%,34.15%,
104/04/07,743,949,1746,3438,444089,11044,13838,468971,32.25%,34.06%,
104/04/02,3408,325,287,4020,443346,10095,12092,465533,32.20%,33.81%,
104/04/01,2749,0,3,2752,439948,9770,11805,461523,31.95%,33.52%,
104/03/31,5089,-374,-365,4350,437199,9770,11802,458771,31.75%,33.32%,
104/03/30,1650,507,330,2487,432100,10966,12167,455233,31.38%,33.06%,
104/03/27,-1985,0,-164,-2149,430450,10459,11837,452746,31.26%,32.88%,
104/03/26,-1231,124,731,-376,432445,10459,12001,454905,31.41%,33.04%,
104/03/25,-483,79,-168,-572,433676,10335,11270,455281,31.50%,33.07%,
104/03/24,-790,368,-220,-642,434159,10256,11438,455853,31.53%,33.11%,
104/03/23,-1590,399,-471,-1662,434949,9888,11658,456495,31.59%,33.16%,
104/03/20,1192,878,727,2797,436528,9489,12129,458146,31.70%,33.27%,
104/03/19,-1211,49,959,-203,435258,8611,11402,455271,31.61%,33.06%,
104/03/18,-771,0,-173,-944,436624,8562,10443,455629,31.71%,33.09%,
104/03/17,-117,-142,-56,-315,437300,8562,10616,456478,31.76%,33.15%,
104/03/16,-579,190,-157,-546,437209,8704,10672,456585,31.75%,33.16%,
104/03/13,-1887,-104,19,-1972,437790,8514,10829,457133,31.79%,33.20%,
104/03/12,-337,-724,192,-869,439831,8618,10810,459259,31.94%,33.35%,
104/03/11,-1327,-1013,34,-2306,440155,9343,10618,460116,31.97%,33.42%,
104/03/10,-1524,312,-247,-1459,441340,10356,10584,462280,32.05%,33.57%,
104/03/09,-884,14,-156,-1026,442874,10044,10831,463749,32.16%,33.68%,
104/03/06,-403,116,140,-147,443784,10030,10987,464801,32.23%,33.76%,
104/03/05,-1288,-1,720,-569,444106,9914,10847,464867,32.25%,33.76%,
104/03/04,-815,-377,559,-633,445393,9915,10127,465435,32.35%,33.81%,
104/03/03,-1104,-641,-37,-1782,446208,10292,9569,466069,32.41%,33.85%,
104/03/02,-2283,0,-13,-2296,447312,10933,9606,467851,32.49%,33.98%,
104/02/26,-235,-6,-8,-249,449721,10933,9619,470273,32.66%,34.15%,
104/02/25,206,-872,92,-574,449946,10939,9627,470512,32.68%,34.17%,
104/02/24,108,-160,-307,-359,449644,11811,9535,470990,32.66%,34.21%,
104/02/13,311,-1,-399,-89,449537,11971,9842,471350,32.65%,34.23%,
104/02/12,-147,-648,-69,-864,449225,11972,10241,471438,32.62%,34.23%,
104/02/11,-1605,-390,-507,-2502,449373,12620,10310,472303,32.64%,34.31%,
104/02/10,-9,-10,-107,-126,450977,13010,10817,474804,32.75%,34.48%,
104/02/09,-1293,-678,-272,-2243,450877,13020,10924,474821,32.74%,34.48%,
104/02/06,-1757,-87,-207,-2051,452190,13698,11196,477084,32.84%,34.65%,
104/02/05,966,-479,-257,230,453937,13785,11403,479125,32.97%,34.80%,
104/02/04,118,-712,-113,-707,452964,14264,11659,478887,32.90%,34.78%,
104/02/03,-1055,-700,-938,-2693,452791,14976,11773,479540,32.88%,34.82%,
104/02/02,-136,-20,150,-6,453847,15676,12711,482234,32.96%,35.02%,
104/01/30,632,-27,-39,566,453875,15696,12561,482132,32.96%,35.01%,
104/01/29,33,0,-182,-149,453243,15723,12600,481566,32.92%,34.98%,
104/01/28,1257,0,47,1304,453209,15723,12782,481714,32.91%,34.98%,
104/01/27,280,281,555,1116,451952,15723,12735,480410,32.82%,34.89%,
104/01/26,1526,126,682,2334,451673,15442,12180,479295,32.80%,34.81%,
104/01/23,135,621,447,1203,450094,15316,11498,476908,32.69%,34.64%,
104/01/22,39,1193,28,1260,449906,14695,11051,475652,32.67%,34.54%,
104/01/21,582,-160,74,496,449867,13502,11023,474392,32.67%,34.45%,
104/01/20,-49,-192,131,-110,449290,13662,10949,473901,32.63%,34.42%,
104/01/19,1749,-209,-496,1044,449313,13854,10818,473985,32.63%,34.42%,
104/01/16,595,0,-199,396,447564,14063,11314,472941,32.50%,34.34%,
104/01/15,2380,-446,-191,1743,447298,14063,11513,472874,32.48%,34.34%,
104/01/14,-239,-65,-496,-800,444918,14509,11704,471131,32.31%,34.21%,
104/01/13,3167,-75,341,3433,445128,14574,12200,471902,32.33%,34.27%,
104/01/12,79,-180,-724,-825,441961,14649,11859,468469,32.10%,34.03%,
104/01/09,888,0,1164,2052,442257,14829,12583,469669,32.12%,34.11%,
104/01/08,413,-300,231,344,441244,14829,11419,467492,32.05%,33.96%,
104/01/07,300,-300,-338,-338,440832,15129,11188,467149,32.02%,33.93%,
104/01/06,-1322,0,-433,-1755,440532,15429,11526,467487,31.99%,33.95%,
104/01/05,753,0,-153,600,441704,15429,11959,469092,32.08%,34.07%,
