日期,外資買賣超,投信買賣超,自營商買賣超,單日合計買賣超,外資估計持股,投信估計持股,自營商估計持股,單日合計估計持股,外資持股比重,三大法人持股比重,
107/03/31,-62,0,-14,-76,43280,49,3461,46790,15.39%,16.64%,
107/03/30,-561,-8,22,-547,43342,49,3475,46866,15.41%,16.66%,
107/03/29,-219,0,-89,-308,43953,57,3453,47463,15.63%,16.88%,
107/03/28,-22,0,-28,-50,44177,57,3542,47776,15.71%,16.99%,
107/03/27,-137,-0,-158,-295,44282,57,3570,47909,15.75%,17.04%,
107/03/26,-342,0,172,-170,44384,57,3728,48169,15.79%,17.14%,
107/03/23,-292,0,-56,-348,44826,57,3556,48439,15.94%,17.23%,
107/03/22,-756,4,-587,-1339,45120,57,3612,48789,16.05%,17.36%,
107/03/21,1090,0,371,1461,45866,53,4199,50118,16.31%,17.82%,
107/03/20,320,0,59,379,45343,53,3828,49224,16.13%,17.51%,
107/03/19,465,0,-145,320,45080,53,3769,48902,16.03%,17.39%,
107/03/16,22,3,-44,-19,44606,53,3914,48573,15.86%,17.27%,
107/03/15,274,0,774,1048,44554,50,3958,48562,15.85%,17.28%,
107/03/14,-30,0,-213,-243,44127,50,3184,47361,15.69%,16.84%,
107/03/13,105,0,527,632,44364,50,3397,47811,15.78%,17.01%,
107/03/12,38,0,-112,-74,44259,50,2870,47179,15.74%,16.78%,
107/03/09,-815,4,101,-710,44121,50,2982,47153,15.69%,16.77%,
107/03/08,-295,0,117,-178,44726,46,2881,47653,15.91%,16.95%,
107/03/07,-1196,0,-249,-1445,44901,46,2764,47711,15.97%,16.97%,
107/03/06,-227,0,-242,-469,46098,46,3013,49157,16.39%,17.48%,
107/03/05,-364,0,255,-109,46316,46,3255,49617,16.47%,17.64%,
107/03/02,-387,0,-292,-679,46313,46,3000,49359,16.47%,17.55%,
107/03/01,-1193,0,-22,-1215,46678,46,3292,50016,16.60%,17.79%,
107/02/27,796,3,817,1616,47963,46,3314,51323,17.06%,18.26%,
107/02/26,-144,5,-166,-305,47483,43,2497,50023,16.89%,17.79%,
107/02/23,-570,10,32,-528,47516,38,2663,50217,16.90%,17.86%,
107/02/22,-375,0,22,-353,48086,28,2631,50745,17.10%,18.05%,
107/02/21,-438,0,131,-307,48284,28,2609,50921,17.17%,18.11%,
107/02/12,-2492,0,-79,-2571,48523,28,2478,51029,17.26%,18.15%,
107/02/09,-274,0,-182,-456,50915,28,2557,53500,18.11%,19.03%,
107/02/08,-1239,0,-177,-1416,51139,28,2739,53906,18.19%,19.17%,
107/02/07,-1354,0,-32,-1386,52378,28,2916,55322,18.63%,19.68%,
107/02/06,-573,0,-726,-1299,53282,28,2948,56258,18.95%,20.01%,
107/02/05,430,0,-134,296,53894,28,3674,57596,19.17%,20.49%,
107/02/02,46,0,52,98,53464,28,3808,57300,19.02%,20.38%,
107/02/01,-817,0,358,-459,53452,28,3756,57236,19.01%,20.36%,
107/01/31,-611,0,-151,-762,54149,28,3398,57575,19.26%,20.48%,
107/01/30,56,0,-173,-117,54755,28,3549,58332,19.48%,20.75%,
107/01/29,1331,0,726,2057,54571,28,3722,58321,19.41%,20.74%,
107/01/26,-496,0,50,-446,53230,28,2996,56254,18.93%,20.01%,
107/01/25,999,0,-112,887,53900,28,2946,56874,19.17%,20.23%,
107/01/24,2124,0,1394,3518,53253,28,3058,56339,18.94%,20.04%,
107/01/23,86,0,-111,-25,51129,28,1664,52821,18.18%,18.78%,
107/01/22,952,0,82,1034,51042,28,1775,52845,18.15%,18.79%,
107/01/19,-659,0,-277,-936,50090,28,1693,51811,17.82%,18.43%,
107/01/18,-548,0,-113,-661,50749,28,1970,52747,18.05%,18.76%,
107/01/17,465,0,71,536,51297,28,2083,53408,18.24%,18.99%,
107/01/16,314,0,243,557,50804,28,2012,52844,18.07%,18.80%,
107/01/15,-180,0,-30,-210,50484,28,1769,52281,17.96%,18.60%,
107/01/12,74,0,354,428,50664,28,1799,52491,18.02%,18.67%,
107/01/11,-529,0,111,-418,50673,28,1445,52146,18.02%,18.54%,
107/01/10,-430,0,38,-392,51222,28,1334,52584,18.22%,18.70%,
107/01/09,-333,0,-167,-500,51572,28,1296,52896,18.34%,18.81%,
107/01/08,75,0,-75,0,52242,28,1463,53733,18.58%,19.11%,
107/01/05,-163,0,221,58,52157,28,1538,53723,18.55%,19.11%,
107/01/04,75,0,43,118,52439,28,1317,53784,18.65%,19.13%,
107/01/03,-311,0,5,-306,52396,28,1274,53698,18.64%,19.10%,
107/01/02,702,0,116,818,53238,28,1269,54535,18.94%,19.40%,
106/12/29,-401,0,1,-400,52542,28,1153,53723,18.69%,19.11%,
106/12/28,-165,-9,38,-136,53015,10,1152,54177,18.86%,19.27%,
106/12/27,943,-8,-5,930,52980,19,1114,54113,18.84%,19.24%,
106/12/26,78,0,-330,-252,52169,27,1119,53315,18.56%,18.97%,
106/12/25,-29,0,-200,-229,52082,27,1449,53558,18.52%,19.05%,
106/12/22,408,0,30,438,52111,27,1649,53787,18.53%,19.13%,
106/12/21,-181,0,-242,-423,51940,27,1619,53586,18.47%,19.06%,
106/12/20,1063,0,112,1175,52074,27,1861,53962,18.52%,19.19%,
106/12/19,-474,0,-232,-706,50954,27,1749,52730,18.12%,18.75%,
106/12/18,-531,0,-199,-730,51365,27,1981,53373,18.27%,18.98%,
106/12/15,23,22,-75,-30,51887,27,2180,54094,18.45%,19.24%,
106/12/14,-527,0,178,-349,51840,5,2255,54100,18.44%,19.24%,
106/12/13,-470,0,4,-466,52467,5,2077,54549,18.66%,19.40%,
106/12/12,-253,0,457,204,53512,5,2073,55590,19.03%,19.77%,
106/12/11,438,0,8,446,53650,5,1616,55271,19.08%,19.66%,
106/12/08,-38,0,-7,-45,53275,5,1608,54888,18.95%,19.52%,
106/12/07,664,0,-7,657,53404,5,1615,55024,18.99%,19.57%,
106/12/06,1446,0,-50,1396,53124,5,1622,54751,18.89%,19.47%,
106/12/05,360,-78,-123,159,51678,5,1672,53355,18.38%,18.98%,
106/12/04,-381,0,17,-364,51313,83,1795,53191,18.25%,18.92%,
106/12/01,-18,0,-8,-26,51631,83,1778,53492,18.36%,19.02%,
106/11/30,-323,0,-78,-401,51842,83,1786,53711,18.44%,19.10%,
106/11/29,-424,0,-113,-537,52165,83,1864,54112,18.55%,19.24%,
106/11/28,554,0,-621,-67,52539,83,1977,54599,18.69%,19.42%,
106/11/27,-236,0,10,-226,51356,83,2598,54037,18.27%,19.22%,
106/11/24,-173,0,-21,-194,51592,83,2588,54263,18.35%,19.30%,
106/11/23,-108,0,-119,-227,51658,83,2609,54350,18.37%,19.33%,
106/11/22,113,0,404,517,51774,83,2728,54585,18.41%,19.41%,
106/11/21,-683,0,-99,-782,51659,83,2324,54066,18.37%,19.23%,
106/11/20,-570,0,150,-420,52361,83,2423,54867,18.62%,19.51%,
106/11/17,2614,0,186,2800,52822,83,2273,55178,18.79%,19.63%,
106/11/16,-214,0,-66,-280,50219,83,2087,52389,17.86%,18.63%,
106/11/15,188,0,-236,-48,50456,83,2153,52692,17.95%,18.75%,
106/11/14,-140,0,317,177,50266,83,2389,52738,17.88%,18.76%,
106/11/13,-409,6,-98,-501,50406,83,2072,52561,17.93%,18.70%,
106/11/10,-2,2,28,28,50771,77,2170,53018,18.06%,18.86%,
106/11/09,294,2,-98,198,50907,75,2142,53124,18.11%,18.90%,
106/11/08,-61,1,-7,-67,50630,73,2240,52943,18.01%,18.83%,
106/11/07,908,0,91,999,50403,72,2247,52722,17.93%,18.76%,
106/11/06,57,0,-9,48,49495,72,2156,51723,17.60%,18.39%,
106/11/03,307,0,-158,149,49438,72,2165,51675,17.58%,18.38%,
106/11/02,-49,0,11,-38,49147,72,2323,51542,17.48%,18.33%,
106/11/01,-898,0,-137,-1035,49196,72,2312,51580,17.50%,18.35%,
106/10/31,-470,0,150,-320,49989,72,2449,52510,17.78%,18.68%,
106/10/30,-1347,0,-321,-1668,50349,72,2299,52720,17.91%,18.75%,
106/10/27,-1559,0,-342,-1901,51665,72,2620,54357,18.38%,19.34%,
106/10/26,312,0,237,549,53213,72,2962,56247,18.93%,20.01%,
106/10/25,-1838,0,-111,-1949,52724,72,2725,55521,18.75%,19.75%,
106/10/24,111,0,316,427,54452,72,2836,57360,19.37%,20.40%,
106/10/23,-195,0,-219,-414,54116,72,2520,56708,19.25%,20.17%,
106/10/20,-2384,0,-313,-2697,54335,72,2739,57146,19.33%,20.33%,
106/10/19,-464,-1,478,13,56449,72,3052,59573,20.08%,21.19%,
106/10/18,340,0,-267,73,56474,73,2574,59121,20.09%,21.03%,
106/10/17,1322,0,-152,1170,56379,73,2841,59293,20.05%,21.09%,
106/10/16,-2217,0,5,-2212,55168,73,2993,58234,19.62%,20.71%,
106/10/13,-463,0,-27,-490,57134,73,2988,60195,20.32%,21.41%,
106/10/12,-461,0,9,-452,57342,73,3015,60430,20.40%,21.50%,
106/10/11,1103,0,-1077,26,57464,73,3006,60543,20.44%,21.54%,
106/10/06,-1663,0,-145,-1808,56260,73,4083,60416,20.01%,21.49%,
106/10/05,-223,0,493,270,57790,73,4228,62091,20.55%,22.08%,
106/10/03,2339,67,511,2917,57698,73,3735,61506,20.52%,21.87%,
106/10/02,-196,0,50,-146,55359,6,3224,58589,19.69%,20.84%,
106/09/30,-20,0,88,68,55555,6,3174,58735,19.76%,20.89%,
106/09/29,-448,0,145,-303,55575,0,3086,58661,19.77%,20.87%,
106/09/28,-964,0,-359,-1323,56203,0,2941,59144,19.99%,21.04%,
106/09/27,2500,0,728,3228,57099,0,3300,60399,20.31%,21.48%,
106/09/26,-1454,0,-389,-1843,54599,0,2572,57171,19.42%,20.34%,
106/09/25,1315,0,-500,815,56051,0,2961,59012,19.94%,20.99%,
106/09/22,-1229,0,-250,-1479,54636,0,3461,58097,19.43%,20.66%,
106/09/21,-503,0,403,-100,55710,0,3711,59421,19.81%,21.13%,
106/09/20,-390,0,-354,-744,56631,0,3308,59939,20.14%,21.32%,
106/09/19,-497,0,-418,-915,57107,0,3662,60769,20.31%,21.61%,
106/09/18,-535,0,295,-240,57855,0,4080,61935,20.58%,22.03%,
106/09/15,-520,0,191,-329,58448,0,3785,62233,20.79%,22.14%,
106/09/14,1299,0,-213,1086,58880,0,3594,62474,20.94%,22.22%,
106/09/13,-2908,0,-173,-3081,57748,0,3807,61555,20.54%,21.89%,
106/09/12,-92,0,-288,-380,60628,0,3980,64608,21.56%,22.98%,
106/09/11,-309,0,-319,-628,60645,0,4268,64913,21.57%,23.09%,
106/09/08,-297,-2,-184,-483,60689,0,4587,65276,21.59%,23.22%,
106/09/07,30,0,29,59,61010,0,4771,65781,21.70%,23.40%,
106/09/06,489,0,51,540,60965,0,4742,65707,21.68%,23.37%,
106/09/05,-148,0,21,-127,60475,0,4691,65166,21.51%,23.18%,
106/09/04,-119,0,11,-108,60643,0,4670,65313,21.57%,23.23%,
106/09/01,-57,0,463,406,60764,0,4659,65423,21.61%,23.27%,
106/08/31,-193,0,152,-41,60813,0,4196,65009,21.63%,23.12%,
106/08/30,114,0,-17,97,61006,0,4044,65050,21.70%,23.14%,
106/08/29,175,0,-64,111,61092,0,4061,65153,21.73%,23.17%,
106/08/28,140,0,433,573,60907,0,4125,65032,21.66%,23.13%,
106/08/25,624,0,209,833,60767,0,3692,64459,21.61%,22.92%,
106/08/24,-1052,-3,-388,-1443,60141,0,3483,63624,21.39%,22.63%,
106/08/23,-547,-4,-827,-1378,60330,3,3871,64204,21.46%,22.84%,
106/08/22,-821,0,356,-465,60917,7,4698,65622,21.67%,23.34%,
106/08/21,-518,0,8,-510,61738,7,4342,66087,21.96%,23.51%,
106/08/18,-420,0,35,-385,62267,7,4334,66608,22.15%,23.69%,
106/08/17,-110,0,373,263,62687,7,4299,66993,22.30%,23.83%,
106/08/16,148,0,-74,74,62797,7,3926,66730,22.34%,23.74%,
106/08/15,351,0,49,400,62438,7,4000,66445,22.21%,23.64%,
106/08/14,-420,0,-274,-694,62087,7,3951,66045,22.08%,23.49%,
106/08/11,-88,0,77,-11,62514,7,4225,66746,22.24%,23.75%,
106/08/10,34,0,-142,-108,62607,7,4148,66762,22.27%,23.75%,
106/08/09,-16,0,148,132,62579,7,4290,66876,22.26%,23.79%,
106/08/08,2210,0,238,2448,62603,7,4142,66752,22.27%,23.75%,
106/08/07,-1,0,-355,-356,61843,7,3904,65754,22.00%,23.39%,
106/08/04,-717,0,-598,-1315,61843,7,4259,66109,22.00%,23.52%,
106/08/03,-1087,0,-116,-1203,62660,7,4857,67524,22.29%,24.02%,
106/08/02,2847,0,356,3203,63501,7,4973,68481,22.59%,24.36%,
106/08/01,1250,-1,-504,745,60619,7,4617,65243,21.56%,23.21%,
106/07/31,1397,0,332,1729,59315,8,5121,64444,21.10%,22.92%,
106/07/28,3503,0,-682,2821,57854,8,4789,62651,20.58%,22.29%,
106/07/27,1888,0,409,2297,54585,8,5471,60064,19.41%,21.36%,
106/07/26,942,0,-513,429,52680,8,5062,57750,18.74%,20.54%,
106/07/25,-7,0,-424,-431,51288,8,5575,56871,18.24%,20.23%,
106/07/24,776,0,2228,3004,51145,8,5999,57152,18.19%,20.33%,
106/07/21,153,0,-470,-317,50427,8,3771,54206,17.94%,19.28%,
106/07/20,49,0,315,364,50407,8,4241,54656,17.93%,19.44%,
106/07/19,260,0,431,691,50417,8,3926,54351,17.93%,19.33%,
106/07/18,119,0,-244,-125,50169,8,3495,53672,17.84%,19.09%,
106/07/17,-224,0,436,212,50309,8,3739,54056,17.89%,19.22%,
106/07/14,89,0,-39,50,50532,8,3303,53843,17.97%,19.15%,
106/07/13,450,0,-176,274,50443,8,3342,53793,17.94%,19.13%,
106/07/12,-331,0,67,-264,49993,8,3518,53519,17.78%,19.03%,
106/07/11,38,0,213,251,50324,8,3451,53783,17.90%,19.13%,
106/07/10,-171,0,-106,-277,49735,8,3238,52981,17.69%,18.84%,
106/07/07,-235,0,-276,-511,49646,8,3344,52998,17.66%,18.85%,
106/07/06,92,0,-68,24,49948,8,3620,53576,17.76%,19.05%,
106/07/05,74,0,408,482,49996,8,3688,53692,17.78%,19.09%,
106/07/04,140,0,133,273,50088,8,3280,53376,17.81%,18.98%,
106/07/03,-98,0,-8,-106,49948,8,3147,53103,17.76%,18.88%,
106/06/30,222,-1,-200,21,50046,8,3155,53209,17.80%,18.93%,
106/06/29,4,0,26,30,49924,0,3355,53279,17.76%,18.95%,
106/06/28,-64,0,-272,-336,49870,0,3329,53199,17.74%,18.92%,
106/06/27,-218,0,166,-52,50814,0,3601,54415,18.07%,19.35%,
106/06/26,284,0,206,490,51032,0,3436,54468,18.15%,19.37%,
106/06/23,164,0,-33,131,50748,0,3230,53978,18.05%,19.20%,
106/06/22,74,0,-135,-61,50584,0,3263,53847,17.99%,19.15%,
106/06/21,267,0,273,540,50454,0,3398,53852,17.94%,19.15%,
106/06/20,-106,0,-122,-228,50241,0,3125,53366,17.87%,18.98%,
106/06/19,-831,0,466,-365,50347,0,3247,53594,17.91%,19.07%,
106/06/16,3239,0,31,3270,51178,0,2781,53959,18.20%,19.19%,
106/06/15,106,0,-104,2,48130,0,2750,50880,17.12%,18.10%,
106/06/14,606,0,18,624,49056,0,2854,51910,17.45%,18.47%,
106/06/13,583,0,52,635,48450,0,2836,51286,17.23%,18.24%,
106/06/12,335,0,-161,174,47685,0,2784,50469,16.96%,17.95%,
106/06/09,-553,0,-525,-1078,47335,0,2945,50280,16.84%,17.89%,
106/06/08,-103,0,293,190,47888,0,3470,51358,17.03%,18.26%,
106/06/07,-1016,0,618,-398,47991,0,3177,51168,17.07%,18.20%,
106/06/06,-18,-16,33,-1,49038,0,2559,51597,17.44%,18.35%,
106/06/05,958,-11,-65,882,49225,0,2526,51751,17.51%,18.41%,
106/06/03,0,0,-3,-3,48267,7,2591,50865,17.17%,18.09%,
106/06/02,-533,0,109,-424,48267,7,2594,50868,17.17%,18.10%,
106/06/01,495,0,98,593,48655,7,2485,51147,17.30%,18.19%,
106/05/31,306,0,29,335,48160,7,2387,50554,17.13%,17.98%,
106/05/26,-439,0,-65,-504,47854,7,2358,50219,17.02%,17.86%,
106/05/25,-322,0,93,-229,48329,7,2423,50759,17.19%,18.05%,
106/05/24,354,0,112,466,48783,7,2330,51120,17.35%,18.18%,
106/05/23,-70,0,-97,-167,48439,7,2218,50664,17.23%,18.02%,
106/05/22,4,0,-57,-53,48909,7,2315,51231,17.40%,18.23%,
106/05/19,-64,0,-85,-149,48936,7,2372,51315,17.40%,18.25%,
106/05/18,337,0,-12,325,48958,7,2457,51422,17.41%,18.29%,
106/05/17,-619,0,125,-494,48521,7,2469,50997,17.26%,18.14%,
106/05/16,27,0,126,153,48972,7,2344,51323,17.42%,18.26%,
106/05/15,106,0,130,236,48945,7,2218,51170,17.41%,18.20%,
106/05/12,-10,0,-356,-366,48847,7,2088,50942,17.37%,18.12%,
106/05/11,-1051,0,-873,-1924,48827,7,2444,51278,17.37%,18.24%,
106/05/10,1642,0,1356,2998,51378,7,3317,54702,18.27%,19.45%,
106/05/09,740,0,-392,348,49736,7,1961,51704,17.69%,18.39%,
106/05/08,134,0,22,156,48196,7,2353,50556,17.14%,17.98%,
106/05/05,-198,0,38,-160,48062,7,2331,50400,17.09%,17.92%,
106/05/04,988,0,-153,835,48173,7,2293,50473,17.13%,17.95%,
106/05/03,1311,0,39,1350,47275,7,2446,49728,16.81%,17.68%,
106/05/02,1201,0,-509,692,46356,7,2407,48770,16.49%,17.35%,
106/04/28,-779,0,17,-762,45888,7,2916,48811,16.32%,17.36%,
106/04/27,658,0,328,986,46834,7,2899,49740,16.66%,17.69%,
106/04/26,1399,0,-3,1396,46176,7,2571,48754,16.42%,17.34%,
106/04/25,-1262,2,-801,-2061,44754,7,2574,47335,15.92%,16.84%,
106/04/24,652,0,826,1478,45876,5,3375,49256,16.32%,17.52%,
106/04/21,624,0,-148,476,45013,5,2549,47567,16.01%,16.92%,
106/04/20,296,0,-314,-18,44463,5,2697,47165,15.81%,16.77%,
106/04/19,-371,0,-130,-501,44082,5,3011,47098,15.68%,16.75%,
106/04/18,214,0,-6,208,44053,5,3141,47199,15.67%,16.79%,
106/04/17,706,0,-156,550,43695,5,3147,46847,15.54%,16.66%,
106/04/14,-86,-2,-461,-549,42770,5,3303,46078,15.21%,16.39%,
106/04/13,-131,0,-670,-801,42729,7,3764,46500,15.20%,16.54%,
106/04/12,-1067,0,-265,-1332,42006,7,4434,46447,14.94%,16.52%,
106/04/11,16,0,368,384,42670,7,4699,47376,15.18%,16.85%,
106/04/10,149,0,-120,29,40454,7,4331,44792,14.39%,15.93%,
106/04/07,195,0,-140,55,40292,7,4451,44750,14.33%,15.92%,
106/04/06,-735,0,-630,-1365,40097,7,4591,44695,14.26%,15.90%,
106/04/05,670,0,902,1572,40762,7,5221,45990,14.50%,16.36%,
106/03/31,644,0,255,899,40093,7,4319,44419,14.26%,15.80%,
106/03/30,-188,0,-169,-357,39449,40,4064,43553,14.03%,15.49%,
106/03/29,961,0,76,1037,39607,40,4233,43880,14.09%,15.61%,
106/03/28,62,0,-587,-525,38646,40,4157,42843,13.74%,15.23%,
106/03/27,-203,-5,37,-171,38584,40,4744,43368,13.72%,15.42%,
106/03/24,124,0,-74,50,38787,45,4707,43539,13.79%,15.48%,
106/03/23,-1090,0,-550,-1640,38558,45,4781,43384,13.71%,15.43%,
106/03/22,-49,0,-80,-129,39553,45,5331,44929,14.07%,15.98%,
106/03/21,-753,-7,759,-1,39643,45,5411,45099,14.10%,16.04%,
106/03/20,24,-4,33,53,40396,52,4652,45100,14.37%,16.04%,
106/03/17,308,0,-110,198,40299,56,4619,44974,14.33%,15.99%,
106/03/16,147,0,-3,144,39972,56,4729,44757,14.22%,15.92%,
106/03/15,256,0,-166,90,39901,56,4732,44689,14.19%,15.89%,
106/03/14,440,0,84,524,39625,56,4898,44579,14.09%,15.85%,
106/03/13,-1366,0,-1141,-2507,39185,56,4814,44055,13.94%,15.67%,
106/03/10,-492,0,1212,720,40545,56,5955,46556,14.42%,16.56%,
106/03/09,-8,0,-444,-452,41024,56,4743,45823,14.59%,16.30%,
106/03/08,23,0,878,901,41032,56,5187,46275,14.59%,16.46%,
106/03/07,-4,0,-71,-75,41009,56,4309,45374,14.58%,16.13%,
106/03/06,190,0,250,440,40813,56,4380,45249,14.51%,16.09%,
106/03/03,-653,0,34,-619,40661,56,4130,44847,14.46%,15.95%,
106/03/02,700,0,102,802,41444,56,4096,45596,14.74%,16.22%,
106/03/01,834,0,-130,704,40546,56,3994,44596,14.42%,15.86%,
106/02/24,257,0,311,568,39712,56,4124,43892,14.12%,15.61%,
106/02/23,29,0,51,80,39455,56,3813,43324,14.03%,15.41%,
106/02/22,-301,0,-75,-376,39443,56,3762,43261,14.03%,15.39%,
106/02/21,-103,0,-272,-375,39667,56,3837,43560,14.11%,15.50%,
106/02/20,-386,0,-24,-410,39530,56,4109,43695,14.06%,15.54%,
106/02/18,665,0,329,994,39975,56,4133,44164,14.22%,15.71%,
106/02/17,653,0,264,917,39310,56,3804,43170,13.98%,15.35%,
106/02/16,-279,0,-172,-451,38657,56,3540,42253,13.75%,15.03%,
106/02/15,-776,0,-360,-1136,38936,56,3712,42704,13.85%,15.19%,
106/02/14,242,0,521,763,39712,56,4072,43840,14.12%,15.59%,
106/02/13,69,0,-106,-37,39470,56,3551,43077,14.04%,15.32%,
106/02/10,-409,0,355,-54,39401,56,3657,43114,14.01%,15.33%,
106/02/09,65,0,670,735,39810,56,3302,43168,14.16%,15.35%,
106/02/08,195,0,-37,158,39967,56,2632,42655,14.21%,15.17%,
106/02/07,269,0,63,332,39772,56,2669,42497,14.14%,15.11%,
106/02/06,658,0,-109,549,39503,56,2606,42165,14.05%,15.00%,
106/02/03,-515,6,-643,-1152,38850,56,2715,41621,13.82%,14.81%,
106/02/02,-23,0,974,951,39365,50,3358,42773,14.00%,15.21%,
106/01/24,460,0,253,713,39388,50,2384,41822,14.01%,14.88%,
106/01/23,-527,0,-198,-725,38928,50,2131,41109,13.84%,14.62%,
106/01/20,1185,0,-63,1122,39319,50,2329,41698,13.98%,14.83%,
106/01/19,-298,0,-924,-1222,38085,50,2392,40527,13.54%,14.41%,
106/01/18,-698,0,184,-514,38383,50,3316,41749,13.65%,14.85%,
106/01/17,1445,0,645,2090,39081,50,3132,42263,13.90%,15.03%,
106/01/16,-67,0,450,383,37636,50,2487,40173,13.38%,14.28%,
106/01/13,55,0,96,151,37703,50,2037,39790,13.41%,14.15%,
106/01/12,-15,0,31,16,37648,50,1941,39639,13.39%,14.10%,
106/01/11,42,0,-27,15,37663,50,1910,39623,13.39%,14.09%,
106/01/10,95,0,4,99,37621,50,1937,39608,13.38%,14.09%,
106/01/09,-49,0,-51,-100,37526,50,1933,39509,13.35%,14.06%,
106/01/06,363,13,278,654,37499,50,1984,39533,13.34%,14.06%,
106/01/05,199,13,17,229,37126,37,1706,38869,13.20%,13.82%,
106/01/04,176,0,-65,111,36927,24,1689,38640,13.13%,13.74%,
106/01/03,180,0,42,222,36751,24,1754,38529,13.07%,13.70%,
105/12/30,158,0,23,181,36571,24,1712,38307,13.01%,13.63%,
105/12/29,184,0,-3,181,36413,24,1689,38126,12.95%,13.56%,
105/12/28,143,0,-17,126,36259,24,1692,37975,12.89%,13.50%,
105/12/27,19,0,-10,9,36116,24,1709,37849,12.84%,13.46%,
105/12/26,2,0,-41,-39,36097,24,1719,37840,12.84%,13.46%,
105/12/23,-54,0,4,-50,36095,24,1760,37879,12.84%,13.47%,
105/12/22,15,0,34,49,36149,24,1756,37929,12.86%,13.49%,
105/12/21,47,0,-99,-52,36134,24,1722,37880,12.85%,13.47%,
105/12/20,174,0,-97,77,36087,24,1821,37932,12.83%,13.49%,
105/12/19,-6,0,-81,-87,35913,24,1918,37855,12.77%,13.46%,
105/12/16,97,0,130,227,35919,24,1999,37942,12.77%,13.49%,
105/12/15,275,0,0,275,35822,24,1869,37715,12.74%,13.41%,
105/12/14,129,0,-72,57,35547,24,1869,37440,12.64%,13.31%,
105/12/13,53,0,-118,-65,35478,24,1941,37443,12.62%,13.32%,
105/12/12,7,0,-163,-156,35425,24,2059,37508,12.60%,13.34%,
105/12/09,297,0,414,711,35418,24,2222,37664,12.60%,13.40%,
105/12/08,239,0,12,251,35121,24,1808,36953,12.49%,13.14%,
105/12/07,234,0,63,297,34882,24,1796,36702,12.40%,13.05%,
105/12/06,361,0,4,365,34648,24,1733,36405,12.32%,12.95%,
105/12/05,-4,0,46,42,34287,24,1729,36040,12.19%,12.81%,
105/12/02,202,0,-26,176,34291,24,1683,35998,12.19%,12.80%,
105/12/01,75,0,-9,66,34089,24,1709,35822,12.12%,12.74%,
105/11/30,168,0,-23,145,34014,24,1718,35756,12.10%,12.72%,
105/11/29,115,0,46,161,33836,24,1741,35601,12.03%,12.66%,
105/11/28,25,0,80,105,33721,24,1695,35440,11.99%,12.60%,
105/11/25,64,0,144,208,33686,24,1615,35325,11.98%,12.56%,
105/11/24,14,0,-8,6,33622,24,1471,35117,11.96%,12.49%,
105/11/23,-126,0,19,-107,33608,24,1479,35111,11.95%,12.48%,
105/11/22,262,0,204,466,33734,24,1460,35218,12.00%,12.53%,
105/11/21,10,0,17,27,33462,24,1256,34742,11.90%,12.36%,
105/11/18,202,0,-2,200,33702,24,1239,34965,11.98%,12.43%,
105/11/17,-6,0,-5,-11,33510,24,1241,34775,11.92%,12.37%,
105/11/16,-12,0,-1,-13,33516,24,1246,34786,11.92%,12.37%,
105/11/15,-70,0,1,-69,33528,24,1247,34799,11.92%,12.37%,
105/11/14,-29,0,8,-21,33598,24,1246,34868,11.95%,12.40%,
105/11/11,20,0,-3,17,33627,24,1238,34889,11.96%,12.41%,
105/11/10,111,0,13,124,33562,24,1241,34827,11.94%,12.39%,
105/11/09,10,0,-42,-32,33451,24,1228,34703,11.90%,12.35%,
105/11/08,-105,0,1,-104,33441,24,1270,34735,11.89%,12.35%,
105/11/07,-39,0,4,-35,33546,24,1269,34839,11.93%,12.39%,
105/11/04,14,0,-4,10,33585,24,1265,34874,11.94%,12.40%,
105/11/03,-30,0,8,-22,33643,24,1269,34936,11.96%,12.42%,
105/11/02,115,0,7,122,33673,24,1261,34958,11.97%,12.43%,
105/11/01,-43,0,-31,-74,33603,24,1254,34881,11.95%,12.40%,
105/10/31,109,0,-9,100,33646,24,1285,34955,11.96%,12.43%,
105/10/28,-3,0,-12,-15,33537,24,1294,34855,11.93%,12.40%,
105/10/27,-24,0,17,-7,33741,24,1306,35071,12.00%,12.47%,
105/10/26,65,0,-3,62,33765,24,1289,35078,12.01%,12.48%,
105/10/25,-9,0,1,-8,33700,24,1292,35016,11.98%,12.45%,
105/10/24,109,0,-10,99,33709,24,1291,35024,11.99%,12.46%,
105/10/21,189,6,0,195,33600,24,1301,34925,11.95%,12.42%,
105/10/20,188,6,-7,187,33562,18,1301,34881,11.94%,12.41%,
105/10/19,110,0,-16,94,33374,12,1308,34694,11.87%,12.34%,
105/10/18,13,0,-2,11,33442,12,1324,34778,11.89%,12.37%,
105/10/17,297,0,1,298,33429,12,1326,34767,11.89%,12.37%,
105/10/14,174,0,-21,153,33132,12,1325,34469,11.78%,12.26%,
105/10/13,187,0,3,190,32958,12,1346,34316,11.72%,12.20%,
105/10/12,197,0,-52,145,32771,12,1343,34126,11.65%,12.13%,
105/10/11,-36,0,-85,-121,32694,12,1395,34101,11.63%,12.13%,
105/10/07,-173,0,19,-154,32730,12,1480,34222,11.64%,12.17%,
105/10/06,-125,0,-13,-138,33053,12,1461,34526,11.75%,12.27%,
105/10/05,162,0,128,290,33228,12,1474,34714,11.82%,12.35%,
105/10/04,92,0,-33,59,33351,12,1346,34709,11.86%,12.34%,
105/10/03,92,0,-37,55,33259,12,1379,34650,11.83%,12.32%,
105/09/30,10,0,62,72,33213,12,1416,34641,11.81%,12.32%,
105/09/29,198,0,-44,154,33303,5,1354,34662,11.84%,12.32%,
105/09/26,28,0,-17,11,33105,5,1398,34508,11.77%,12.27%,
105/09/23,155,0,-27,128,33077,5,1415,34497,11.76%,12.27%,
105/09/22,181,0,14,195,33037,5,1442,34484,11.75%,12.26%,
105/09/21,184,0,-20,164,32856,5,1428,34289,11.68%,12.19%,
105/09/20,-33,0,0,-33,32577,5,1448,34030,11.58%,12.10%,
105/09/19,-15,0,-35,-50,32610,5,1448,34063,11.60%,12.12%,
105/09/14,198,0,-22,176,32625,5,1483,34113,11.60%,12.13%,
105/09/13,-21,0,-96,-117,32417,5,1505,33927,11.53%,12.07%,
105/09/12,35,0,-29,6,32462,5,1601,34068,11.54%,12.11%,
105/09/10,0,0,-128,-128,32427,5,1630,34062,11.53%,12.11%,
105/09/09,38,0,0,38,32427,5,1758,34190,11.53%,12.16%,
105/09/08,124,0,204,328,32389,5,1758,34152,11.52%,12.15%,
105/09/07,367,0,48,415,32265,5,1554,33824,11.47%,12.02%,
105/09/06,614,0,38,652,31898,5,1506,33409,11.34%,11.88%,
105/09/05,230,0,10,240,31284,5,1468,32757,11.12%,11.64%,
105/09/02,176,0,-50,126,31054,5,1458,32517,11.04%,11.56%,
105/09/01,22,0,0,22,30878,5,1508,32391,10.98%,11.52%,
105/08/31,-36,0,-39,-75,30856,5,1508,32369,10.97%,11.51%,
105/08/30,43,0,-88,-45,30860,5,1547,32412,10.97%,11.52%,
105/08/29,-144,0,-84,-228,30817,5,1635,32457,10.96%,11.54%,
105/08/26,-114,0,189,75,31197,5,1719,32921,11.09%,11.70%,
105/08/25,196,0,-2,194,31321,5,1530,32856,11.14%,11.69%,
105/08/24,106,-1,-1,104,31125,5,1532,32662,11.07%,11.62%,
105/08/23,-35,0,-2,-37,31019,6,1533,32558,11.03%,11.58%,
105/08/22,243,0,-45,198,31054,6,1535,32595,11.04%,11.59%,
105/08/19,315,0,0,315,30811,6,1580,32397,10.96%,11.52%,
105/08/18,-44,0,29,-15,30594,6,1580,32180,10.88%,11.44%,
105/08/17,-3,0,82,79,30638,6,1551,32195,10.89%,11.44%,
105/08/16,-160,-1,57,-104,30641,6,1469,32116,10.90%,11.42%,
105/08/15,20,0,65,85,30801,7,1412,32220,10.95%,11.45%,
105/08/12,15,0,-115,-100,30859,7,1347,32213,10.97%,11.45%,
105/08/11,74,0,46,120,30844,7,1462,32313,10.97%,11.49%,
105/08/10,27,0,41,68,30770,7,1416,32193,10.94%,11.45%,
105/08/09,-2,0,1,-1,30743,7,1375,32125,10.93%,11.42%,
105/08/08,211,0,51,262,30745,7,1374,32126,10.93%,11.42%,
105/08/05,313,0,-5,308,30534,7,1323,31864,10.86%,11.33%,
105/08/04,73,0,-67,6,30221,7,1328,31556,10.75%,11.22%,
105/08/03,-17,-1,-3,-21,30138,7,1395,31540,10.72%,11.22%,
105/08/02,-73,0,36,-37,30405,8,1398,31811,10.81%,11.31%,
105/08/01,54,0,31,85,30478,8,1362,31848,10.84%,11.33%,
105/07/29,-57,-1,-5,-63,30424,8,1331,31763,10.82%,11.30%,
105/07/28,18,0,0,18,30481,9,1336,31826,10.84%,11.32%,
105/07/27,-6,0,24,18,30463,9,1336,31808,10.83%,11.31%,
105/07/26,53,0,-3,50,30469,9,1312,31790,10.83%,11.30%,
105/07/25,3,0,30,33,30415,9,1315,31739,10.82%,11.29%,
105/07/22,233,-1,13,245,30412,9,1285,31706,10.81%,11.27%,
105/07/21,143,-1,-40,102,30179,10,1272,31461,10.73%,11.19%,
105/07/20,218,-1,109,326,30026,11,1312,31349,10.68%,11.15%,
105/07/19,-31,0,7,-24,29808,12,1203,31023,10.60%,11.03%,
105/07/18,195,0,-14,181,29839,12,1196,31047,10.61%,11.04%,
105/07/15,42,0,20,62,29644,12,1210,30866,10.54%,10.97%,
105/07/14,220,0,3,223,29602,12,1190,30804,10.53%,10.96%,
105/07/13,177,0,20,197,29382,12,1187,30581,10.45%,10.88%,
105/07/12,-31,0,-13,-44,29205,12,1167,30384,10.39%,10.81%,
105/07/11,193,0,17,210,29236,12,1180,30428,10.40%,10.82%,
105/07/07,-8,0,5,-3,29043,12,1163,30218,10.33%,10.75%,
105/07/06,-116,0,-88,-204,29051,12,1158,30221,10.33%,10.75%,
105/07/05,-25,0,64,39,29177,12,1246,30435,10.38%,10.83%,
105/07/04,14,0,7,21,28892,12,1182,30086,10.27%,10.69%,
105/07/01,-88,0,-6,-94,28878,12,1175,30065,10.27%,10.69%,
105/06/30,105,0,-11,94,28979,12,1181,30172,10.30%,10.72%,
105/06/29,-138,0,-35,-173,28874,33,1192,30099,10.27%,10.71%,
105/06/28,-65,0,67,2,29012,33,1227,30272,10.32%,10.77%,
105/06/27,45,16,9,70,29077,33,1160,30270,10.34%,10.76%,
105/06/24,-97,17,-47,-127,29032,17,1151,30200,10.32%,10.74%,
105/06/23,47,0,-31,16,29129,0,1198,30327,10.36%,10.79%,
105/06/22,53,0,45,98,29072,0,1229,30301,10.34%,10.78%,
105/06/21,-44,0,1,-43,29019,0,1184,30203,10.32%,10.74%,
105/06/20,89,0,30,119,29063,0,1183,30246,10.33%,10.75%,
105/06/17,116,0,2,118,28974,0,1153,30127,10.30%,10.71%,
105/06/16,-30,0,-7,-37,28858,0,1151,30009,10.26%,10.67%,
105/06/15,38,0,7,45,28888,0,1158,30046,10.27%,10.68%,
105/06/14,-77,0,4,-73,28850,0,1151,30001,10.26%,10.67%,
105/06/13,-95,0,7,-88,28927,0,1147,30074,10.29%,10.70%,
105/06/08,-93,0,-54,-147,29022,0,1140,30162,10.32%,10.73%,
105/06/07,-35,0,5,-30,29115,0,1194,30309,10.35%,10.77%,
105/06/06,204,0,108,312,29150,0,1189,30339,10.37%,10.79%,
105/06/04,0,0,0,0,28946,0,1081,30027,10.29%,10.67%,
105/06/03,99,0,-13,86,28946,0,1081,30027,10.29%,10.67%,
105/06/02,143,0,9,152,28829,0,1094,29923,10.25%,10.64%,
105/06/01,76,0,17,93,28686,0,1085,29771,10.20%,10.59%,
105/05/31,100,0,0,100,28610,0,1068,29678,10.17%,10.55%,
105/05/30,104,0,6,110,28510,0,1068,29578,10.14%,10.52%,
105/05/27,14,0,-2,12,28406,0,1062,29468,10.10%,10.48%,
105/05/26,27,0,1,28,28392,0,1064,29456,10.10%,10.48%,
105/05/25,-6,0,0,-6,28365,0,1063,29428,10.09%,10.47%,
105/05/24,216,0,-1,215,28371,0,1063,29434,10.09%,10.47%,
105/05/23,275,0,8,283,28155,0,1064,29219,10.01%,10.39%,
105/05/20,160,0,-9,151,27957,0,1056,29013,9.94%,10.32%,
105/05/19,102,0,-14,88,27797,0,1065,28862,9.88%,10.26%,
105/05/18,81,0,-12,69,27672,0,1079,28751,9.84%,10.22%,
105/05/17,93,0,-2,91,27591,0,1091,28682,9.81%,10.20%,
105/05/16,88,0,2,90,27498,0,1093,28591,9.78%,10.17%,
105/05/13,-61,0,-12,-73,27410,0,1091,28501,9.75%,10.14%,
105/05/12,47,0,23,70,27471,0,1103,28574,9.77%,10.16%,
105/05/11,-192,0,2,-190,27424,0,1080,28504,9.75%,10.13%,
105/05/10,281,0,13,294,27616,0,1078,28694,9.82%,10.20%,
105/05/09,-60,0,-4,-64,27335,0,1065,28400,9.72%,10.10%,
105/05/06,-66,0,1,-65,27395,0,1069,28464,9.74%,10.12%,
105/05/05,35,0,2,37,27461,0,1068,28529,9.76%,10.14%,
105/05/04,-5,0,1,-4,27426,0,1066,28492,9.75%,10.13%,
105/05/03,-39,0,-7,-46,27431,0,1065,28496,9.75%,10.13%,
105/04/29,-36,0,-5,-41,27470,0,1072,28542,9.77%,10.15%,
105/04/28,-59,0,-6,-65,27506,0,1077,28583,9.78%,10.16%,
105/04/27,-57,0,-4,-61,27565,0,1083,28648,9.80%,10.19%,
105/04/26,-34,0,2,-32,27612,0,1087,28699,9.82%,10.21%,
105/04/25,6,0,10,16,27646,0,1085,28731,9.83%,10.22%,
105/04/22,-148,0,1,-147,27640,0,1075,28715,9.83%,10.21%,
105/04/21,-174,0,-30,-204,27663,0,1074,28737,9.84%,10.22%,
105/04/20,-118,0,-25,-143,27837,0,1104,28941,9.90%,10.29%,
105/04/19,12,0,10,22,27955,0,1129,29084,9.94%,10.34%,
105/04/18,-92,0,-3,-95,27943,0,1119,29062,9.94%,10.34%,
105/04/15,8,-138,-36,-166,28050,0,1122,29172,9.97%,10.37%,
105/04/14,-85,0,-12,-97,28042,12,1158,29212,9.97%,10.39%,
105/04/13,-66,0,-38,-104,28127,12,1170,29309,10.00%,10.42%,
105/04/12,-259,0,-21,-280,28193,12,1208,29413,10.03%,10.46%,
105/04/11,-13,0,0,-13,28452,12,1229,29693,10.12%,10.56%,
105/04/08,17,0,11,28,28465,12,1229,29706,10.12%,10.56%,
105/04/07,35,0,-1,34,28448,12,1218,29678,10.12%,10.56%,
105/04/06,-104,0,-3,-107,28401,12,1219,29632,10.10%,10.54%,
105/04/01,-14,0,-6,-20,28505,12,1222,29739,10.14%,10.58%,
105/03/31,-4,0,0,-4,28519,12,1228,29759,10.14%,10.58%,
105/03/30,-12,0,0,-12,28523,11,1228,29762,10.14%,10.58%,
105/03/29,-80,0,-23,-103,28535,11,1228,29774,10.15%,10.59%,
105/03/28,-195,0,-14,-209,28615,11,1251,29877,10.18%,10.63%,
105/03/25,-91,0,-6,-97,29172,11,1265,30448,10.37%,10.82%,
105/03/24,-200,0,-10,-210,29263,11,1271,30545,10.41%,10.87%,
105/03/23,-110,0,24,-86,29463,11,1281,30755,10.48%,10.94%,
105/03/22,-6,0,-29,-35,29573,11,1257,30841,10.52%,10.97%,
105/03/21,-1,0,-19,-20,29579,11,1286,30876,10.52%,10.98%,
105/03/18,11,0,-6,5,29580,11,1305,30896,10.52%,10.99%,
105/03/17,-216,0,12,-204,29554,11,1311,30876,10.51%,10.98%,
105/03/16,-29,0,-64,-93,29770,11,1299,31080,10.59%,11.06%,
105/03/15,-36,0,10,-26,29799,11,1363,31173,10.60%,11.09%,
105/03/14,125,0,7,132,29835,11,1353,31199,10.61%,11.10%,
105/03/11,-126,0,-8,-134,29710,11,1346,31067,10.56%,11.04%,
105/03/10,-34,0,-21,-55,29836,11,1354,31201,10.61%,11.10%,
105/03/09,-98,0,11,-87,29870,11,1375,31256,10.62%,11.11%,
105/03/08,-82,0,-1,-83,29968,11,1364,31343,10.66%,11.15%,
105/03/07,-60,0,4,-56,29984,11,1365,31360,10.66%,11.15%,
105/03/04,-15,0,24,9,30044,11,1361,31416,10.68%,11.17%,
105/03/03,-67,0,-51,-118,30059,11,1337,31407,10.69%,11.17%,
105/03/02,-167,0,8,-159,30076,11,1388,31475,10.70%,11.20%,
105/03/01,-68,0,-1,-69,30243,11,1380,31634,10.75%,11.24%,
105/02/26,37,0,-2,35,30311,11,1381,31703,10.78%,11.28%,
105/02/25,-35,0,-4,-39,30274,11,1383,31668,10.77%,11.27%,
105/02/24,-56,0,-6,-62,30309,11,1387,31707,10.78%,11.28%,
105/02/23,35,0,-13,22,30365,11,1393,31769,10.80%,11.30%,
105/02/22,43,0,-14,29,30330,11,1406,31747,10.79%,11.29%,
105/02/19,-133,0,-23,-156,30307,11,1420,31738,10.78%,11.29%,
105/02/18,175,0,-5,170,30440,11,1443,31894,10.82%,11.34%,
105/02/17,59,0,16,75,30265,11,1448,31724,10.76%,11.28%,
105/02/16,213,0,-43,170,30206,11,1432,31649,10.74%,11.25%,
105/02/15,118,0,-6,112,30035,11,1475,31521,10.68%,11.21%,
105/02/03,89,0,-50,39,29917,11,1481,31409,10.64%,11.17%,
105/02/02,368,0,-6,362,30523,11,1531,32065,10.85%,11.40%,
105/02/01,78,0,-112,-34,30155,11,1537,31703,10.72%,11.27%,
105/01/30,0,11,-11,0,29484,11,1649,31144,10.48%,11.07%,
105/01/29,249,0,31,280,29484,0,1660,31144,10.48%,11.07%,
105/01/28,-22,0,-54,-76,29438,0,1629,31067,10.47%,11.05%,
105/01/27,200,0,288,488,29460,0,1683,31143,10.48%,11.08%,
105/01/26,90,0,0,90,29260,0,1395,30655,10.40%,10.90%,
105/01/25,228,0,63,291,29170,0,1395,30565,10.37%,10.87%,
105/01/22,1,0,-2,-1,28942,0,1332,30274,10.29%,10.76%,
105/01/21,264,0,-43,221,29170,0,1334,30504,10.37%,10.84%,
105/01/20,519,-9,-83,427,28896,0,1377,30273,10.28%,10.77%,
105/01/19,324,-1,91,414,28377,2,1460,29839,10.09%,10.61%,
105/01/18,394,0,62,456,28033,3,1369,29405,9.97%,10.46%,
105/01/15,179,-9,-18,152,27539,3,1307,28849,9.79%,10.26%,
105/01/14,437,0,6,443,27532,12,1325,28869,9.79%,10.27%,
105/01/13,-72,0,-29,-101,27660,12,1319,28991,9.84%,10.31%,
105/01/12,475,0,-31,444,27793,12,1348,29153,9.88%,10.36%,
105/01/11,-80,0,71,-9,27355,12,1379,28746,9.73%,10.22%,
105/01/08,-283,0,70,-213,27425,12,1308,28745,9.75%,10.22%,
105/01/07,396,0,-7,389,27697,12,1238,28947,9.85%,10.29%,
105/01/06,33,0,-51,-18,27249,12,1245,28506,9.69%,10.14%,
105/01/05,213,0,-3,210,27206,12,1296,28514,9.67%,10.14%,
105/01/04,-18,0,-11,-29,26993,12,1299,28304,9.60%,10.07%,
104/12/31,-65,0,-37,-102,27011,12,1310,28333,9.60%,10.07%,
104/12/30,410,0,47,457,27076,125,1347,28548,9.63%,10.15%,
104/12/29,163,52,-4,211,26666,125,1300,28091,9.48%,9.99%,
104/12/28,48,51,-3,96,26503,73,1304,27880,9.42%,9.91%,
104/12/25,37,0,1,38,26455,22,1307,27784,9.41%,9.88%,
104/12/24,34,0,-12,22,26454,22,1306,27782,9.41%,9.88%,
104/12/23,176,0,-7,169,26420,22,1318,27760,9.39%,9.87%,
104/12/22,22,0,-6,16,26245,22,1325,27592,9.33%,9.81%,
104/12/21,31,0,-67,-36,26253,22,1331,27606,9.33%,9.81%,
104/12/18,91,0,-39,52,26222,22,1398,27642,9.32%,9.83%,
104/12/17,-49,0,8,-41,26176,22,1437,27635,9.31%,9.83%,
104/12/16,-45,0,13,-32,26225,22,1429,27676,9.33%,9.85%,
104/12/15,-80,0,-4,-84,26260,22,1416,27698,9.34%,9.85%,
104/12/14,235,0,-88,147,26240,22,1420,27682,9.33%,9.84%,
104/12/11,-138,0,-31,-169,26005,22,1508,27535,9.25%,9.79%,
104/12/10,457,0,0,457,26153,22,1539,27714,9.30%,9.86%,
104/12/09,196,0,-57,139,25676,22,1539,27237,9.13%,9.69%,
104/12/08,457,0,-88,369,25441,22,1596,27059,9.05%,9.63%,
104/12/07,-117,0,-23,-140,25083,22,1684,26789,8.92%,9.53%,
104/12/04,82,0,7,89,25178,22,1707,26907,8.95%,9.57%,
104/12/03,165,0,-3,162,25172,22,1700,26894,8.95%,9.56%,
104/12/02,70,0,-4,66,25007,22,1703,26732,8.89%,9.50%,
104/12/01,268,0,-84,184,24937,22,1707,26666,8.87%,9.49%,
104/11/30,-60,0,-68,-128,24669,22,1791,26482,8.77%,9.42%,
104/11/27,54,0,-20,34,24729,22,1859,26610,8.79%,9.46%,
104/11/26,400,0,-129,271,24736,22,1879,26637,8.80%,9.48%,
104/11/25,126,0,-223,-97,24336,22,2008,26366,8.65%,9.37%,
104/11/24,-142,0,-302,-444,24210,22,2231,26463,8.61%,9.41%,
104/11/23,438,0,482,920,24352,22,2533,26907,8.66%,9.57%,
104/11/20,383,0,-45,338,24045,22,2051,26118,8.55%,9.29%,
104/11/19,-28,0,262,234,23662,22,2096,25780,8.41%,9.16%,
104/11/18,186,0,52,238,23690,22,1834,25546,8.42%,9.08%,
104/11/17,21,0,198,219,23504,22,1782,25308,8.36%,9.00%,
104/11/16,-47,0,-19,-66,23417,22,1584,25023,8.33%,8.90%,
104/11/13,245,0,5,250,23464,22,1603,25089,8.34%,8.92%,
104/11/12,-86,0,-32,-118,23270,22,1598,24890,8.27%,8.85%,
104/11/11,-201,0,-402,-603,23700,22,1630,25352,8.43%,9.02%,
104/11/10,332,0,370,702,23877,22,2032,25931,8.49%,9.22%,
104/11/09,-220,0,-18,-238,23638,22,1662,25322,8.40%,9.00%,
104/11/06,181,0,13,194,23835,22,1680,25537,8.47%,9.08%,
104/11/05,32,0,-3,29,23712,22,1667,25401,8.43%,9.03%,
104/11/04,268,5,-110,163,23680,22,1670,25372,8.42%,9.02%,
104/11/03,-28,0,208,180,23062,17,1780,24859,8.20%,8.84%,
104/11/02,52,0,-12,40,23090,17,1572,24679,8.21%,8.78%,
104/10/30,158,0,-59,99,23028,17,1584,24629,8.19%,8.76%,
104/10/29,-28,0,-63,-91,22947,17,1643,24607,8.16%,8.75%,
104/10/28,46,0,-22,24,22965,17,1706,24688,8.17%,8.78%,
104/10/27,23,0,-32,-9,22919,17,1728,24664,8.15%,8.77%,
104/10/26,131,0,-84,47,22945,17,1760,24722,8.16%,8.79%,
104/10/23,-1194,0,-65,-1259,22814,17,1844,24675,8.11%,8.77%,
104/10/22,-61,0,-17,-78,24081,17,1909,26007,8.56%,9.25%,
104/10/21,-26,0,-46,-72,24089,17,1926,26032,8.57%,9.26%,
104/10/20,241,0,14,255,24115,17,1972,26104,8.57%,9.28%,
104/10/19,-134,0,-9,-143,23874,17,1958,25849,8.49%,9.19%,
104/10/16,45,0,-515,-470,24008,17,1967,25992,8.54%,9.25%,
104/10/15,439,0,214,653,24089,17,2482,26588,8.57%,9.46%,
104/10/14,648,0,432,1080,23714,17,2268,25999,8.43%,9.24%,
104/10/13,347,0,-102,245,23066,17,1836,24919,8.20%,8.86%,
104/10/12,854,0,86,940,22771,17,1938,24726,8.10%,8.80%,
104/10/08,1467,0,-139,1328,21917,17,1852,23786,7.79%,8.45%,
104/10/07,24,0,-30,-6,20627,17,1991,22635,7.33%,8.04%,
104/10/06,94,0,-8,86,20652,17,2021,22690,7.34%,8.07%,
104/10/05,561,1,-1,561,20558,17,2029,22604,7.31%,8.04%,
104/10/02,486,4,87,577,19997,16,2030,22043,7.11%,7.84%,
104/10/01,-732,0,-106,-838,19472,12,1943,21427,6.92%,7.62%,
104/09/30,659,0,118,777,20180,12,2049,22241,7.17%,7.90%,
104/09/25,310,0,-56,254,19521,27,1931,21479,6.94%,7.64%,
104/09/24,-70,0,-609,-679,19201,27,1987,21215,6.83%,7.55%,
104/09/23,-163,0,575,412,19206,27,2596,21829,6.83%,7.76%,
104/09/22,248,0,74,322,19235,27,2021,21283,6.84%,7.57%,
104/09/21,14,25,-65,-26,18977,27,1947,20951,6.75%,7.45%,
104/09/18,612,0,-1,611,19221,2,2012,21235,6.83%,7.55%,
104/09/17,24,0,185,209,18609,2,2013,20624,6.62%,7.34%,
104/09/16,294,0,-119,175,18585,2,1828,20415,6.61%,7.26%,
104/09/15,784,0,131,915,18257,2,1947,20206,6.49%,7.18%,
104/09/14,527,0,-53,474,17463,2,1816,19281,6.21%,6.86%,
104/09/11,-1,0,-20,-21,16963,2,1869,18834,6.03%,6.70%,
104/09/10,377,0,16,393,16954,2,1889,18845,6.03%,6.70%,
104/09/09,76,0,-122,-46,16567,2,1873,18442,5.89%,6.56%,
104/09/08,359,0,259,618,16767,2,1995,18764,5.96%,6.67%,
104/09/07,245,1,55,301,16408,2,1736,18146,5.83%,6.45%,
104/09/04,-85,-2,-192,-279,16034,1,1681,17716,5.70%,6.30%,
104/09/03,549,0,-80,469,16119,3,1873,17995,5.73%,6.40%,
104/09/02,121,0,229,350,15510,3,1953,17466,5.51%,6.21%,
104/09/01,-315,-2,200,-117,15389,3,1724,17116,5.47%,6.08%,
104/08/31,-113,-1,50,-64,16347,5,1524,17876,5.81%,6.35%,
104/08/28,1235,0,8,1243,16260,6,1474,17740,5.78%,6.31%,
104/08/27,-134,0,-20,-154,15106,6,1466,16578,5.37%,5.89%,
104/08/26,-99,0,-7,-106,15240,6,1486,16732,5.42%,5.95%,
104/08/25,-534,0,7,-527,15339,6,1493,16838,5.45%,5.98%,
104/08/24,-764,0,-0,-764,15842,6,1486,17334,5.63%,6.16%,
104/08/21,-650,0,-19,-669,16606,6,1486,18098,5.90%,6.43%,
104/08/20,-2,0,-50,-52,17229,6,1505,18740,6.12%,6.66%,
104/08/19,-756,0,77,-679,17266,6,1555,18827,6.14%,6.70%,
104/08/18,-522,0,-19,-541,17595,6,1478,19079,6.25%,6.78%,
104/08/17,-546,0,69,-477,17399,6,1497,18902,6.19%,6.72%,
104/08/14,-340,0,105,-235,17869,6,1428,19303,6.35%,6.86%,
104/08/13,-227,0,57,-170,18052,6,1323,19381,6.42%,6.89%,
104/08/12,-37,1,147,111,18196,6,1266,19468,6.47%,6.92%,
104/08/11,-412,0,-15,-427,18233,5,1119,19357,6.48%,6.88%,
104/08/10,-123,0,5,-118,18652,5,1134,19791,6.63%,7.04%,
104/08/07,654,0,0,654,18782,5,1129,19916,6.68%,7.08%,
104/08/06,-183,0,-39,-222,18329,5,1129,19463,6.52%,6.92%,
104/08/05,483,0,-11,472,18512,5,1168,19685,6.58%,7.00%,
104/08/04,371,0,-56,315,18052,5,1179,19236,6.42%,6.84%,
104/08/03,23,0,-21,2,17704,5,1235,18944,6.29%,6.73%,
104/07/31,-122,0,-54,-176,17670,5,1256,18931,6.28%,6.73%,
104/07/30,-66,0,-6,-72,17741,5,1310,19056,6.31%,6.78%,
104/07/29,-139,0,-19,-158,17902,5,1316,19223,6.36%,6.83%,
104/07/28,572,4,-12,564,18057,5,1335,19397,6.42%,6.90%,
104/07/27,438,0,-163,275,17625,1,1347,18973,6.27%,6.75%,
104/07/24,90,0,-41,49,17166,1,1510,18677,6.10%,6.64%,
104/07/23,-1530,0,-121,-1651,17154,1,1551,18706,6.10%,6.65%,
104/07/22,-160,0,-90,-250,18048,1,1672,19721,6.42%,7.02%,
104/07/21,116,0,-23,93,18221,1,1762,19984,6.48%,7.11%,
104/07/20,-1098,0,-90,-1188,18105,1,1785,19891,6.44%,7.08%,
104/07/17,-415,1,14,-400,19042,1,1875,20918,6.77%,7.44%,
104/07/16,407,-17,29,419,19454,0,1861,21315,6.92%,7.58%,
104/07/15,-318,2,-61,-377,19064,14,1832,20910,6.78%,7.44%,
104/07/14,163,0,-22,141,19381,12,1893,21286,6.89%,7.57%,
104/07/13,520,0,75,595,19096,12,1915,21023,6.79%,7.48%,
104/07/09,-26,0,36,10,18616,12,1840,20468,6.62%,7.28%,
104/07/08,78,0,79,157,18511,12,1804,20327,6.58%,7.23%,
104/07/07,-204,0,-90,-294,18402,12,1725,20139,6.54%,7.16%,
104/07/06,-392,0,-13,-405,18406,12,1815,20233,6.54%,7.19%,
104/07/03,-401,0,-17,-418,18816,12,1828,20656,6.69%,7.34%,
104/07/02,-48,0,17,-31,18997,12,1845,20854,6.75%,7.41%,
104/07/01,-481,0,-10,-491,19045,12,1828,20885,6.77%,7.42%,
104/06/30,-272,0,2,-270,19131,12,1838,20981,6.80%,7.46%,
104/06/29,21,0,-83,-62,18857,36,1836,20729,6.70%,7.37%,
104/06/26,-127,0,13,-114,18882,36,1919,20837,6.71%,7.41%,
104/06/25,-13,0,-70,-83,19019,36,1906,20961,6.76%,7.45%,
104/06/24,-671,0,39,-632,19049,36,1976,21061,6.77%,7.49%,
104/06/23,-11,0,-56,-67,18789,36,1937,20762,6.68%,7.38%,
104/06/22,-167,-3,7,-163,18800,36,1993,20829,6.68%,7.40%,
104/06/18,8,0,-5,3,18907,39,1986,20932,6.72%,7.44%,
104/06/17,-682,0,-48,-730,18857,39,1991,20887,6.70%,7.42%,
104/06/16,-429,0,-39,-468,19461,39,2039,21539,6.92%,7.66%,
104/06/15,-172,0,-249,-421,19742,39,2078,21859,7.02%,7.77%,
104/06/12,-110,0,-17,-127,20019,39,2327,22385,7.12%,7.96%,
104/06/11,-274,0,-146,-420,20484,39,2344,22867,7.28%,8.13%,
104/06/10,48,0,301,349,20555,39,2490,23084,7.31%,8.21%,
104/06/09,-450,0,-119,-569,20492,39,2189,22720,7.29%,8.08%,
104/06/08,-31,0,0,-31,20861,39,2308,23208,7.42%,8.25%,
104/06/05,-355,0,-70,-425,20852,39,2308,23199,7.41%,8.24%,
104/06/04,-48,0,-139,-187,21183,39,2378,23600,7.53%,8.39%,
104/06/03,-33,0,62,29,21225,39,2517,23781,7.55%,8.46%,
104/06/02,-148,0,96,-52,21185,39,2455,23679,7.53%,8.42%,
104/06/01,-135,0,-111,-246,21286,39,2359,23684,7.57%,8.42%,
104/05/29,148,0,218,366,21398,39,2470,23907,7.61%,8.50%,
104/05/28,-33,0,-157,-190,21250,39,2252,23541,7.55%,8.37%,
104/05/27,-374,0,-421,-795,21283,39,2409,23731,7.57%,8.44%,
104/05/26,428,0,785,1213,21597,39,2830,24466,7.68%,8.70%,
104/05/25,-104,0,-80,-184,21222,39,2045,23306,7.55%,8.29%,
104/05/22,-358,0,34,-324,21326,39,2125,23490,7.58%,8.35%,
104/05/21,120,0,-60,60,21679,39,2091,23809,7.71%,8.47%,
104/05/20,35,0,56,91,21528,39,2151,23718,7.66%,8.44%,
104/05/19,-413,0,-35,-448,21561,39,2095,23695,7.67%,8.43%,
104/05/18,173,0,15,188,21990,39,2130,24159,7.82%,8.59%,
104/05/15,-179,0,-245,-424,21817,39,2115,23971,7.76%,8.53%,
104/05/14,-360,0,-153,-513,21978,39,2360,24377,7.82%,8.67%,
104/05/13,-607,0,547,-60,22317,39,2513,24869,7.94%,8.85%,
104/05/12,-12,0,35,23,22816,39,1966,24821,8.11%,8.82%,
104/05/11,-94,0,-3,-97,23333,39,1931,25303,8.30%,9.00%,
104/05/08,37,0,38,75,23381,39,1934,25354,8.31%,9.01%,
104/05/07,-231,0,39,-192,23409,39,1896,25344,8.32%,9.01%,
104/05/06,277,0,23,300,23640,39,1857,25536,8.41%,9.08%,
104/05/05,276,0,-14,262,23417,39,1834,25290,8.33%,9.00%,
104/05/04,171,0,-44,127,23129,39,1848,25016,8.22%,8.89%,
104/04/30,-67,0,-12,-79,22945,39,1892,24876,8.16%,8.85%,
104/04/29,36,0,-6,30,22843,39,1904,24786,8.12%,8.81%,
104/04/28,123,0,17,140,22651,39,1910,24600,8.05%,8.74%,
104/04/27,105,0,-1,104,22518,39,1893,24450,8.01%,8.70%,
104/04/24,238,0,-9,229,22413,39,1894,24346,7.97%,8.66%,
104/04/23,289,0,-4,285,22175,39,1903,24117,7.89%,8.58%,
104/04/22,78,0,-20,58,21856,39,1907,23802,7.77%,8.46%,
104/04/21,-167,0,-54,-221,21678,39,1927,23644,7.71%,8.41%,
104/04/20,132,0,-12,120,21845,39,1981,23865,7.77%,8.49%,
104/04/17,419,0,-110,309,21703,39,1993,23735,7.72%,8.44%,
104/04/16,-195,0,-56,-251,21284,39,2103,23426,7.57%,8.33%,
104/04/15,-123,0,-155,-278,21728,39,2159,23926,7.73%,8.51%,
104/04/14,-190,0,-18,-208,21551,39,2314,23904,7.66%,8.50%,
104/04/13,237,0,4,241,21741,39,2332,24112,7.73%,8.57%,
104/04/10,416,0,-68,348,21503,39,2328,23870,7.65%,8.49%,
104/04/09,319,0,15,334,21087,39,2396,23522,7.50%,8.37%,
104/04/08,-121,0,-34,-155,20768,39,2381,23188,7.38%,8.24%,
104/04/07,-208,0,-18,-226,20889,39,2415,23343,7.43%,8.30%,
104/04/02,1207,0,-30,1177,21097,39,2434,23570,7.50%,8.38%,
104/04/01,-169,0,-408,-577,20093,39,2464,22596,7.14%,8.03%,
104/03/31,732,0,14,746,19976,39,2872,22887,7.10%,8.14%,
104/03/30,-12,0,-33,-45,19406,36,2858,22300,6.90%,7.93%,
104/03/27,1002,0,-247,755,19418,36,2891,22345,6.90%,7.94%,
104/03/26,84,0,165,249,18416,36,3138,21590,6.55%,7.68%,
104/03/25,33,0,-18,15,18332,36,2972,21340,6.52%,7.59%,
104/03/24,13,0,-59,-46,18323,36,2990,21349,6.51%,7.59%,
104/03/23,-91,0,68,-23,18394,36,3049,21479,6.54%,7.64%,
104/03/20,80,0,-182,-102,18533,36,2981,21550,6.59%,7.66%,
104/03/19,167,0,-162,5,18589,36,3163,21788,6.61%,7.75%,
104/03/18,34,0,-108,-74,18422,36,3325,21783,6.55%,7.75%,
104/03/17,-369,0,-154,-523,18388,36,3433,21857,6.54%,7.77%,
104/03/16,-185,-5,-57,-247,18850,36,3587,22473,6.70%,7.99%,
104/03/13,104,0,-357,-253,19035,41,3644,22720,6.77%,8.08%,
104/03/12,-120,0,142,22,18931,41,4001,22973,6.73%,8.17%,
104/03/11,-54,0,-215,-269,19062,41,3859,22962,6.78%,8.17%,
104/03/10,-209,0,461,252,19116,41,4074,23231,6.80%,8.26%,
104/03/09,169,0,-56,113,19395,41,3613,23049,6.90%,8.20%,
104/03/06,-4,0,-333,-337,19324,41,3669,23034,6.87%,8.19%,
104/03/05,-630,0,-506,-1136,19838,41,4002,23881,7.05%,8.49%,
104/03/04,-1268,0,1273,5,20468,41,4508,25017,7.28%,8.90%,
104/03/03,-83,0,-122,-205,21382,41,3235,24658,7.60%,8.77%,
104/03/02,-673,0,-132,-805,21376,41,3357,24774,7.60%,8.81%,
104/02/26,-123,0,123,0,21829,41,3489,25359,7.76%,9.02%,
104/02/25,-168,0,-306,-474,22063,41,3366,25470,7.85%,9.06%,
104/02/24,-754,0,511,-243,22142,41,3672,25855,7.87%,9.19%,
104/02/13,-116,0,-519,-635,22845,41,3161,26047,8.12%,9.26%,
104/02/12,-812,0,195,-617,23121,41,3680,26842,8.22%,9.54%,
104/02/11,-45,0,-71,-116,23934,41,3485,27460,8.51%,9.76%,
104/02/10,-1271,0,-44,-1315,24508,41,3556,28105,8.72%,10.00%,
104/02/09,366,-2,-362,2,25556,41,3600,29197,9.09%,10.39%,
104/02/06,-248,0,-1540,-1788,25087,43,3962,29092,8.92%,10.34%,
104/02/05,-429,0,1001,572,25197,43,5502,30742,8.96%,10.93%,
104/02/04,-1221,-12,-204,-1437,25357,43,4501,29901,9.02%,10.64%,
104/02/03,280,0,-488,-208,26511,55,4705,31271,9.43%,11.12%,
104/02/02,-369,0,1162,793,26112,55,5193,31360,9.29%,11.16%,
104/01/30,72,0,438,510,26236,55,4031,30322,9.33%,10.78%,
104/01/29,279,0,-443,-164,26030,55,3593,29678,9.26%,10.56%,
104/01/28,-1070,0,-1208,-2278,25738,55,4036,29829,9.15%,10.61%,
104/01/27,11,0,2606,2617,26709,55,5244,32008,9.50%,11.39%,
104/01/26,36,0,-22,14,26882,55,2638,29575,9.56%,10.52%,
104/01/23,-192,0,-18,-210,26846,55,2660,29561,9.55%,10.52%,
104/01/22,-76,0,-123,-199,27037,55,2678,29770,9.62%,10.59%,
104/01/21,-191,0,8,-183,27179,55,2801,30035,9.67%,10.69%,
104/01/20,333,0,-7,326,27300,55,2793,30148,9.71%,10.72%,
104/01/19,-44,0,-286,-330,26954,55,2800,29809,9.59%,10.61%,
104/01/16,-326,0,-301,-627,27604,55,3086,30745,9.82%,10.94%,
104/01/15,-150,0,76,-74,28035,55,3387,31477,9.97%,11.19%,
104/01/14,256,0,998,1254,28416,55,3311,31782,10.11%,11.31%,
104/01/13,45,0,38,83,28149,55,2313,30517,10.01%,10.85%,
104/01/12,107,0,-77,30,28090,55,2275,30420,9.99%,10.82%,
104/01/09,176,0,3,179,27983,55,2352,30390,9.95%,10.81%,
104/01/08,-407,0,83,-324,27807,55,2349,30211,9.89%,10.75%,
104/01/07,302,0,108,410,28244,55,2266,30565,10.04%,10.87%,
104/01/06,-20,0,-111,-131,28092,55,2158,30305,9.99%,10.78%,
104/01/05,281,0,-56,225,28112,55,2269,30436,10.00%,10.83%,
